Orthogroup	Arachis_hypogaea	Brassica_napus	Capsicum_anuum	Prunus_persica	Solanum_lycopersicum	Total
OG0000000	759	0	0	0	0	759
OG0000001	427	0	0	1	0	428
OG0000002	331	0	0	0	0	331
OG0000003	0	330	0	0	0	330
OG0000004	0	250	0	0	0	250
OG0000005	226	1	0	0	0	227
OG0000006	0	0	226	0	1	227
OG0000007	213	0	0	0	0	213
OG0000008	0	1	207	0	3	211
OG0000009	201	0	0	0	0	201
OG0000010	191	0	0	0	0	191
OG0000011	0	182	0	0	0	182
OG0000012	178	1	0	0	0	179
OG0000013	0	179	0	0	0	179
OG0000014	165	2	2	0	0	169
OG0000015	165	0	0	1	0	166
OG0000016	143	0	0	0	0	143
OG0000017	1	2	135	0	4	142
OG0000018	0	0	121	0	15	136
OG0000019	0	135	0	0	0	135
OG0000020	134	0	0	0	0	134
OG0000021	0	127	0	0	0	127
OG0000022	0	125	0	0	0	125
OG0000023	0	0	124	0	1	125
OG0000024	16	8	38	32	25	119
OG0000025	118	0	0	0	0	118
OG0000026	116	2	0	0	0	118
OG0000027	0	116	0	0	0	116
OG0000028	104	1	4	4	1	114
OG0000029	0	3	104	5	2	114
OG0000030	111	0	0	0	0	111
OG0000031	0	110	0	0	0	110
OG0000032	0	109	0	0	0	109
OG0000033	0	109	0	0	0	109
OG0000034	0	1	103	0	5	109
OG0000035	16	0	52	27	13	108
OG0000036	0	108	0	0	0	108
OG0000037	107	0	0	0	0	107
OG0000038	0	104	0	0	0	104
OG0000039	0	0	84	1	18	103
OG0000040	96	3	0	0	1	100
OG0000041	99	0	0	0	0	99
OG0000042	1	0	19	0	77	97
OG0000043	96	0	0	0	0	96
OG0000044	0	0	94	0	2	96
OG0000045	90	0	0	1	0	91
OG0000046	90	0	0	1	0	91
OG0000047	0	91	0	0	0	91
OG0000048	0	90	0	0	0	90
OG0000049	0	90	0	0	0	90
OG0000050	0	1	81	1	7	90
OG0000051	0	0	88	0	1	89
OG0000052	88	0	0	0	0	88
OG0000053	87	0	0	0	0	87
OG0000054	2	7	49	4	25	87
OG0000055	0	87	0	0	0	87
OG0000056	0	0	39	0	48	87
OG0000057	0	0	85	0	1	86
OG0000058	0	3	70	0	12	85
OG0000059	0	0	82	0	2	84
OG0000060	83	0	0	0	0	83
OG0000061	0	73	0	8	0	81
OG0000062	0	0	10	0	71	81
OG0000063	0	78	0	0	0	78
OG0000064	77	0	0	0	0	77
OG0000065	0	0	0	0	77	77
OG0000066	1	0	48	9	17	75
OG0000067	72	1	1	0	0	74
OG0000068	74	0	0	0	0	74
OG0000069	73	0	0	0	0	73
OG0000070	14	0	43	2	14	73
OG0000071	71	0	1	0	0	72
OG0000072	72	0	0	0	0	72
OG0000073	0	72	0	0	0	72
OG0000074	0	0	0	72	0	72
OG0000075	0	71	0	0	0	71
OG0000076	0	0	67	0	4	71
OG0000077	0	0	70	1	0	71
OG0000078	23	0	19	17	11	70
OG0000079	17	12	15	19	7	70
OG0000080	0	70	0	0	0	70
OG0000081	0	0	4	0	66	70
OG0000082	69	0	0	0	0	69
OG0000083	18	0	6	42	3	69
OG0000084	10	0	32	6	21	69
OG0000085	0	69	0	0	0	69
OG0000086	68	0	0	0	0	68
OG0000087	4	4	57	1	2	68
OG0000088	0	67	0	0	0	67
OG0000089	0	67	0	0	0	67
OG0000090	0	67	0	0	0	67
OG0000091	0	67	0	0	0	67
OG0000092	0	0	58	0	9	67
OG0000093	0	0	39	0	28	67
OG0000094	66	0	0	0	0	66
OG0000095	20	20	9	8	9	66
OG0000096	0	66	0	0	0	66
OG0000097	0	66	0	0	0	66
OG0000098	0	66	0	0	0	66
OG0000099	0	66	0	0	0	66
OG0000100	22	4	9	18	12	65
OG0000101	22	21	8	9	5	65
OG0000102	0	65	0	0	0	65
OG0000103	0	65	0	0	0	65
OG0000104	0	65	0	0	0	65
OG0000105	15	24	12	6	7	64
OG0000106	4	0	18	1	41	64
OG0000107	1	0	2	0	61	64
OG0000108	0	0	0	0	64	64
OG0000109	12	18	12	1	20	63
OG0000110	61	0	0	0	0	61
OG0000111	61	0	0	0	0	61
OG0000112	61	0	0	0	0	61
OG0000113	4	14	25	3	15	61
OG0000114	0	61	0	0	0	61
OG0000115	0	60	0	0	0	60
OG0000116	0	0	60	0	0	60
OG0000117	59	0	0	0	0	59
OG0000118	58	0	0	0	1	59
OG0000119	0	59	0	0	0	59
OG0000120	0	0	0	0	59	59
OG0000121	0	58	0	0	0	58
OG0000122	0	1	56	0	1	58
OG0000123	57	0	0	0	0	57
OG0000124	1	0	16	0	40	57
OG0000125	0	57	0	0	0	57
OG0000126	0	57	0	0	0	57
OG0000127	0	57	0	0	0	57
OG0000128	0	35	0	22	0	57
OG0000129	0	0	56	0	1	57
OG0000130	56	0	0	0	0	56
OG0000131	0	56	0	0	0	56
OG0000132	0	55	0	1	0	56
OG0000133	14	0	10	19	12	55
OG0000134	0	55	0	0	0	55
OG0000135	0	3	11	0	41	55
OG0000136	0	0	54	0	1	55
OG0000137	0	0	22	4	29	55
OG0000138	13	6	5	26	4	54
OG0000139	6	25	5	13	5	54
OG0000140	2	2	45	3	2	54
OG0000141	0	54	0	0	0	54
OG0000142	0	54	0	0	0	54
OG0000143	0	54	0	0	0	54
OG0000144	53	0	0	0	0	53
OG0000145	0	53	0	0	0	53
OG0000146	52	0	0	0	0	52
OG0000147	15	2	12	19	4	52
OG0000148	0	52	0	0	0	52
OG0000149	0	52	0	0	0	52
OG0000150	0	52	0	0	0	52
OG0000151	0	0	0	0	52	52
OG0000152	51	0	0	0	0	51
OG0000153	51	0	0	0	0	51
OG0000154	51	0	0	0	0	51
OG0000155	6	3	12	3	27	51
OG0000156	0	51	0	0	0	51
OG0000157	0	0	13	0	38	51
OG0000158	0	0	48	0	3	51
OG0000159	0	0	0	0	51	51
OG0000160	50	0	0	0	0	50
OG0000161	0	50	0	0	0	50
OG0000162	0	0	0	50	0	50
OG0000163	0	0	0	0	50	50
OG0000164	9	11	10	14	5	49
OG0000165	33	5	3	4	4	49
OG0000166	49	0	0	0	0	49
OG0000167	3	0	40	5	1	49
OG0000168	0	49	0	0	0	49
OG0000169	0	49	0	0	0	49
OG0000170	0	49	0	0	0	49
OG0000171	0	0	0	0	49	49
OG0000172	0	0	0	0	49	49
OG0000173	3	1	35	0	9	48
OG0000174	48	0	0	0	0	48
OG0000175	8	0	20	16	4	48
OG0000176	4	8	10	18	8	48
OG0000177	0	48	0	0	0	48
OG0000178	47	0	0	0	0	47
OG0000179	19	7	7	11	3	47
OG0000180	17	0	24	0	6	47
OG0000181	47	0	0	0	0	47
OG0000182	11	17	1	16	2	47
OG0000183	1	1	36	1	8	47
OG0000184	1	1	40	0	5	47
OG0000185	0	47	0	0	0	47
OG0000186	0	47	0	0	0	47
OG0000187	46	0	0	0	0	46
OG0000188	8	1	17	7	13	46
OG0000189	1	3	32	4	6	46
OG0000190	7	7	15	15	2	46
OG0000191	0	46	0	0	0	46
OG0000192	0	46	0	0	0	46
OG0000193	0	0	2	0	44	46
OG0000194	6	2	18	10	9	45
OG0000195	2	1	6	26	10	45
OG0000196	35	4	2	2	2	45
OG0000197	2	32	1	7	3	45
OG0000198	0	45	0	0	0	45
OG0000199	0	45	0	0	0	45
OG0000200	0	45	0	0	0	45
OG0000201	0	45	0	0	0	45
OG0000202	0	45	0	0	0	45
OG0000203	0	45	0	0	0	45
OG0000204	0	1	37	0	7	45
OG0000205	0	0	22	7	16	45
OG0000206	0	0	0	45	0	45
OG0000207	44	0	0	0	0	44
OG0000208	18	15	7	1	3	44
OG0000209	17	0	15	3	9	44
OG0000210	9	5	9	10	11	44
OG0000211	4	2	30	1	7	44
OG0000212	5	7	22	0	10	44
OG0000213	1	5	9	0	29	44
OG0000214	0	44	0	0	0	44
OG0000215	0	44	0	0	0	44
OG0000216	0	44	0	0	0	44
OG0000217	0	2	7	0	35	44
OG0000218	0	0	0	0	44	44
OG0000219	43	0	0	0	0	43
OG0000220	43	0	0	0	0	43
OG0000221	43	0	0	0	0	43
OG0000222	13	1	1	26	2	43
OG0000223	8	7	10	14	4	43
OG0000224	10	3	7	18	5	43
OG0000225	2	13	11	11	6	43
OG0000226	43	0	0	0	0	43
OG0000227	0	43	0	0	0	43
OG0000228	0	43	0	0	0	43
OG0000229	0	43	0	0	0	43
OG0000230	0	8	6	5	24	43
OG0000231	0	0	40	0	3	43
OG0000232	0	0	37	0	6	43
OG0000233	0	0	0	43	0	43
OG0000234	0	0	0	0	43	43
OG0000235	11	9	1	20	1	42
OG0000236	13	10	7	5	7	42
OG0000237	42	0	0	0	0	42
OG0000238	42	0	0	0	0	42
OG0000239	4	1	26	2	9	42
OG0000240	1	13	0	28	0	42
OG0000241	0	42	0	0	0	42
OG0000242	0	0	37	1	4	42
OG0000243	41	0	0	0	0	41
OG0000244	41	0	0	0	0	41
OG0000245	41	0	0	0	0	41
OG0000246	4	15	7	11	4	41
OG0000247	15	0	9	13	4	41
OG0000248	12	13	6	6	4	41
OG0000249	9	16	7	6	3	41
OG0000250	10	7	3	17	4	41
OG0000251	8	5	11	7	10	41
OG0000252	1	32	3	3	2	41
OG0000253	6	7	1	26	1	41
OG0000254	0	41	0	0	0	41
OG0000255	0	41	0	0	0	41
OG0000256	0	41	0	0	0	41
OG0000257	0	41	0	0	0	41
OG0000258	0	41	0	0	0	41
OG0000259	0	0	1	1	39	41
OG0000260	8	11	9	4	8	40
OG0000261	9	10	8	7	6	40
OG0000262	11	0	6	19	4	40
OG0000263	3	13	10	3	11	40
OG0000264	2	0	15	11	12	40
OG0000265	6	11	14	0	9	40
OG0000266	0	31	2	7	0	40
OG0000267	0	40	0	0	0	40
OG0000268	0	40	0	0	0	40
OG0000269	0	40	0	0	0	40
OG0000270	0	0	27	0	13	40
OG0000271	38	0	0	1	0	39
OG0000272	39	0	0	0	0	39
OG0000273	39	0	0	0	0	39
OG0000274	38	0	0	0	1	39
OG0000275	8	13	10	3	5	39
OG0000276	3	4	8	21	3	39
OG0000277	11	17	3	6	2	39
OG0000278	13	7	6	6	7	39
OG0000279	6	11	15	6	1	39
OG0000280	13	5	8	7	6	39
OG0000281	11	6	3	13	6	39
OG0000282	2	5	10	2	20	39
OG0000283	2	0	4	31	2	39
OG0000284	1	0	30	1	7	39
OG0000285	1	0	33	1	4	39
OG0000286	0	0	4	29	6	39
OG0000287	0	0	1	0	38	39
OG0000288	38	0	0	0	0	38
OG0000289	5	17	10	2	4	38
OG0000290	10	0	6	3	19	38
OG0000291	12	7	8	7	4	38
OG0000292	7	9	18	1	3	38
OG0000293	2	12	8	9	7	38
OG0000294	2	0	21	1	14	38
OG0000295	0	38	0	0	0	38
OG0000296	0	38	0	0	0	38
OG0000297	0	0	36	0	2	38
OG0000298	0	0	38	0	0	38
OG0000299	0	0	0	0	38	38
OG0000300	37	0	0	0	0	37
OG0000301	37	0	0	0	0	37
OG0000302	5	20	6	6	0	37
OG0000303	27	6	1	2	1	37
OG0000304	3	1	26	0	7	37
OG0000305	11	5	17	1	3	37
OG0000306	14	5	5	4	9	37
OG0000307	37	0	0	0	0	37
OG0000308	0	37	0	0	0	37
OG0000309	0	37	0	0	0	37
OG0000310	0	37	0	0	0	37
OG0000311	0	0	34	0	3	37
OG0000312	0	0	3	0	34	37
OG0000313	3	3	4	2	24	36
OG0000314	36	0	0	0	0	36
OG0000315	7	0	14	6	9	36
OG0000316	36	0	0	0	0	36
OG0000317	11	4	7	6	8	36
OG0000318	11	3	11	10	1	36
OG0000319	18	0	6	4	8	36
OG0000320	2	25	3	4	2	36
OG0000321	6	9	10	7	4	36
OG0000322	36	0	0	0	0	36
OG0000323	36	0	0	0	0	36
OG0000324	0	36	0	0	0	36
OG0000325	0	36	0	0	0	36
OG0000326	0	36	0	0	0	36
OG0000327	0	35	1	0	0	36
OG0000328	0	1	29	2	4	36
OG0000329	0	0	31	0	5	36
OG0000330	0	0	30	0	6	36
OG0000331	7	15	5	6	2	35
OG0000332	35	0	0	0	0	35
OG0000333	8	18	6	2	1	35
OG0000334	4	1	19	0	11	35
OG0000335	5	0	11	12	7	35
OG0000336	3	25	1	2	4	35
OG0000337	6	2	22	0	5	35
OG0000338	7	20	4	2	2	35
OG0000339	6	0	13	0	16	35
OG0000340	0	35	0	0	0	35
OG0000341	0	35	0	0	0	35
OG0000342	0	35	0	0	0	35
OG0000343	0	0	2	0	33	35
OG0000344	0	0	9	0	26	35
OG0000345	0	0	0	0	35	35
OG0000346	34	0	0	0	0	34
OG0000347	34	0	0	0	0	34
OG0000348	6	10	7	9	2	34
OG0000349	7	0	10	8	9	34
OG0000350	7	25	1	1	0	34
OG0000351	2	0	30	2	0	34
OG0000352	2	4	11	10	7	34
OG0000353	0	34	0	0	0	34
OG0000354	0	34	0	0	0	34
OG0000355	0	34	0	0	0	34
OG0000356	0	34	0	0	0	34
OG0000357	0	34	0	0	0	34
OG0000358	0	34	0	0	0	34
OG0000359	0	34	0	0	0	34
OG0000360	0	0	33	0	1	34
OG0000361	0	0	32	0	2	34
OG0000362	0	0	27	1	6	34
OG0000363	33	0	0	0	0	33
OG0000364	33	0	0	0	0	33
OG0000365	4	5	3	12	9	33
OG0000366	10	9	5	4	5	33
OG0000367	2	6	7	14	4	33
OG0000368	10	11	4	3	5	33
OG0000369	12	10	5	4	2	33
OG0000370	2	16	5	5	5	33
OG0000371	3	11	8	6	5	33
OG0000372	18	3	1	10	1	33
OG0000373	0	33	0	0	0	33
OG0000374	0	33	0	0	0	33
OG0000375	0	33	0	0	0	33
OG0000376	0	33	0	0	0	33
OG0000377	0	33	0	0	0	33
OG0000378	0	33	0	0	0	33
OG0000379	0	33	0	0	0	33
OG0000380	0	1	1	0	31	33
OG0000381	0	1	29	0	3	33
OG0000382	0	0	33	0	0	33
OG0000383	0	0	9	0	24	33
OG0000384	0	0	2	0	31	33
OG0000385	18	2	3	8	1	32
OG0000386	32	0	0	0	0	32
OG0000387	15	4	6	4	3	32
OG0000388	23	4	2	1	2	32
OG0000389	5	12	6	3	6	32
OG0000390	6	13	6	3	4	32
OG0000391	14	6	3	3	6	32
OG0000392	4	22	2	2	2	32
OG0000393	6	2	11	4	9	32
OG0000394	8	9	7	3	5	32
OG0000395	8	18	4	1	1	32
OG0000396	3	3	11	6	9	32
OG0000397	4	12	7	7	2	32
OG0000398	3	14	10	3	2	32
OG0000399	0	32	0	0	0	32
OG0000400	0	32	0	0	0	32
OG0000401	0	32	0	0	0	32
OG0000402	0	32	0	0	0	32
OG0000403	0	32	0	0	0	32
OG0000404	0	32	0	0	0	32
OG0000405	0	0	0	32	0	32
OG0000406	0	0	0	0	32	32
OG0000407	0	0	0	0	32	32
OG0000408	4	6	8	13	0	31
OG0000409	31	0	0	0	0	31
OG0000410	9	10	3	6	3	31
OG0000411	31	0	0	0	0	31
OG0000412	2	2	0	27	0	31
OG0000413	4	11	6	5	5	31
OG0000414	9	4	13	0	5	31
OG0000415	7	11	5	6	2	31
OG0000416	8	7	4	7	5	31
OG0000417	2	2	1	25	1	31
OG0000418	1	12	6	9	3	31
OG0000419	1	0	0	0	30	31
OG0000420	0	31	0	0	0	31
OG0000421	0	31	0	0	0	31
OG0000422	0	31	0	0	0	31
OG0000423	0	31	0	0	0	31
OG0000424	0	31	0	0	0	31
OG0000425	0	31	0	0	0	31
OG0000426	0	0	27	0	4	31
OG0000427	0	0	1	0	30	31
OG0000428	18	3	2	4	3	30
OG0000429	23	1	2	3	1	30
OG0000430	9	2	8	3	8	30
OG0000431	5	1	13	3	8	30
OG0000432	30	0	0	0	0	30
OG0000433	28	1	1	0	0	30
OG0000434	3	13	8	3	3	30
OG0000435	7	7	7	4	5	30
OG0000436	6	10	5	3	6	30
OG0000437	2	0	5	20	3	30
OG0000438	30	0	0	0	0	30
OG0000439	11	5	6	7	1	30
OG0000440	5	10	10	2	3	30
OG0000441	1	0	28	0	1	30
OG0000442	5	5	7	8	5	30
OG0000443	0	30	0	0	0	30
OG0000444	0	27	0	3	0	30
OG0000445	0	30	0	0	0	30
OG0000446	0	30	0	0	0	30
OG0000447	0	30	0	0	0	30
OG0000448	0	1	24	1	4	30
OG0000449	0	1	0	29	0	30
OG0000450	0	0	30	0	0	30
OG0000451	0	0	30	0	0	30
OG0000452	0	0	25	0	5	30
OG0000453	0	0	20	4	6	30
OG0000454	0	0	1	0	29	30
OG0000455	0	0	30	0	0	30
OG0000456	0	0	2	24	4	30
OG0000457	0	0	0	0	30	30
OG0000458	0	0	0	0	30	30
OG0000459	0	0	0	0	30	30
OG0000460	29	0	0	0	0	29
OG0000461	9	9	3	3	5	29
OG0000462	29	0	0	0	0	29
OG0000463	4	11	4	6	4	29
OG0000464	13	1	15	0	0	29
OG0000465	9	5	5	4	6	29
OG0000466	12	9	3	3	2	29
OG0000467	6	8	7	3	5	29
OG0000468	12	4	3	7	3	29
OG0000469	29	0	0	0	0	29
OG0000470	6	14	1	4	4	29
OG0000471	6	0	6	9	8	29
OG0000472	8	10	3	4	4	29
OG0000473	2	6	9	1	11	29
OG0000474	2	15	4	3	5	29
OG0000475	2	3	22	0	2	29
OG0000476	2	22	2	1	2	29
OG0000477	4	0	5	17	3	29
OG0000478	1	0	15	5	8	29
OG0000479	0	27	1	0	1	29
OG0000480	0	29	0	0	0	29
OG0000481	0	1	24	0	4	29
OG0000482	0	22	2	1	4	29
OG0000483	0	29	0	0	0	29
OG0000484	0	29	0	0	0	29
OG0000485	0	0	26	0	3	29
OG0000486	0	0	27	0	2	29
OG0000487	0	0	28	0	1	29
OG0000488	5	4	9	1	9	28
OG0000489	28	0	0	0	0	28
OG0000490	17	3	3	3	2	28
OG0000491	13	3	4	6	2	28
OG0000492	28	0	0	0	0	28
OG0000493	8	8	4	4	4	28
OG0000494	8	8	4	3	5	28
OG0000495	7	4	5	5	7	28
OG0000496	15	7	2	1	3	28
OG0000497	4	4	10	2	8	28
OG0000498	28	0	0	0	0	28
OG0000499	1	15	2	10	0	28
OG0000500	9	10	2	3	4	28
OG0000501	27	1	0	0	0	28
OG0000502	6	5	5	8	4	28
OG0000503	4	4	3	1	16	28
OG0000504	5	7	7	2	7	28
OG0000505	6	9	4	4	5	28
OG0000506	28	0	0	0	0	28
OG0000507	3	9	5	8	3	28
OG0000508	8	7	5	3	5	28
OG0000509	4	10	7	2	5	28
OG0000510	1	0	8	0	19	28
OG0000511	2	21	3	1	1	28
OG0000512	2	11	1	13	1	28
OG0000513	1	13	5	4	5	28
OG0000514	0	28	0	0	0	28
OG0000515	0	28	0	0	0	28
OG0000516	0	28	0	0	0	28
OG0000517	0	28	0	0	0	28
OG0000518	0	6	22	0	0	28
OG0000519	0	0	25	0	3	28
OG0000520	0	0	19	0	9	28
OG0000521	0	0	1	25	2	28
OG0000522	10	1	6	5	5	27
OG0000523	27	0	0	0	0	27
OG0000524	5	1	4	8	9	27
OG0000525	6	10	4	3	4	27
OG0000526	2	0	16	8	1	27
OG0000527	27	0	0	0	0	27
OG0000528	27	0	0	0	0	27
OG0000529	6	3	4	2	12	27
OG0000530	6	2	6	1	12	27
OG0000531	6	8	3	3	7	27
OG0000532	9	7	4	4	3	27
OG0000533	4	3	10	5	5	27
OG0000534	27	0	0	0	0	27
OG0000535	7	8	5	2	5	27
OG0000536	18	3	2	1	3	27
OG0000537	27	0	0	0	0	27
OG0000538	4	7	5	5	6	27
OG0000539	9	4	5	4	5	27
OG0000540	2	16	4	2	3	27
OG0000541	7	8	6	2	4	27
OG0000542	17	3	3	3	1	27
OG0000543	6	3	9	1	8	27
OG0000544	5	10	4	4	4	27
OG0000545	6	3	15	1	2	27
OG0000546	5	6	13	1	2	27
OG0000547	27	0	0	0	0	27
OG0000548	8	8	7	2	2	27
OG0000549	6	10	4	3	4	27
OG0000550	6	8	4	4	5	27
OG0000551	1	0	24	0	2	27
OG0000552	2	4	2	17	2	27
OG0000553	8	2	4	7	6	27
OG0000554	2	3	12	3	7	27
OG0000555	5	10	5	3	4	27
OG0000556	14	5	3	4	1	27
OG0000557	9	5	3	5	5	27
OG0000558	2	6	15	0	4	27
OG0000559	3	11	4	4	5	27
OG0000560	1	4	9	7	6	27
OG0000561	2	5	12	4	4	27
OG0000562	1	15	4	3	4	27
OG0000563	0	27	0	0	0	27
OG0000564	0	27	0	0	0	27
OG0000565	0	27	0	0	0	27
OG0000566	0	27	0	0	0	27
OG0000567	0	25	0	1	1	27
OG0000568	0	27	0	0	0	27
OG0000569	0	27	0	0	0	27
OG0000570	0	5	15	2	5	27
OG0000571	0	27	0	0	0	27
OG0000572	0	27	0	0	0	27
OG0000573	0	27	0	0	0	27
OG0000574	0	27	0	0	0	27
OG0000575	0	2	21	1	3	27
OG0000576	0	0	26	0	1	27
OG0000577	0	0	6	0	21	27
OG0000578	0	0	27	0	0	27
OG0000579	0	0	1	0	26	27
OG0000580	0	0	0	0	27	27
OG0000581	0	0	0	0	27	27
OG0000582	22	1	1	2	0	26
OG0000583	13	4	4	2	3	26
OG0000584	16	6	1	1	2	26
OG0000585	10	11	2	2	1	26
OG0000586	8	5	4	5	4	26
OG0000587	4	5	5	6	6	26
OG0000588	26	0	0	0	0	26
OG0000589	26	0	0	0	0	26
OG0000590	26	0	0	0	0	26
OG0000591	8	8	4	2	4	26
OG0000592	26	0	0	0	0	26
OG0000593	6	1	2	16	1	26
OG0000594	6	1	17	0	2	26
OG0000595	22	3	0	0	1	26
OG0000596	26	0	0	0	0	26
OG0000597	7	7	5	3	4	26
OG0000598	6	3	5	6	6	26
OG0000599	10	5	6	1	4	26
OG0000600	1	8	8	3	6	26
OG0000601	5	5	6	4	6	26
OG0000602	26	0	0	0	0	26
OG0000603	4	9	5	3	5	26
OG0000604	6	8	4	3	5	26
OG0000605	5	8	2	9	2	26
OG0000606	11	6	1	5	3	26
OG0000607	4	0	16	3	3	26
OG0000608	6	10	4	3	3	26
OG0000609	6	8	4	4	4	26
OG0000610	9	4	6	3	4	26
OG0000611	8	3	4	5	6	26
OG0000612	9	8	2	4	3	26
OG0000613	8	12	2	2	2	26
OG0000614	7	6	4	4	5	26
OG0000615	6	7	6	1	6	26
OG0000616	6	9	1	3	7	26
OG0000617	3	5	9	7	2	26
OG0000618	4	0	6	5	11	26
OG0000619	4	14	0	6	2	26
OG0000620	5	5	4	6	6	26
OG0000621	12	2	5	5	2	26
OG0000622	1	0	21	0	4	26
OG0000623	2	0	17	1	6	26
OG0000624	3	1	8	8	6	26
OG0000625	0	26	0	0	0	26
OG0000626	0	26	0	0	0	26
OG0000627	0	10	5	7	4	26
OG0000628	0	26	0	0	0	26
OG0000629	0	26	0	0	0	26
OG0000630	0	26	0	0	0	26
OG0000631	0	26	0	0	0	26
OG0000632	0	26	0	0	0	26
OG0000633	0	3	0	23	0	26
OG0000634	0	25	0	0	1	26
OG0000635	0	13	7	2	4	26
OG0000636	0	2	22	0	2	26
OG0000637	0	0	21	0	5	26
OG0000638	0	0	8	0	18	26
OG0000639	0	0	0	26	0	26
OG0000640	0	0	0	26	0	26
OG0000641	0	0	0	0	26	26
OG0000642	0	0	0	0	26	26
OG0000643	0	0	0	0	26	26
OG0000644	25	0	0	0	0	25
OG0000645	25	0	0	0	0	25
OG0000646	7	4	10	2	2	25
OG0000647	25	0	0	0	0	25
OG0000648	4	12	4	2	3	25
OG0000649	12	2	3	2	6	25
OG0000650	5	8	4	3	5	25
OG0000651	5	10	3	4	3	25
OG0000652	19	2	2	1	1	25
OG0000653	6	10	4	2	3	25
OG0000654	5	7	5	3	5	25
OG0000655	6	6	4	4	5	25
OG0000656	6	4	5	4	6	25
OG0000657	20	2	1	1	1	25
OG0000658	8	7	3	3	4	25
OG0000659	25	0	0	0	0	25
OG0000660	10	6	3	3	3	25
OG0000661	8	7	2	4	4	25
OG0000662	6	10	3	2	4	25
OG0000663	7	6	5	2	5	25
OG0000664	5	11	3	2	4	25
OG0000665	6	2	6	6	5	25
OG0000666	5	13	4	1	2	25
OG0000667	4	10	4	3	4	25
OG0000668	6	5	6	4	4	25
OG0000669	4	2	17	1	1	25
OG0000670	2	15	2	4	2	25
OG0000671	7	8	3	3	4	25
OG0000672	5	13	1	2	4	25
OG0000673	5	10	3	4	3	25
OG0000674	7	12	2	3	1	25
OG0000675	5	9	3	3	5	25
OG0000676	8	1	5	4	7	25
OG0000677	25	0	0	0	0	25
OG0000678	1	24	0	0	0	25
OG0000679	8	6	4	3	4	25
OG0000680	8	6	3	3	5	25
OG0000681	25	0	0	0	0	25
OG0000682	5	11	2	4	3	25
OG0000683	8	10	3	3	1	25
OG0000684	5	0	2	16	2	25
OG0000685	14	4	6	0	1	25
OG0000686	3	2	18	0	2	25
OG0000687	1	18	0	2	4	25
OG0000688	6	8	4	3	4	25
OG0000689	2	10	5	6	2	25
OG0000690	4	1	6	7	7	25
OG0000691	4	7	2	6	6	25
OG0000692	4	14	6	0	1	25
OG0000693	4	3	14	0	4	25
OG0000694	8	12	2	1	2	25
OG0000695	2	12	6	2	3	25
OG0000696	3	11	5	2	4	25
OG0000697	2	12	4	4	3	25
OG0000698	2	4	6	10	3	25
OG0000699	1	2	16	0	6	25
OG0000700	0	25	0	0	0	25
OG0000701	0	25	0	0	0	25
OG0000702	0	25	0	0	0	25
OG0000703	0	17	2	2	4	25
OG0000704	0	25	0	0	0	25
OG0000705	0	4	20	0	1	25
OG0000706	0	25	0	0	0	25
OG0000707	0	25	0	0	0	25
OG0000708	0	0	2	0	23	25
OG0000709	0	0	24	0	1	25
OG0000710	0	0	2	2	21	25
OG0000711	0	0	0	25	0	25
OG0000712	0	0	0	25	0	25
OG0000713	0	0	0	25	0	25
OG0000714	0	0	0	0	25	25
OG0000715	10	0	0	12	2	24
OG0000716	8	6	3	5	2	24
OG0000717	3	1	14	2	4	24
OG0000718	9	4	2	4	5	24
OG0000719	4	4	7	2	7	24
OG0000720	4	11	3	4	2	24
OG0000721	6	10	3	3	2	24
OG0000722	6	6	5	4	3	24
OG0000723	3	3	14	0	4	24
OG0000724	6	1	3	0	14	24
OG0000725	3	7	1	1	12	24
OG0000726	9	2	3	4	6	24
OG0000727	5	8	4	3	4	24
OG0000728	24	0	0	0	0	24
OG0000729	6	5	4	3	6	24
OG0000730	9	7	2	4	2	24
OG0000731	7	5	3	4	5	24
OG0000732	4	7	5	3	5	24
OG0000733	8	8	3	2	3	24
OG0000734	5	1	10	6	2	24
OG0000735	4	14	2	2	2	24
OG0000736	24	0	0	0	0	24
OG0000737	7	4	1	9	3	24
OG0000738	24	0	0	0	0	24
OG0000739	5	9	4	3	3	24
OG0000740	3	3	11	3	4	24
OG0000741	2	10	5	3	4	24
OG0000742	7	6	2	5	4	24
OG0000743	6	8	4	2	4	24
OG0000744	8	4	3	5	4	24
OG0000745	7	6	3	4	4	24
OG0000746	9	4	3	6	2	24
OG0000747	4	2	9	3	6	24
OG0000748	6	7	4	3	4	24
OG0000749	5	1	7	6	5	24
OG0000750	6	8	2	5	3	24
OG0000751	6	11	2	2	3	24
OG0000752	3	14	2	1	4	24
OG0000753	2	13	2	5	2	24
OG0000754	2	0	3	13	6	24
OG0000755	11	3	3	3	4	24
OG0000756	5	11	1	4	3	24
OG0000757	6	4	5	7	2	24
OG0000758	5	1	13	1	4	24
OG0000759	8	7	4	1	4	24
OG0000760	5	7	3	3	6	24
OG0000761	4	12	3	2	3	24
OG0000762	4	0	7	9	4	24
OG0000763	4	3	10	6	1	24
OG0000764	24	0	0	0	0	24
OG0000765	6	5	4	4	5	24
OG0000766	2	2	4	1	15	24
OG0000767	4	10	5	2	3	24
OG0000768	5	4	4	3	8	24
OG0000769	6	11	4	2	1	24
OG0000770	2	3	15	1	3	24
OG0000771	2	0	5	1	16	24
OG0000772	1	0	21	0	2	24
OG0000773	2	7	7	3	5	24
OG0000774	2	8	2	7	5	24
OG0000775	4	14	3	1	2	24
OG0000776	2	6	6	7	3	24
OG0000777	1	5	9	6	3	24
OG0000778	0	24	0	0	0	24
OG0000779	0	24	0	0	0	24
OG0000780	0	24	0	0	0	24
OG0000781	0	2	11	0	11	24
OG0000782	0	24	0	0	0	24
OG0000783	0	24	0	0	0	24
OG0000784	0	24	0	0	0	24
OG0000785	0	1	22	0	1	24
OG0000786	0	23	0	0	1	24
OG0000787	0	4	1	19	0	24
OG0000788	0	0	10	0	14	24
OG0000789	0	0	21	0	3	24
OG0000790	0	0	3	1	20	24
OG0000791	0	0	1	0	23	24
OG0000792	0	0	0	24	0	24
OG0000793	0	0	0	24	0	24
OG0000794	0	0	0	0	24	24
OG0000795	0	0	0	0	24	24
OG0000796	0	0	0	0	24	24
OG0000797	0	0	0	0	24	24
OG0000798	23	0	0	0	0	23
OG0000799	5	2	7	4	5	23
OG0000800	8	4	2	6	3	23
OG0000801	23	0	0	0	0	23
OG0000802	6	11	2	2	2	23
OG0000803	23	0	0	0	0	23
OG0000804	16	3	2	1	1	23
OG0000805	1	11	4	4	3	23
OG0000806	4	5	11	1	2	23
OG0000807	6	10	3	1	3	23
OG0000808	19	2	0	1	1	23
OG0000809	11	6	2	2	2	23
OG0000810	23	0	0	0	0	23
OG0000811	4	6	5	3	5	23
OG0000812	8	8	2	2	3	23
OG0000813	4	7	5	2	5	23
OG0000814	2	14	2	2	3	23
OG0000815	5	2	6	3	7	23
OG0000816	23	0	0	0	0	23
OG0000817	3	2	17	0	1	23
OG0000818	6	11	2	2	2	23
OG0000819	16	4	1	1	1	23
OG0000820	7	7	3	3	3	23
OG0000821	8	8	1	3	3	23
OG0000822	4	14	1	2	2	23
OG0000823	3	9	3	5	3	23
OG0000824	10	7	1	2	3	23
OG0000825	2	11	4	2	4	23
OG0000826	1	20	1	1	0	23
OG0000827	4	8	3	2	6	23
OG0000828	4	6	5	4	4	23
OG0000829	6	8	3	1	5	23
OG0000830	4	14	2	1	2	23
OG0000831	2	3	8	5	5	23
OG0000832	6	0	11	4	2	23
OG0000833	7	0	11	0	5	23
OG0000834	6	3	6	3	5	23
OG0000835	4	12	2	2	3	23
OG0000836	6	4	6	3	4	23
OG0000837	4	14	1	2	2	23
OG0000838	4	11	3	2	3	23
OG0000839	13	6	1	2	1	23
OG0000840	5	2	15	0	1	23
OG0000841	2	0	2	2	17	23
OG0000842	5	11	2	2	3	23
OG0000843	3	12	1	6	1	23
OG0000844	2	13	3	2	3	23
OG0000845	6	4	5	3	5	23
OG0000846	6	6	6	2	3	23
OG0000847	7	6	4	3	3	23
OG0000848	20	0	2	1	0	23
OG0000849	4	0	2	16	1	23
OG0000850	1	3	9	9	1	23
OG0000851	1	7	10	4	1	23
OG0000852	0	23	0	0	0	23
OG0000853	0	23	0	0	0	23
OG0000854	0	23	0	0	0	23
OG0000855	0	23	0	0	0	23
OG0000856	0	23	0	0	0	23
OG0000857	0	23	0	0	0	23
OG0000858	0	23	0	0	0	23
OG0000859	0	5	11	1	6	23
OG0000860	0	1	22	0	0	23
OG0000861	0	0	22	0	1	23
OG0000862	0	0	21	0	2	23
OG0000863	0	0	19	0	4	23
OG0000864	0	0	2	0	21	23
OG0000865	0	0	9	0	14	23
OG0000866	0	0	1	0	22	23
OG0000867	0	0	4	0	19	23
OG0000868	0	0	1	21	1	23
OG0000869	0	0	0	0	23	23
OG0000870	0	0	0	0	23	23
OG0000871	0	0	0	0	23	23
OG0000872	0	0	0	0	23	23
OG0000873	21	0	1	0	0	22
OG0000874	21	0	0	0	1	22
OG0000875	8	11	1	1	1	22
OG0000876	17	3	1	1	0	22
OG0000877	18	2	1	1	0	22
OG0000878	22	0	0	0	0	22
OG0000879	3	12	2	4	1	22
OG0000880	8	6	2	3	3	22
OG0000881	6	6	4	2	4	22
OG0000882	6	12	1	2	1	22
OG0000883	6	6	3	3	4	22
OG0000884	6	4	5	2	5	22
OG0000885	8	4	4	3	3	22
OG0000886	22	0	0	0	0	22
OG0000887	22	0	0	0	0	22
OG0000888	11	4	3	1	3	22
OG0000889	8	8	1	3	2	22
OG0000890	22	0	0	0	0	22
OG0000891	22	0	0	0	0	22
OG0000892	9	2	4	3	4	22
OG0000893	4	0	15	0	3	22
OG0000894	8	6	3	2	3	22
OG0000895	22	0	0	0	0	22
OG0000896	22	0	0	0	0	22
OG0000897	8	5	3	3	3	22
OG0000898	7	10	2	2	1	22
OG0000899	9	4	3	3	3	22
OG0000900	2	13	3	1	3	22
OG0000901	4	5	5	3	5	22
OG0000902	2	4	4	11	1	22
OG0000903	5	2	1	13	1	22
OG0000904	6	10	3	1	2	22
OG0000905	4	8	5	2	3	22
OG0000906	3	17	1	1	0	22
OG0000907	4	11	3	2	2	22
OG0000908	3	9	3	3	4	22
OG0000909	7	6	4	2	3	22
OG0000910	4	6	6	3	3	22
OG0000911	5	2	4	7	4	22
OG0000912	7	6	1	5	3	22
OG0000913	4	8	4	3	3	22
OG0000914	4	8	4	4	2	22
OG0000915	22	0	0	0	0	22
OG0000916	6	1	3	11	1	22
OG0000917	22	0	0	0	0	22
OG0000918	9	5	4	2	2	22
OG0000919	6	12	2	1	1	22
OG0000920	4	0	16	0	2	22
OG0000921	7	9	3	2	1	22
OG0000922	6	6	4	2	4	22
OG0000923	3	6	5	3	5	22
OG0000924	4	9	3	3	3	22
OG0000925	8	5	3	3	3	22
OG0000926	6	9	3	1	3	22
OG0000927	6	10	1	2	3	22
OG0000928	2	0	2	1	17	22
OG0000929	3	10	2	4	3	22
OG0000930	6	6	3	5	2	22
OG0000931	6	9	3	2	2	22
OG0000932	3	10	4	1	4	22
OG0000933	8	4	4	2	4	22
OG0000934	4	10	3	3	2	22
OG0000935	3	11	1	2	5	22
OG0000936	10	2	8	1	1	22
OG0000937	6	6	5	2	3	22
OG0000938	5	8	5	2	2	22
OG0000939	5	4	12	0	1	22
OG0000940	3	8	2	3	6	22
OG0000941	4	5	4	5	4	22
OG0000942	10	1	2	7	2	22
OG0000943	1	1	18	0	2	22
OG0000944	6	5	5	3	3	22
OG0000945	2	11	3	2	4	22
OG0000946	4	10	3	2	3	22
OG0000947	3	9	4	2	4	22
OG0000948	1	3	1	7	10	22
OG0000949	22	0	0	0	0	22
OG0000950	4	7	4	2	5	22
OG0000951	6	5	10	0	1	22
OG0000952	2	0	0	20	0	22
OG0000953	2	0	0	20	0	22
OG0000954	0	22	0	0	0	22
OG0000955	0	22	0	0	0	22
OG0000956	0	22	0	0	0	22
OG0000957	0	22	0	0	0	22
OG0000958	0	22	0	0	0	22
OG0000959	0	12	4	2	4	22
OG0000960	0	22	0	0	0	22
OG0000961	0	22	0	0	0	22
OG0000962	0	22	0	0	0	22
OG0000963	0	22	0	0	0	22
OG0000964	0	22	0	0	0	22
OG0000965	0	22	0	0	0	22
OG0000966	0	16	3	1	2	22
OG0000967	0	9	4	6	3	22
OG0000968	0	22	0	0	0	22
OG0000969	0	22	0	0	0	22
OG0000970	0	0	20	0	2	22
OG0000971	0	0	9	0	13	22
OG0000972	0	0	20	1	1	22
OG0000973	0	0	7	0	15	22
OG0000974	0	0	1	0	21	22
OG0000975	0	0	20	0	2	22
OG0000976	0	0	1	21	0	22
OG0000977	0	0	0	0	22	22
OG0000978	4	13	1	2	1	21
OG0000979	10	7	1	1	2	21
OG0000980	21	0	0	0	0	21
OG0000981	21	0	0	0	0	21
OG0000982	12	4	2	1	2	21
OG0000983	21	0	0	0	0	21
OG0000984	8	7	1	3	2	21
OG0000985	6	4	4	3	4	21
OG0000986	21	0	0	0	0	21
OG0000987	6	8	3	2	2	21
OG0000988	6	6	4	2	3	21
OG0000989	6	9	2	2	2	21
OG0000990	11	4	2	1	3	21
OG0000991	8	4	3	2	4	21
OG0000992	13	4	2	1	1	21
OG0000993	7	3	4	2	5	21
OG0000994	21	0	0	0	0	21
OG0000995	7	3	4	3	4	21
OG0000996	6	9	2	2	2	21
OG0000997	10	4	2	2	3	21
OG0000998	4	6	4	3	4	21
OG0000999	6	8	2	2	3	21
OG0001000	3	10	1	6	1	21
OG0001001	8	4	4	2	3	21
OG0001002	4	6	5	2	4	21
OG0001003	6	5	4	4	2	21
OG0001004	6	4	4	3	4	21
OG0001005	4	4	10	0	3	21
OG0001006	6	5	8	0	2	21
OG0001007	2	6	4	3	6	21
OG0001008	6	7	2	3	3	21
OG0001009	2	3	2	1	13	21
OG0001010	20	0	0	1	0	21
OG0001011	5	4	3	4	5	21
OG0001012	7	3	4	5	2	21
OG0001013	4	11	2	2	2	21
OG0001014	4	0	7	3	7	21
OG0001015	4	9	3	2	3	21
OG0001016	4	10	2	2	3	21
OG0001017	6	6	2	5	2	21
OG0001018	4	6	5	2	4	21
OG0001019	7	8	2	2	2	21
OG0001020	10	6	2	0	3	21
OG0001021	7	5	4	2	3	21
OG0001022	4	9	2	2	4	21
OG0001023	4	0	14	0	3	21
OG0001024	4	8	2	3	4	21
OG0001025	12	4	2	2	1	21
OG0001026	21	0	0	0	0	21
OG0001027	4	11	2	1	3	21
OG0001028	6	11	1	2	1	21
OG0001029	8	6	2	2	3	21
OG0001030	7	10	1	2	1	21
OG0001031	1	9	3	3	5	21
OG0001032	3	3	0	2	13	21
OG0001033	6	10	2	1	2	21
OG0001034	1	10	4	2	4	21
OG0001035	21	0	0	0	0	21
OG0001036	4	8	4	2	3	21
OG0001037	4	7	3	3	4	21
OG0001038	2	9	5	3	2	21
OG0001039	8	6	3	2	2	21
OG0001040	8	4	2	3	4	21
OG0001041	21	0	0	0	0	21
OG0001042	6	3	3	4	5	21
OG0001043	4	11	2	2	2	21
OG0001044	5	7	3	2	4	21
OG0001045	7	5	5	1	3	21
OG0001046	8	1	4	4	4	21
OG0001047	7	8	2	3	1	21
OG0001048	6	6	2	4	3	21
OG0001049	2	3	8	3	5	21
OG0001050	4	0	6	2	9	21
OG0001051	4	10	2	3	2	21
OG0001052	6	6	3	3	3	21
OG0001053	4	9	2	4	2	21
OG0001054	8	4	3	3	3	21
OG0001055	2	12	2	2	3	21
OG0001056	5	8	2	2	4	21
OG0001057	6	3	4	5	3	21
OG0001058	2	1	17	0	1	21
OG0001059	6	8	3	2	2	21
OG0001060	1	2	9	0	9	21
OG0001061	2	7	3	2	7	21
OG0001062	6	4	5	3	3	21
OG0001063	6	7	3	3	2	21
OG0001064	4	11	3	1	2	21
OG0001065	2	0	1	14	4	21
OG0001066	4	5	3	3	6	21
OG0001067	3	8	5	2	3	21
OG0001068	14	0	1	5	1	21
OG0001069	4	8	3	2	4	21
OG0001070	3	7	3	4	4	21
OG0001071	2	16	1	1	1	21
OG0001072	6	4	3	7	1	21
OG0001073	7	8	2	2	2	21
OG0001074	4	7	4	3	3	21
OG0001075	2	12	2	4	1	21
OG0001076	2	12	2	2	3	21
OG0001077	5	6	3	3	4	21
OG0001078	4	8	2	3	4	21
OG0001079	3	4	9	0	5	21
OG0001080	1	0	20	0	0	21
OG0001081	2	1	7	5	6	21
OG0001082	0	21	0	0	0	21
OG0001083	0	16	3	0	2	21
OG0001084	0	21	0	0	0	21
OG0001085	0	21	0	0	0	21
OG0001086	0	21	0	0	0	21
OG0001087	0	21	0	0	0	21
OG0001088	0	21	0	0	0	21
OG0001089	0	21	0	0	0	21
OG0001090	0	21	0	0	0	21
OG0001091	0	5	10	5	1	21
OG0001092	0	1	1	1	18	21
OG0001093	0	21	0	0	0	21
OG0001094	0	21	0	0	0	21
OG0001095	0	21	0	0	0	21
OG0001096	0	21	0	0	0	21
OG0001097	0	1	19	1	0	21
OG0001098	0	0	21	0	0	21
OG0001099	0	0	19	0	2	21
OG0001100	0	0	2	0	19	21
OG0001101	0	0	17	0	4	21
OG0001102	0	0	19	0	2	21
OG0001103	0	0	14	1	6	21
OG0001104	0	0	0	21	0	21
OG0001105	0	0	0	0	21	21
OG0001106	9	8	1	1	1	20
OG0001107	12	0	4	4	0	20
OG0001108	7	2	4	3	4	20
OG0001109	5	6	2	6	1	20
OG0001110	11	5	1	1	2	20
OG0001111	6	6	4	2	2	20
OG0001112	4	10	3	1	2	20
OG0001113	15	2	1	1	1	20
OG0001114	20	0	0	0	0	20
OG0001115	7	1	4	4	4	20
OG0001116	2	11	4	1	2	20
OG0001117	20	0	0	0	0	20
OG0001118	20	0	0	0	0	20
OG0001119	4	13	1	1	1	20
OG0001120	20	0	0	0	0	20
OG0001121	4	13	1	1	1	20
OG0001122	20	0	0	0	0	20
OG0001123	6	5	5	2	2	20
OG0001124	8	3	2	3	4	20
OG0001125	4	4	2	2	8	20
OG0001126	20	0	0	0	0	20
OG0001127	6	4	4	2	4	20
OG0001128	6	2	4	2	6	20
OG0001129	10	1	8	0	1	20
OG0001130	4	7	3	2	4	20
OG0001131	8	4	4	2	2	20
OG0001132	4	2	6	5	3	20
OG0001133	6	2	5	2	5	20
OG0001134	4	5	3	4	4	20
OG0001135	4	4	4	6	2	20
OG0001136	5	7	3	3	2	20
OG0001137	4	10	2	2	2	20
OG0001138	6	6	2	3	3	20
OG0001139	10	1	3	0	6	20
OG0001140	6	5	4	2	3	20
OG0001141	6	6	2	3	3	20
OG0001142	6	6	2	4	2	20
OG0001143	3	6	3	3	5	20
OG0001144	6	5	2	4	3	20
OG0001145	5	7	3	2	3	20
OG0001146	5	7	3	3	2	20
OG0001147	4	8	3	2	3	20
OG0001148	8	5	3	2	2	20
OG0001149	4	4	4	2	6	20
OG0001150	3	0	13	0	4	20
OG0001151	4	2	6	3	5	20
OG0001152	6	6	2	3	3	20
OG0001153	3	9	3	2	3	20
OG0001154	6	8	2	2	2	20
OG0001155	18	0	2	0	0	20
OG0001156	19	0	0	1	0	20
OG0001157	1	2	7	7	3	20
OG0001158	3	5	6	4	2	20
OG0001159	7	7	2	2	2	20
OG0001160	5	6	3	3	3	20
OG0001161	5	4	4	3	4	20
OG0001162	20	0	0	0	0	20
OG0001163	8	6	2	2	2	20
OG0001164	6	5	3	3	3	20
OG0001165	6	3	4	3	4	20
OG0001166	3	7	3	2	5	20
OG0001167	6	4	3	3	4	20
OG0001168	20	0	0	0	0	20
OG0001169	6	4	9	0	1	20
OG0001170	4	6	5	1	4	20
OG0001171	6	6	2	3	3	20
OG0001172	5	9	2	3	1	20
OG0001173	9	1	3	6	1	20
OG0001174	5	8	2	2	3	20
OG0001175	3	6	5	2	4	20
OG0001176	5	6	4	2	3	20
OG0001177	3	5	7	1	4	20
OG0001178	5	1	5	4	5	20
OG0001179	5	4	9	1	1	20
OG0001180	2	10	4	1	3	20
OG0001181	5	8	3	1	3	20
OG0001182	5	6	4	3	2	20
OG0001183	6	7	2	2	3	20
OG0001184	9	1	4	2	4	20
OG0001185	5	0	12	0	3	20
OG0001186	4	8	3	2	3	20
OG0001187	2	7	4	3	4	20
OG0001188	8	4	2	3	3	20
OG0001189	3	7	3	2	5	20
OG0001190	4	7	3	2	4	20
OG0001191	2	10	2	3	3	20
OG0001192	4	9	1	2	4	20
OG0001193	4	0	9	6	1	20
OG0001194	2	8	0	7	3	20
OG0001195	3	9	2	4	2	20
OG0001196	4	2	3	7	4	20
OG0001197	4	5	4	3	4	20
OG0001198	5	6	2	3	4	20
OG0001199	6	6	3	2	3	20
OG0001200	7	5	2	2	4	20
OG0001201	13	4	1	1	1	20
OG0001202	6	9	2	2	1	20
OG0001203	4	11	2	1	2	20
OG0001204	2	10	3	1	4	20
OG0001205	6	6	2	3	3	20
OG0001206	2	4	2	1	11	20
OG0001207	2	11	3	1	3	20
OG0001208	4	12	1	2	1	20
OG0001209	2	15	1	1	1	20
OG0001210	2	8	5	2	3	20
OG0001211	4	4	3	5	4	20
OG0001212	1	9	5	3	2	20
OG0001213	6	7	3	2	2	20
OG0001214	2	8	4	1	5	20
OG0001215	2	6	2	2	8	20
OG0001216	3	11	4	1	1	20
OG0001217	6	8	2	2	2	20
OG0001218	2	12	1	1	4	20
OG0001219	4	8	3	2	3	20
OG0001220	1	12	2	2	3	20
OG0001221	3	3	11	1	2	20
OG0001222	3	2	10	0	5	20
OG0001223	4	1	8	2	5	20
OG0001224	2	0	1	0	17	20
OG0001225	2	10	3	1	4	20
OG0001226	2	6	5	4	3	20
OG0001227	2	5	10	0	3	20
OG0001228	1	6	6	2	5	20
OG0001229	1	15	1	2	1	20
OG0001230	1	3	3	1	12	20
OG0001231	0	20	0	0	0	20
OG0001232	0	5	6	6	3	20
OG0001233	0	20	0	0	0	20
OG0001234	0	20	0	0	0	20
OG0001235	0	20	0	0	0	20
OG0001236	0	20	0	0	0	20
OG0001237	0	20	0	0	0	20
OG0001238	0	20	0	0	0	20
OG0001239	0	20	0	0	0	20
OG0001240	0	20	0	0	0	20
OG0001241	0	20	0	0	0	20
OG0001242	0	20	0	0	0	20
OG0001243	0	20	0	0	0	20
OG0001244	0	20	0	0	0	20
OG0001245	0	20	0	0	0	20
OG0001246	0	7	8	2	3	20
OG0001247	0	2	16	2	0	20
OG0001248	0	1	19	0	0	20
OG0001249	0	0	20	0	0	20
OG0001250	0	0	13	2	5	20
OG0001251	0	0	17	0	3	20
OG0001252	0	0	19	0	1	20
OG0001253	0	0	1	0	19	20
OG0001254	0	0	7	6	7	20
OG0001255	0	0	0	20	0	20
OG0001256	0	0	0	20	0	20
OG0001257	0	0	0	20	0	20
OG0001258	0	0	0	20	0	20
OG0001259	0	0	0	0	20	20
OG0001260	0	0	0	0	20	20
OG0001261	0	0	0	0	20	20
OG0001262	0	0	0	0	20	20
OG0001263	14	2	1	1	1	19
OG0001264	4	7	4	1	3	19
OG0001265	4	9	2	2	2	19
OG0001266	9	7	1	1	1	19
OG0001267	13	3	1	1	1	19
OG0001268	3	11	2	1	2	19
OG0001269	4	4	4	2	5	19
OG0001270	6	7	2	2	2	19
OG0001271	8	3	4	2	2	19
OG0001272	5	12	0	2	0	19
OG0001273	6	5	3	3	2	19
OG0001274	7	5	2	3	2	19
OG0001275	8	7	1	1	2	19
OG0001276	6	5	4	1	3	19
OG0001277	9	0	4	2	4	19
OG0001278	2	0	6	9	2	19
OG0001279	5	0	2	3	9	19
OG0001280	5	5	3	3	3	19
OG0001281	3	6	2	5	3	19
OG0001282	2	8	3	3	3	19
OG0001283	3	8	3	2	3	19
OG0001284	4	3	2	1	9	19
OG0001285	19	0	0	0	0	19
OG0001286	8	4	1	2	4	19
OG0001287	4	5	3	2	5	19
OG0001288	6	4	4	2	3	19
OG0001289	8	3	3	2	3	19
OG0001290	8	3	3	2	3	19
OG0001291	19	0	0	0	0	19
OG0001292	1	1	8	0	9	19
OG0001293	18	0	0	0	1	19
OG0001294	7	2	3	2	5	19
OG0001295	12	2	1	1	3	19
OG0001296	9	3	5	1	1	19
OG0001297	6	7	2	2	2	19
OG0001298	6	2	5	3	3	19
OG0001299	2	14	1	2	0	19
OG0001300	5	4	4	2	4	19
OG0001301	11	5	1	1	1	19
OG0001302	4	9	2	2	2	19
OG0001303	8	0	4	2	5	19
OG0001304	7	6	2	2	2	19
OG0001305	2	8	4	2	3	19
OG0001306	4	4	4	2	5	19
OG0001307	19	0	0	0	0	19
OG0001308	6	2	5	2	4	19
OG0001309	4	3	4	3	5	19
OG0001310	4	5	3	2	5	19
OG0001311	19	0	0	0	0	19
OG0001312	6	1	5	2	5	19
OG0001313	8	4	2	3	2	19
OG0001314	4	7	4	2	2	19
OG0001315	2	8	2	5	2	19
OG0001316	6	4	4	2	3	19
OG0001317	4	6	3	3	3	19
OG0001318	4	10	2	1	2	19
OG0001319	7	5	2	2	3	19
OG0001320	19	0	0	0	0	19
OG0001321	7	2	1	9	0	19
OG0001322	2	9	3	1	4	19
OG0001323	1	0	9	3	6	19
OG0001324	4	10	2	2	1	19
OG0001325	4	3	5	5	2	19
OG0001326	9	8	0	1	1	19
OG0001327	4	9	2	1	3	19
OG0001328	19	0	0	0	0	19
OG0001329	10	2	3	2	2	19
OG0001330	4	5	3	2	5	19
OG0001331	4	6	3	2	4	19
OG0001332	6	4	1	2	6	19
OG0001333	7	5	2	3	2	19
OG0001334	5	3	5	2	4	19
OG0001335	4	9	2	2	2	19
OG0001336	6	6	3	1	3	19
OG0001337	5	5	3	3	3	19
OG0001338	6	3	5	2	3	19
OG0001339	6	4	4	2	3	19
OG0001340	13	3	1	1	1	19
OG0001341	6	7	2	2	2	19
OG0001342	4	9	2	2	2	19
OG0001343	4	11	1	1	2	19
OG0001344	6	4	2	3	4	19
OG0001345	6	4	4	2	3	19
OG0001346	4	9	3	0	3	19
OG0001347	7	4	2	2	4	19
OG0001348	12	4	1	1	1	19
OG0001349	4	9	1	1	4	19
OG0001350	5	2	3	2	7	19
OG0001351	7	5	2	2	3	19
OG0001352	4	10	3	1	1	19
OG0001353	7	6	2	2	2	19
OG0001354	2	1	4	10	2	19
OG0001355	6	6	2	3	2	19
OG0001356	6	3	4	2	4	19
OG0001357	5	2	5	3	4	19
OG0001358	2	12	2	1	2	19
OG0001359	4	4	3	5	3	19
OG0001360	11	4	1	1	2	19
OG0001361	4	9	2	2	2	19
OG0001362	6	3	4	2	4	19
OG0001363	9	0	1	7	2	19
OG0001364	2	0	5	3	9	19
OG0001365	3	0	1	0	15	19
OG0001366	7	8	1	2	1	19
OG0001367	3	11	2	1	2	19
OG0001368	2	6	4	2	5	19
OG0001369	2	6	4	2	5	19
OG0001370	6	7	2	2	2	19
OG0001371	4	6	3	3	3	19
OG0001372	4	8	3	1	3	19
OG0001373	4	3	3	2	7	19
OG0001374	6	5	3	2	3	19
OG0001375	6	0	3	8	2	19
OG0001376	2	9	3	2	3	19
OG0001377	2	12	2	1	2	19
OG0001378	6	7	2	2	2	19
OG0001379	1	9	3	3	3	19
OG0001380	5	2	5	2	5	19
OG0001381	4	8	2	3	2	19
OG0001382	6	4	3	3	3	19
OG0001383	5	7	2	3	2	19
OG0001384	4	9	2	2	2	19
OG0001385	6	7	1	2	3	19
OG0001386	2	10	2	2	3	19
OG0001387	4	6	4	2	3	19
OG0001388	4	6	2	2	5	19
OG0001389	1	0	0	18	0	19
OG0001390	5	4	3	3	4	19
OG0001391	7	1	3	4	4	19
OG0001392	6	1	4	3	5	19
OG0001393	4	11	1	2	1	19
OG0001394	2	14	1	1	1	19
OG0001395	6	7	2	2	2	19
OG0001396	5	4	3	3	4	19
OG0001397	2	4	3	8	2	19
OG0001398	6	4	2	2	5	19
OG0001399	2	6	5	2	4	19
OG0001400	3	5	6	2	3	19
OG0001401	2	9	1	5	2	19
OG0001402	4	3	1	10	1	19
OG0001403	5	1	10	0	3	19
OG0001404	19	0	0	0	0	19
OG0001405	2	7	4	3	3	19
OG0001406	4	6	1	2	6	19
OG0001407	6	5	3	4	1	19
OG0001408	1	7	3	1	7	19
OG0001409	2	9	3	2	3	19
OG0001410	2	2	7	6	2	19
OG0001411	1	2	14	0	2	19
OG0001412	1	18	0	0	0	19
OG0001413	1	18	0	0	0	19
OG0001414	0	19	0	0	0	19
OG0001415	0	19	0	0	0	19
OG0001416	0	19	0	0	0	19
OG0001417	0	19	0	0	0	19
OG0001418	0	2	16	0	1	19
OG0001419	0	19	0	0	0	19
OG0001420	0	19	0	0	0	19
OG0001421	0	19	0	0	0	19
OG0001422	0	19	0	0	0	19
OG0001423	0	19	0	0	0	19
OG0001424	0	19	0	0	0	19
OG0001425	0	19	0	0	0	19
OG0001426	0	19	0	0	0	19
OG0001427	0	19	0	0	0	19
OG0001428	0	19	0	0	0	19
OG0001429	0	19	0	0	0	19
OG0001430	0	19	0	0	0	19
OG0001431	0	19	0	0	0	19
OG0001432	0	19	0	0	0	19
OG0001433	0	19	0	0	0	19
OG0001434	0	19	0	0	0	19
OG0001435	0	19	0	0	0	19
OG0001436	0	1	9	0	9	19
OG0001437	0	2	0	17	0	19
OG0001438	0	1	18	0	0	19
OG0001439	0	0	18	0	1	19
OG0001440	0	0	14	0	5	19
OG0001441	0	0	6	9	4	19
OG0001442	0	0	16	0	3	19
OG0001443	0	0	15	0	4	19
OG0001444	0	0	19	0	0	19
OG0001445	0	0	1	0	18	19
OG0001446	0	0	15	0	4	19
OG0001447	0	0	0	17	2	19
OG0001448	0	0	0	19	0	19
OG0001449	0	0	0	19	0	19
OG0001450	0	0	0	19	0	19
OG0001451	0	0	0	0	19	19
OG0001452	8	6	1	2	1	18
OG0001453	5	2	6	4	1	18
OG0001454	18	0	0	0	0	18
OG0001455	2	4	8	2	2	18
OG0001456	18	0	0	0	0	18
OG0001457	6	1	4	3	4	18
OG0001458	4	2	2	5	5	18
OG0001459	2	10	1	1	4	18
OG0001460	6	9	1	1	1	18
OG0001461	11	2	2	1	2	18
OG0001462	18	0	0	0	0	18
OG0001463	5	6	2	2	3	18
OG0001464	2	5	4	4	3	18
OG0001465	8	4	1	3	2	18
OG0001466	6	6	2	2	2	18
OG0001467	7	6	2	2	1	18
OG0001468	18	0	0	0	0	18
OG0001469	7	2	3	3	3	18
OG0001470	6	5	1	4	2	18
OG0001471	6	1	3	2	6	18
OG0001472	6	6	3	1	2	18
OG0001473	5	6	3	1	3	18
OG0001474	4	9	2	1	2	18
OG0001475	8	7	2	0	1	18
OG0001476	8	3	3	3	1	18
OG0001477	5	6	1	2	4	18
OG0001478	6	3	2	3	4	18
OG0001479	2	6	4	3	3	18
OG0001480	13	2	1	1	1	18
OG0001481	16	2	0	0	0	18
OG0001482	1	17	0	0	0	18
OG0001483	4	8	2	2	2	18
OG0001484	18	0	0	0	0	18
OG0001485	18	0	0	0	0	18
OG0001486	8	0	5	1	4	18
OG0001487	4	7	3	2	2	18
OG0001488	9	6	1	1	1	18
OG0001489	8	4	2	2	2	18
OG0001490	7	5	2	2	2	18
OG0001491	8	3	3	2	2	18
OG0001492	6	5	2	2	3	18
OG0001493	4	6	3	2	3	18
OG0001494	2	7	4	2	3	18
OG0001495	4	6	3	2	3	18
OG0001496	4	4	3	5	2	18
OG0001497	6	6	1	4	1	18
OG0001498	2	7	3	2	4	18
OG0001499	8	2	4	2	2	18
OG0001500	3	4	5	2	4	18
OG0001501	6	7	2	2	1	18
OG0001502	18	0	0	0	0	18
OG0001503	4	6	2	3	3	18
OG0001504	6	0	3	5	4	18
OG0001505	7	5	1	4	1	18
OG0001506	3	8	2	3	2	18
OG0001507	4	7	1	3	3	18
OG0001508	2	5	6	2	3	18
OG0001509	6	6	2	2	2	18
OG0001510	11	4	1	1	1	18
OG0001511	2	7	4	2	3	18
OG0001512	2	6	3	3	4	18
OG0001513	5	6	2	2	3	18
OG0001514	3	9	4	1	1	18
OG0001515	4	6	3	2	3	18
OG0001516	4	7	3	2	2	18
OG0001517	2	9	2	2	3	18
OG0001518	4	9	1	2	2	18
OG0001519	18	0	0	0	0	18
OG0001520	2	6	4	3	3	18
OG0001521	6	5	3	2	2	18
OG0001522	17	0	0	0	1	18
OG0001523	3	12	1	1	1	18
OG0001524	7	4	4	2	1	18
OG0001525	5	2	4	3	4	18
OG0001526	4	3	3	4	4	18
OG0001527	2	2	7	1	6	18
OG0001528	4	8	2	2	2	18
OG0001529	4	10	2	1	1	18
OG0001530	3	7	4	1	3	18
OG0001531	2	2	12	1	1	18
OG0001532	4	6	3	2	3	18
OG0001533	2	7	2	3	4	18
OG0001534	3	10	1	2	2	18
OG0001535	6	5	2	3	2	18
OG0001536	18	0	0	0	0	18
OG0001537	5	4	3	3	3	18
OG0001538	2	16	0	0	0	18
OG0001539	4	6	4	1	3	18
OG0001540	4	6	3	2	3	18
OG0001541	3	8	3	2	2	18
OG0001542	8	6	1	2	1	18
OG0001543	4	4	4	2	4	18
OG0001544	3	6	4	2	3	18
OG0001545	4	9	2	1	2	18
OG0001546	2	10	2	2	2	18
OG0001547	6	5	2	2	3	18
OG0001548	5	1	3	7	2	18
OG0001549	4	3	5	4	2	18
OG0001550	2	8	4	4	0	18
OG0001551	6	6	1	4	1	18
OG0001552	2	4	5	3	4	18
OG0001553	8	4	2	2	2	18
OG0001554	7	5	2	2	2	18
OG0001555	4	4	4	2	4	18
OG0001556	6	7	2	1	2	18
OG0001557	4	6	4	3	1	18
OG0001558	4	8	2	2	2	18
OG0001559	2	12	2	1	1	18
OG0001560	8	0	4	2	4	18
OG0001561	6	2	4	1	5	18
OG0001562	4	6	3	3	2	18
OG0001563	4	4	5	3	2	18
OG0001564	3	8	3	1	3	18
OG0001565	4	5	3	3	3	18
OG0001566	2	6	5	2	3	18
OG0001567	2	0	3	11	2	18
OG0001568	4	6	4	1	3	18
OG0001569	4	6	3	2	3	18
OG0001570	6	2	3	6	1	18
OG0001571	5	5	3	4	1	18
OG0001572	1	16	0	1	0	18
OG0001573	4	9	1	2	2	18
OG0001574	4	2	4	2	6	18
OG0001575	2	11	2	1	2	18
OG0001576	2	8	2	2	4	18
OG0001577	15	0	0	3	0	18
OG0001578	2	9	2	2	3	18
OG0001579	5	7	1	3	2	18
OG0001580	10	4	1	2	1	18
OG0001581	7	4	2	3	2	18
OG0001582	2	10	2	1	3	18
OG0001583	8	6	2	1	1	18
OG0001584	2	11	2	1	2	18
OG0001585	4	4	3	3	4	18
OG0001586	4	8	4	1	1	18
OG0001587	6	0	2	9	1	18
OG0001588	2	8	1	5	2	18
OG0001589	4	6	2	2	4	18
OG0001590	11	0	1	5	1	18
OG0001591	2	6	5	2	3	18
OG0001592	6	6	2	0	4	18
OG0001593	4	10	1	2	1	18
OG0001594	4	5	3	3	3	18
OG0001595	2	2	6	4	4	18
OG0001596	2	9	5	1	1	18
OG0001597	6	6	2	2	2	18
OG0001598	4	6	3	2	3	18
OG0001599	5	4	3	3	3	18
OG0001600	4	9	2	1	2	18
OG0001601	5	2	8	1	2	18
OG0001602	3	4	7	0	4	18
OG0001603	3	8	2	2	3	18
OG0001604	4	5	3	3	3	18
OG0001605	8	2	2	4	2	18
OG0001606	4	10	2	1	1	18
OG0001607	6	4	3	2	3	18
OG0001608	2	5	3	4	4	18
OG0001609	1	9	5	1	2	18
OG0001610	10	2	2	1	3	18
OG0001611	2	0	12	0	4	18
OG0001612	1	8	2	2	5	18
OG0001613	18	0	0	0	0	18
OG0001614	18	0	0	0	0	18
OG0001615	18	0	0	0	0	18
OG0001616	18	0	0	0	0	18
OG0001617	1	11	2	1	3	18
OG0001618	2	7	3	3	3	18
OG0001619	1	9	1	5	2	18
OG0001620	0	18	0	0	0	18
OG0001621	0	18	0	0	0	18
OG0001622	0	18	0	0	0	18
OG0001623	0	18	0	0	0	18
OG0001624	0	18	0	0	0	18
OG0001625	0	18	0	0	0	18
OG0001626	0	18	0	0	0	18
OG0001627	0	18	0	0	0	18
OG0001628	0	18	0	0	0	18
OG0001629	0	18	0	0	0	18
OG0001630	0	18	0	0	0	18
OG0001631	0	18	0	0	0	18
OG0001632	0	18	0	0	0	18
OG0001633	0	16	0	2	0	18
OG0001634	0	18	0	0	0	18
OG0001635	0	18	0	0	0	18
OG0001636	0	18	0	0	0	18
OG0001637	0	18	0	0	0	18
OG0001638	0	3	6	4	5	18
OG0001639	0	5	9	3	1	18
OG0001640	0	18	0	0	0	18
OG0001641	0	3	1	0	14	18
OG0001642	0	18	0	0	0	18
OG0001643	0	18	0	0	0	18
OG0001644	0	1	4	10	3	18
OG0001645	0	1	0	0	17	18
OG0001646	0	1	16	1	0	18
OG0001647	0	0	17	0	1	18
OG0001648	0	0	16	0	2	18
OG0001649	0	0	6	0	12	18
OG0001650	0	0	18	0	0	18
OG0001651	0	0	18	0	0	18
OG0001652	0	0	3	13	2	18
OG0001653	0	0	11	1	6	18
OG0001654	0	0	16	0	2	18
OG0001655	0	0	18	0	0	18
OG0001656	0	0	15	0	3	18
OG0001657	0	0	1	0	17	18
OG0001658	0	0	18	0	0	18
OG0001659	0	0	0	0	18	18
OG0001660	0	0	0	0	18	18
OG0001661	4	9	1	2	1	17
OG0001662	4	4	3	2	4	17
OG0001663	8	0	4	3	2	17
OG0001664	6	5	2	2	2	17
OG0001665	4	8	2	2	1	17
OG0001666	6	4	1	3	3	17
OG0001667	6	2	3	2	4	17
OG0001668	2	10	2	1	2	17
OG0001669	5	2	3	3	4	17
OG0001670	2	9	2	3	1	17
OG0001671	5	4	3	2	3	17
OG0001672	2	7	2	2	4	17
OG0001673	17	0	0	0	0	17
OG0001674	6	4	1	5	1	17
OG0001675	5	6	2	1	3	17
OG0001676	5	4	2	3	3	17
OG0001677	17	0	0	0	0	17
OG0001678	7	4	2	2	2	17
OG0001679	6	7	1	2	1	17
OG0001680	4	8	3	1	1	17
OG0001681	12	0	2	1	2	17
OG0001682	17	0	0	0	0	17
OG0001683	4	9	2	1	1	17
OG0001684	17	0	0	0	0	17
OG0001685	4	5	1	6	1	17
OG0001686	17	0	0	0	0	17
OG0001687	7	3	3	2	2	17
OG0001688	4	4	5	2	2	17
OG0001689	5	8	2	1	1	17
OG0001690	4	10	1	1	1	17
OG0001691	4	2	5	2	4	17
OG0001692	2	7	2	4	2	17
OG0001693	17	0	0	0	0	17
OG0001694	4	7	1	3	2	17
OG0001695	6	3	3	2	3	17
OG0001696	4	10	1	1	1	17
OG0001697	3	0	4	6	4	17
OG0001698	4	8	2	1	2	17
OG0001699	2	8	2	2	3	17
OG0001700	1	2	10	0	4	17
OG0001701	8	4	2	1	2	17
OG0001702	5	3	3	3	3	17
OG0001703	17	0	0	0	0	17
OG0001704	5	6	2	2	2	17
OG0001705	2	9	1	2	3	17
OG0001706	17	0	0	0	0	17
OG0001707	7	4	3	2	1	17
OG0001708	12	4	0	1	0	17
OG0001709	3	8	2	2	2	17
OG0001710	12	0	1	2	2	17
OG0001711	3	2	3	5	4	17
OG0001712	4	6	3	2	2	17
OG0001713	5	2	2	7	1	17
OG0001714	17	0	0	0	0	17
OG0001715	7	2	2	5	1	17
OG0001716	8	3	2	2	2	17
OG0001717	4	0	3	8	2	17
OG0001718	7	5	2	1	2	17
OG0001719	2	9	2	2	2	17
OG0001720	11	3	1	1	1	17
OG0001721	2	7	3	2	3	17
OG0001722	17	0	0	0	0	17
OG0001723	4	5	3	2	3	17
OG0001724	6	2	2	3	4	17
OG0001725	6	2	3	3	3	17
OG0001726	6	3	2	2	4	17
OG0001727	15	0	0	2	0	17
OG0001728	6	6	2	1	2	17
OG0001729	17	0	0	0	0	17
OG0001730	2	11	1	1	2	17
OG0001731	2	8	2	3	2	17
OG0001732	4	6	3	3	1	17
OG0001733	6	8	1	1	1	17
OG0001734	4	0	10	0	3	17
OG0001735	3	0	5	2	7	17
OG0001736	4	6	3	2	2	17
OG0001737	6	8	1	1	1	17
OG0001738	4	8	2	1	2	17
OG0001739	2	9	2	1	3	17
OG0001740	9	3	2	2	1	17
OG0001741	4	6	3	2	2	17
OG0001742	5	6	3	1	2	17
OG0001743	4	4	4	2	3	17
OG0001744	11	0	1	3	2	17
OG0001745	4	4	3	3	3	17
OG0001746	4	7	2	2	2	17
OG0001747	5	4	3	1	4	17
OG0001748	8	2	2	2	3	17
OG0001749	5	8	1	2	1	17
OG0001750	1	16	0	0	0	17
OG0001751	5	5	2	3	2	17
OG0001752	2	10	2	1	2	17
OG0001753	4	6	3	1	3	17
OG0001754	4	3	4	2	4	17
OG0001755	5	6	2	2	2	17
OG0001756	7	1	2	2	5	17
OG0001757	17	0	0	0	0	17
OG0001758	4	6	3	1	3	17
OG0001759	3	4	3	2	5	17
OG0001760	4	8	1	2	2	17
OG0001761	7	4	2	2	2	17
OG0001762	5	8	1	2	1	17
OG0001763	4	3	3	1	6	17
OG0001764	6	5	2	1	3	17
OG0001765	5	2	3	2	5	17
OG0001766	6	2	4	2	3	17
OG0001767	4	6	3	1	3	17
OG0001768	6	4	2	3	2	17
OG0001769	5	4	4	2	2	17
OG0001770	2	9	2	2	2	17
OG0001771	1	7	9	0	0	17
OG0001772	10	3	2	1	1	17
OG0001773	2	1	4	8	2	17
OG0001774	5	2	4	2	4	17
OG0001775	6	0	3	7	1	17
OG0001776	7	4	2	2	2	17
OG0001777	4	0	10	1	2	17
OG0001778	7	2	3	2	3	17
OG0001779	4	7	2	1	3	17
OG0001780	13	0	1	1	2	17
OG0001781	6	2	3	3	3	17
OG0001782	4	6	3	2	2	17
OG0001783	7	4	2	2	2	17
OG0001784	2	4	2	7	2	17
OG0001785	5	5	2	2	3	17
OG0001786	4	8	1	3	1	17
OG0001787	17	0	0	0	0	17
OG0001788	2	8	3	1	3	17
OG0001789	4	7	3	1	2	17
OG0001790	4	10	1	1	1	17
OG0001791	6	2	3	2	4	17
OG0001792	4	6	3	2	2	17
OG0001793	2	8	3	2	2	17
OG0001794	3	3	3	3	5	17
OG0001795	4	6	2	3	2	17
OG0001796	6	2	2	2	5	17
OG0001797	4	4	3	2	4	17
OG0001798	2	6	4	1	4	17
OG0001799	5	5	1	4	2	17
OG0001800	5	6	2	2	2	17
OG0001801	6	4	2	2	3	17
OG0001802	6	2	4	3	2	17
OG0001803	4	6	2	2	3	17
OG0001804	4	6	3	1	3	17
OG0001805	2	2	6	5	2	17
OG0001806	6	5	1	2	3	17
OG0001807	5	5	3	2	2	17
OG0001808	5	6	2	2	2	17
OG0001809	4	4	4	1	4	17
OG0001810	17	0	0	0	0	17
OG0001811	2	9	2	1	3	17
OG0001812	3	6	3	2	3	17
OG0001813	2	2	0	12	1	17
OG0001814	6	8	1	1	1	17
OG0001815	3	0	9	0	5	17
OG0001816	4	4	3	2	4	17
OG0001817	3	1	5	5	3	17
OG0001818	12	2	1	1	1	17
OG0001819	2	11	1	2	1	17
OG0001820	4	6	3	1	3	17
OG0001821	7	6	1	2	1	17
OG0001822	6	7	1	2	1	17
OG0001823	5	3	1	6	2	17
OG0001824	4	4	3	2	4	17
OG0001825	4	6	2	2	3	17
OG0001826	4	9	1	1	2	17
OG0001827	4	4	4	3	2	17
OG0001828	5	1	1	5	5	17
OG0001829	7	0	5	0	5	17
OG0001830	1	0	16	0	0	17
OG0001831	4	7	2	2	2	17
OG0001832	6	4	2	3	2	17
OG0001833	4	4	3	2	4	17
OG0001834	2	7	3	2	3	17
OG0001835	2	7	2	3	3	17
OG0001836	6	4	3	2	2	17
OG0001837	6	1	3	3	4	17
OG0001838	7	4	2	2	2	17
OG0001839	4	4	4	2	3	17
OG0001840	6	5	3	1	2	17
OG0001841	2	2	11	1	1	17
OG0001842	5	1	2	6	3	17
OG0001843	2	9	2	2	2	17
OG0001844	3	4	5	3	2	17
OG0001845	3	2	5	3	4	17
OG0001846	2	9	2	3	1	17
OG0001847	4	7	3	1	2	17
OG0001848	17	0	0	0	0	17
OG0001849	4	4	3	2	4	17
OG0001850	2	9	2	1	3	17
OG0001851	4	9	2	1	1	17
OG0001852	4	6	3	2	2	17
OG0001853	1	11	2	1	2	17
OG0001854	1	2	6	6	2	17
OG0001855	4	8	2	1	2	17
OG0001856	2	8	2	2	3	17
OG0001857	3	6	3	3	2	17
OG0001858	4	5	2	3	3	17
OG0001859	4	6	3	2	2	17
OG0001860	2	5	2	7	1	17
OG0001861	5	6	2	2	2	17
OG0001862	17	0	0	0	0	17
OG0001863	5	2	3	2	5	17
OG0001864	3	6	3	2	3	17
OG0001865	1	6	4	2	4	17
OG0001866	17	0	0	0	0	17
OG0001867	1	12	2	1	1	17
OG0001868	4	8	1	2	2	17
OG0001869	2	12	1	1	1	17
OG0001870	2	5	4	2	4	17
OG0001871	17	0	0	0	0	17
OG0001872	4	6	2	3	2	17
OG0001873	5	1	5	1	5	17
OG0001874	3	5	4	2	3	17
OG0001875	2	8	3	2	2	17
OG0001876	5	9	0	2	1	17
OG0001877	7	3	3	1	3	17
OG0001878	1	2	1	1	12	17
OG0001879	2	1	11	0	3	17
OG0001880	4	6	2	3	2	17
OG0001881	1	16	0	0	0	17
OG0001882	1	3	12	0	1	17
OG0001883	3	10	1	1	2	17
OG0001884	2	11	1	2	1	17
OG0001885	2	8	2	1	4	17
OG0001886	2	3	2	9	1	17
OG0001887	2	2	11	1	1	17
OG0001888	4	6	2	2	3	17
OG0001889	4	2	10	0	1	17
OG0001890	1	14	1	1	0	17
OG0001891	1	10	2	2	2	17
OG0001892	1	0	13	1	2	17
OG0001893	0	8	3	2	4	17
OG0001894	0	16	0	1	0	17
OG0001895	0	17	0	0	0	17
OG0001896	0	17	0	0	0	17
OG0001897	0	17	0	0	0	17
OG0001898	0	17	0	0	0	17
OG0001899	0	17	0	0	0	17
OG0001900	0	12	1	2	2	17
OG0001901	0	17	0	0	0	17
OG0001902	0	17	0	0	0	17
OG0001903	0	16	0	1	0	17
OG0001904	0	17	0	0	0	17
OG0001905	0	17	0	0	0	17
OG0001906	0	17	0	0	0	17
OG0001907	0	17	0	0	0	17
OG0001908	0	17	0	0	0	17
OG0001909	0	17	0	0	0	17
OG0001910	0	16	0	1	0	17
OG0001911	0	17	0	0	0	17
OG0001912	0	17	0	0	0	17
OG0001913	0	17	0	0	0	17
OG0001914	0	17	0	0	0	17
OG0001915	0	17	0	0	0	17
OG0001916	0	17	0	0	0	17
OG0001917	0	17	0	0	0	17
OG0001918	0	17	0	0	0	17
OG0001919	0	3	11	0	3	17
OG0001920	0	17	0	0	0	17
OG0001921	0	17	0	0	0	17
OG0001922	0	17	0	0	0	17
OG0001923	0	2	13	0	2	17
OG0001924	0	2	11	0	4	17
OG0001925	0	3	7	4	3	17
OG0001926	0	1	14	0	2	17
OG0001927	0	1	15	0	1	17
OG0001928	0	0	17	0	0	17
OG0001929	0	0	11	0	6	17
OG0001930	0	0	12	0	5	17
OG0001931	0	0	14	2	1	17
OG0001932	0	0	17	0	0	17
OG0001933	0	0	16	0	1	17
OG0001934	0	0	14	0	3	17
OG0001935	0	0	17	0	0	17
OG0001936	0	0	17	0	0	17
OG0001937	0	0	2	0	15	17
OG0001938	0	0	16	0	1	17
OG0001939	0	0	2	0	15	17
OG0001940	0	0	2	14	1	17
OG0001941	0	0	13	0	4	17
OG0001942	0	0	2	0	15	17
OG0001943	0	0	13	0	4	17
OG0001944	0	0	7	7	3	17
OG0001945	0	0	15	0	2	17
OG0001946	0	0	0	17	0	17
OG0001947	0	0	0	17	0	17
OG0001948	0	0	0	17	0	17
OG0001949	0	0	0	0	17	17
OG0001950	0	0	0	0	17	17
OG0001951	0	0	0	0	17	17
OG0001952	0	0	0	0	17	17
OG0001953	0	0	0	0	17	17
OG0001954	0	0	0	0	17	17
OG0001955	0	0	0	0	17	17
OG0001956	0	0	0	0	17	17
OG0001957	0	0	0	0	17	17
OG0001958	9	4	1	1	1	16
OG0001959	6	4	2	2	2	16
OG0001960	16	0	0	0	0	16
OG0001961	4	7	1	2	2	16
OG0001962	4	2	6	2	2	16
OG0001963	4	6	2	2	2	16
OG0001964	16	0	0	0	0	16
OG0001965	2	11	1	1	1	16
OG0001966	14	0	1	1	0	16
OG0001967	3	2	0	11	0	16
OG0001968	16	0	0	0	0	16
OG0001969	5	6	1	1	3	16
OG0001970	6	4	3	1	2	16
OG0001971	6	2	3	2	3	16
OG0001972	11	2	1	1	1	16
OG0001973	6	0	3	3	4	16
OG0001974	6	4	2	2	2	16
OG0001975	3	5	3	1	4	16
OG0001976	9	0	2	1	4	16
OG0001977	4	6	2	2	2	16
OG0001978	3	4	4	1	4	16
OG0001979	8	4	1	2	1	16
OG0001980	4	7	2	1	2	16
OG0001981	15	0	0	1	0	16
OG0001982	16	0	0	0	0	16
OG0001983	6	2	2	4	2	16
OG0001984	7	3	2	2	2	16
OG0001985	1	0	7	0	8	16
OG0001986	6	7	1	1	1	16
OG0001987	8	2	1	4	1	16
OG0001988	7	4	2	1	2	16
OG0001989	2	0	11	0	3	16
OG0001990	4	7	2	1	2	16
OG0001991	3	10	1	1	1	16
OG0001992	4	6	2	2	2	16
OG0001993	6	2	2	4	2	16
OG0001994	4	4	3	2	3	16
OG0001995	5	3	3	2	3	16
OG0001996	5	7	2	1	1	16
OG0001997	11	0	2	1	2	16
OG0001998	4	6	1	2	3	16
OG0001999	7	6	1	1	1	16
OG0002000	16	0	0	0	0	16
OG0002001	16	0	0	0	0	16
OG0002002	10	1	2	1	2	16
OG0002003	4	4	3	2	3	16
OG0002004	9	3	1	2	1	16
OG0002005	7	6	1	1	1	16
OG0002006	4	6	2	2	2	16
OG0002007	6	4	1	2	3	16
OG0002008	5	6	2	2	1	16
OG0002009	11	2	1	1	1	16
OG0002010	2	5	5	1	3	16
OG0002011	2	10	2	1	1	16
OG0002012	6	4	2	2	2	16
OG0002013	5	5	3	2	1	16
OG0002014	4	5	2	2	3	16
OG0002015	3	3	2	4	4	16
OG0002016	4	5	2	3	2	16
OG0002017	5	8	1	1	1	16
OG0002018	16	0	0	0	0	16
OG0002019	7	1	7	0	1	16
OG0002020	3	3	7	1	2	16
OG0002021	4	5	1	4	2	16
OG0002022	5	4	4	2	1	16
OG0002023	4	6	2	2	2	16
OG0002024	3	4	2	5	2	16
OG0002025	16	0	0	0	0	16
OG0002026	4	7	2	2	1	16
OG0002027	16	0	0	0	0	16
OG0002028	2	4	3	5	2	16
OG0002029	4	6	2	2	2	16
OG0002030	5	2	1	5	3	16
OG0002031	9	4	1	1	1	16
OG0002032	9	4	1	1	1	16
OG0002033	16	0	0	0	0	16
OG0002034	2	11	1	1	1	16
OG0002035	6	2	3	2	3	16
OG0002036	6	4	2	2	2	16
OG0002037	16	0	0	0	0	16
OG0002038	12	2	1	1	0	16
OG0002039	4	3	4	2	3	16
OG0002040	6	4	2	1	3	16
OG0002041	16	0	0	0	0	16
OG0002042	5	7	1	2	1	16
OG0002043	3	2	8	2	1	16
OG0002044	6	3	3	2	2	16
OG0002045	4	7	3	1	1	16
OG0002046	6	4	2	2	2	16
OG0002047	15	1	0	0	0	16
OG0002048	2	1	10	0	3	16
OG0002049	6	5	1	2	2	16
OG0002050	15	0	0	1	0	16
OG0002051	7	5	1	1	2	16
OG0002052	4	7	2	1	2	16
OG0002053	7	3	2	2	2	16
OG0002054	4	6	2	2	2	16
OG0002055	2	9	2	1	2	16
OG0002056	4	4	4	2	2	16
OG0002057	7	6	1	1	1	16
OG0002058	5	2	2	3	4	16
OG0002059	4	8	2	1	1	16
OG0002060	4	2	5	2	3	16
OG0002061	8	2	2	2	2	16
OG0002062	11	2	1	1	1	16
OG0002063	3	4	3	3	3	16
OG0002064	7	2	2	4	1	16
OG0002065	8	2	3	1	2	16
OG0002066	6	4	3	1	2	16
OG0002067	6	2	3	2	3	16
OG0002068	2	7	2	1	4	16
OG0002069	4	6	2	2	2	16
OG0002070	4	7	2	2	1	16
OG0002071	1	15	0	0	0	16
OG0002072	4	6	2	2	2	16
OG0002073	2	6	3	2	3	16
OG0002074	16	0	0	0	0	16
OG0002075	16	0	0	0	0	16
OG0002076	4	4	2	2	4	16
OG0002077	1	9	2	2	2	16
OG0002078	4	4	3	3	2	16
OG0002079	4	2	2	3	5	16
OG0002080	11	2	1	1	1	16
OG0002081	4	7	1	2	2	16
OG0002082	4	4	3	3	2	16
OG0002083	2	6	3	2	3	16
OG0002084	2	6	3	2	3	16
OG0002085	2	9	1	1	3	16
OG0002086	3	7	2	1	3	16
OG0002087	4	8	1	2	1	16
OG0002088	4	7	2	1	2	16
OG0002089	6	0	4	2	4	16
OG0002090	6	6	1	2	1	16
OG0002091	6	1	2	2	5	16
OG0002092	2	8	2	2	2	16
OG0002093	4	2	1	8	1	16
OG0002094	4	4	2	2	4	16
OG0002095	7	5	2	1	1	16
OG0002096	2	5	4	1	4	16
OG0002097	4	9	1	2	0	16
OG0002098	4	7	2	1	2	16
OG0002099	4	5	2	1	4	16
OG0002100	2	8	1	3	2	16
OG0002101	2	8	2	2	2	16
OG0002102	6	3	4	1	2	16
OG0002103	4	8	1	1	2	16
OG0002104	4	8	1	1	2	16
OG0002105	4	6	3	1	2	16
OG0002106	9	2	1	2	2	16
OG0002107	5	4	2	2	3	16
OG0002108	4	0	3	5	4	16
OG0002109	4	3	3	2	4	16
OG0002110	6	0	4	2	4	16
OG0002111	6	6	1	2	1	16
OG0002112	4	8	1	2	1	16
OG0002113	6	4	1	2	3	16
OG0002114	6	4	2	2	2	16
OG0002115	5	8	1	1	1	16
OG0002116	3	5	3	2	3	16
OG0002117	3	6	3	1	3	16
OG0002118	2	7	3	2	2	16
OG0002119	5	5	2	2	2	16
OG0002120	4	6	2	2	2	16
OG0002121	5	4	2	2	3	16
OG0002122	3	4	3	2	4	16
OG0002123	4	0	8	1	3	16
OG0002124	4	3	6	2	1	16
OG0002125	5	6	1	2	2	16
OG0002126	2	4	2	3	5	16
OG0002127	2	11	1	1	1	16
OG0002128	2	8	3	1	2	16
OG0002129	4	9	1	1	1	16
OG0002130	16	0	0	0	0	16
OG0002131	6	5	1	3	1	16
OG0002132	2	6	3	2	3	16
OG0002133	2	6	4	1	3	16
OG0002134	3	4	4	2	3	16
OG0002135	5	6	2	1	2	16
OG0002136	4	6	1	4	1	16
OG0002137	4	6	2	2	2	16
OG0002138	4	9	1	1	1	16
OG0002139	4	7	2	1	2	16
OG0002140	4	5	2	5	0	16
OG0002141	10	3	1	1	1	16
OG0002142	2	0	11	0	3	16
OG0002143	2	10	1	2	1	16
OG0002144	3	6	3	1	3	16
OG0002145	2	3	3	6	2	16
OG0002146	4	4	3	2	3	16
OG0002147	4	5	3	1	3	16
OG0002148	4	4	3	2	3	16
OG0002149	6	2	4	2	2	16
OG0002150	4	7	2	2	1	16
OG0002151	5	6	2	2	1	16
OG0002152	2	11	1	1	1	16
OG0002153	4	5	4	1	2	16
OG0002154	6	6	1	2	1	16
OG0002155	6	5	2	1	2	16
OG0002156	4	6	2	2	2	16
OG0002157	2	7	3	2	2	16
OG0002158	3	9	2	1	1	16
OG0002159	2	4	4	3	3	16
OG0002160	3	6	4	1	2	16
OG0002161	4	7	2	1	2	16
OG0002162	5	3	3	2	3	16
OG0002163	2	9	2	1	2	16
OG0002164	4	6	2	2	2	16
OG0002165	6	2	3	1	4	16
OG0002166	6	2	3	2	3	16
OG0002167	5	6	1	2	2	16
OG0002168	2	9	3	1	1	16
OG0002169	3	8	2	2	1	16
OG0002170	3	9	2	1	1	16
OG0002171	2	2	6	2	4	16
OG0002172	2	9	1	3	1	16
OG0002173	2	6	2	4	2	16
OG0002174	2	6	3	2	3	16
OG0002175	2	4	4	4	2	16
OG0002176	4	9	1	1	1	16
OG0002177	8	3	1	1	3	16
OG0002178	9	2	2	1	2	16
OG0002179	5	5	2	2	2	16
OG0002180	4	1	6	1	4	16
OG0002181	6	2	3	2	3	16
OG0002182	16	0	0	0	0	16
OG0002183	4	6	2	2	2	16
OG0002184	2	8	2	1	3	16
OG0002185	5	6	2	3	0	16
OG0002186	4	8	2	1	1	16
OG0002187	4	4	4	2	2	16
OG0002188	2	11	1	1	1	16
OG0002189	4	10	0	1	1	16
OG0002190	2	11	0	1	2	16
OG0002191	16	0	0	0	0	16
OG0002192	4	8	2	1	1	16
OG0002193	2	8	1	3	2	16
OG0002194	3	4	3	2	4	16
OG0002195	6	3	2	2	3	16
OG0002196	4	6	2	1	3	16
OG0002197	2	10	2	1	1	16
OG0002198	2	9	1	1	3	16
OG0002199	2	3	7	1	3	16
OG0002200	3	5	3	2	3	16
OG0002201	1	6	4	3	2	16
OG0002202	2	8	2	2	2	16
OG0002203	16	0	0	0	0	16
OG0002204	4	7	2	1	2	16
OG0002205	2	8	4	1	1	16
OG0002206	3	3	3	2	5	16
OG0002207	2	12	0	1	1	16
OG0002208	2	4	4	3	3	16
OG0002209	1	6	4	1	4	16
OG0002210	7	2	2	2	3	16
OG0002211	4	4	3	2	3	16
OG0002212	2	9	2	1	2	16
OG0002213	4	4	3	2	3	16
OG0002214	3	4	5	1	3	16
OG0002215	2	5	4	2	3	16
OG0002216	1	10	2	1	2	16
OG0002217	1	9	1	4	1	16
OG0002218	16	0	0	0	0	16
OG0002219	2	2	2	6	4	16
OG0002220	8	5	1	1	1	16
OG0002221	2	2	8	3	1	16
OG0002222	2	9	2	1	2	16
OG0002223	2	10	1	2	1	16
OG0002224	1	0	13	2	0	16
OG0002225	1	9	4	1	1	16
OG0002226	4	6	3	1	2	16
OG0002227	1	7	3	2	3	16
OG0002228	1	10	2	1	2	16
OG0002229	0	16	0	0	0	16
OG0002230	0	16	0	0	0	16
OG0002231	0	16	0	0	0	16
OG0002232	0	16	0	0	0	16
OG0002233	0	16	0	0	0	16
OG0002234	0	2	11	1	2	16
OG0002235	0	15	0	0	1	16
OG0002236	0	16	0	0	0	16
OG0002237	0	16	0	0	0	16
OG0002238	0	16	0	0	0	16
OG0002239	0	16	0	0	0	16
OG0002240	0	14	1	1	0	16
OG0002241	0	16	0	0	0	16
OG0002242	0	16	0	0	0	16
OG0002243	0	16	0	0	0	16
OG0002244	0	16	0	0	0	16
OG0002245	0	16	0	0	0	16
OG0002246	0	16	0	0	0	16
OG0002247	0	16	0	0	0	16
OG0002248	0	16	0	0	0	16
OG0002249	0	12	1	1	2	16
OG0002250	0	7	4	2	3	16
OG0002251	0	10	2	2	2	16
OG0002252	0	15	1	0	0	16
OG0002253	0	5	3	2	6	16
OG0002254	0	13	1	1	1	16
OG0002255	0	15	0	1	0	16
OG0002256	0	16	0	0	0	16
OG0002257	0	16	0	0	0	16
OG0002258	0	16	0	0	0	16
OG0002259	0	16	0	0	0	16
OG0002260	0	3	2	10	1	16
OG0002261	0	16	0	0	0	16
OG0002262	0	13	1	1	1	16
OG0002263	0	16	0	0	0	16
OG0002264	0	16	0	0	0	16
OG0002265	0	2	14	0	0	16
OG0002266	0	1	15	0	0	16
OG0002267	0	0	14	1	1	16
OG0002268	0	0	16	0	0	16
OG0002269	0	0	13	0	3	16
OG0002270	0	0	14	0	2	16
OG0002271	0	0	11	0	5	16
OG0002272	0	0	16	0	0	16
OG0002273	0	0	7	2	7	16
OG0002274	0	0	13	0	3	16
OG0002275	0	0	14	0	2	16
OG0002276	0	0	13	0	3	16
OG0002277	0	0	5	0	11	16
OG0002278	0	0	1	0	15	16
OG0002279	0	0	2	0	14	16
OG0002280	0	0	1	0	15	16
OG0002281	0	0	14	0	2	16
OG0002282	0	0	0	16	0	16
OG0002283	0	0	0	15	1	16
OG0002284	0	0	0	16	0	16
OG0002285	0	0	0	0	16	16
OG0002286	4	8	1	1	1	15
OG0002287	4	8	1	1	1	15
OG0002288	6	2	2	2	3	15
OG0002289	4	0	6	0	5	15
OG0002290	15	0	0	0	0	15
OG0002291	15	0	0	0	0	15
OG0002292	15	0	0	0	0	15
OG0002293	6	3	2	2	2	15
OG0002294	6	3	3	1	2	15
OG0002295	4	3	2	5	1	15
OG0002296	6	6	1	1	1	15
OG0002297	4	4	3	2	2	15
OG0002298	4	6	2	2	1	15
OG0002299	15	0	0	0	0	15
OG0002300	10	2	1	1	1	15
OG0002301	7	6	0	1	1	15
OG0002302	6	6	0	1	2	15
OG0002303	5	1	2	6	1	15
OG0002304	4	2	4	1	4	15
OG0002305	3	4	2	1	5	15
OG0002306	6	6	1	1	1	15
OG0002307	5	5	2	1	2	15
OG0002308	7	2	2	2	2	15
OG0002309	15	0	0	0	0	15
OG0002310	1	7	3	2	2	15
OG0002311	3	4	4	2	2	15
OG0002312	4	3	2	2	4	15
OG0002313	6	4	1	2	2	15
OG0002314	5	4	2	2	2	15
OG0002315	14	1	0	0	0	15
OG0002316	11	2	1	1	0	15
OG0002317	7	4	1	1	2	15
OG0002318	6	4	1	2	2	15
OG0002319	11	0	1	2	1	15
OG0002320	7	2	2	3	1	15
OG0002321	8	4	0	1	2	15
OG0002322	4	3	5	2	1	15
OG0002323	15	0	0	0	0	15
OG0002324	5	5	3	2	0	15
OG0002325	5	3	3	3	1	15
OG0002326	3	2	3	5	2	15
OG0002327	4	4	3	2	2	15
OG0002328	5	3	2	2	3	15
OG0002329	8	3	1	2	1	15
OG0002330	15	0	0	0	0	15
OG0002331	7	4	1	2	1	15
OG0002332	5	0	5	2	3	15
OG0002333	6	2	3	1	3	15
OG0002334	4	6	1	1	3	15
OG0002335	5	3	3	3	1	15
OG0002336	9	2	1	2	1	15
OG0002337	7	2	3	1	2	15
OG0002338	2	9	0	1	3	15
OG0002339	6	5	1	2	1	15
OG0002340	4	5	2	1	3	15
OG0002341	3	6	1	3	2	15
OG0002342	3	2	3	0	7	15
OG0002343	2	4	8	1	0	15
OG0002344	5	5	2	1	2	15
OG0002345	15	0	0	0	0	15
OG0002346	5	5	1	3	1	15
OG0002347	2	8	2	1	2	15
OG0002348	2	7	2	2	2	15
OG0002349	3	4	3	2	3	15
OG0002350	15	0	0	0	0	15
OG0002351	5	6	1	2	1	15
OG0002352	4	6	1	3	1	15
OG0002353	3	6	2	2	2	15
OG0002354	14	0	1	0	0	15
OG0002355	4	6	1	3	1	15
OG0002356	5	4	3	2	1	15
OG0002357	15	0	0	0	0	15
OG0002358	3	4	2	4	2	15
OG0002359	2	8	2	2	1	15
OG0002360	4	3	4	2	2	15
OG0002361	6	4	2	2	1	15
OG0002362	4	4	2	2	3	15
OG0002363	4	4	2	3	2	15
OG0002364	6	2	3	2	2	15
OG0002365	2	9	1	1	2	15
OG0002366	4	8	1	1	1	15
OG0002367	4	7	2	1	1	15
OG0002368	2	1	9	3	0	15
OG0002369	3	4	3	4	1	15
OG0002370	4	5	2	2	2	15
OG0002371	4	6	2	1	2	15
OG0002372	4	4	2	2	3	15
OG0002373	5	6	1	2	1	15
OG0002374	4	6	2	1	2	15
OG0002375	3	8	2	1	1	15
OG0002376	5	5	2	1	2	15
OG0002377	4	5	2	2	2	15
OG0002378	4	6	2	1	2	15
OG0002379	4	7	1	1	2	15
OG0002380	6	6	1	1	1	15
OG0002381	4	3	2	3	3	15
OG0002382	2	2	6	1	4	15
OG0002383	4	2	4	1	4	15
OG0002384	4	6	1	3	1	15
OG0002385	4	5	1	2	3	15
OG0002386	7	4	1	2	1	15
OG0002387	2	6	2	3	2	15
OG0002388	5	3	2	2	3	15
OG0002389	6	4	1	2	2	15
OG0002390	2	6	3	1	3	15
OG0002391	7	2	6	0	0	15
OG0002392	4	5	2	2	2	15
OG0002393	6	6	1	1	1	15
OG0002394	4	4	2	3	2	15
OG0002395	4	4	3	2	2	15
OG0002396	14	0	0	0	1	15
OG0002397	4	4	2	3	2	15
OG0002398	2	11	0	1	1	15
OG0002399	4	3	3	2	3	15
OG0002400	4	6	2	1	2	15
OG0002401	4	1	3	3	4	15
OG0002402	5	5	2	1	2	15
OG0002403	7	0	0	6	2	15
OG0002404	4	3	4	1	3	15
OG0002405	15	0	0	0	0	15
OG0002406	5	7	1	1	1	15
OG0002407	4	5	2	2	2	15
OG0002408	6	1	3	2	3	15
OG0002409	2	7	2	2	2	15
OG0002410	4	6	2	2	1	15
OG0002411	4	3	2	3	3	15
OG0002412	1	10	1	1	2	15
OG0002413	2	4	4	3	2	15
OG0002414	4	4	2	2	3	15
OG0002415	2	4	4	2	3	15
OG0002416	4	5	2	2	2	15
OG0002417	4	7	2	1	1	15
OG0002418	4	2	4	3	2	15
OG0002419	5	2	4	2	2	15
OG0002420	4	6	1	1	3	15
OG0002421	6	0	5	1	3	15
OG0002422	2	6	3	2	2	15
OG0002423	4	6	2	1	2	15
OG0002424	2	8	3	1	1	15
OG0002425	4	7	1	1	2	15
OG0002426	5	5	2	1	2	15
OG0002427	7	4	2	1	1	15
OG0002428	1	0	9	1	4	15
OG0002429	4	6	2	2	1	15
OG0002430	3	3	5	2	2	15
OG0002431	4	5	2	2	2	15
OG0002432	6	3	1	3	2	15
OG0002433	5	6	1	2	1	15
OG0002434	4	7	1	2	1	15
OG0002435	7	3	2	2	1	15
OG0002436	4	4	3	1	3	15
OG0002437	2	9	1	2	1	15
OG0002438	2	10	1	1	1	15
OG0002439	4	8	1	1	1	15
OG0002440	2	6	3	2	2	15
OG0002441	2	9	2	1	1	15
OG0002442	4	5	2	2	2	15
OG0002443	2	1	5	4	3	15
OG0002444	6	4	2	1	2	15
OG0002445	7	5	1	1	1	15
OG0002446	4	7	1	1	2	15
OG0002447	4	5	2	1	3	15
OG0002448	6	5	2	1	1	15
OG0002449	6	3	2	2	2	15
OG0002450	3	4	3	2	3	15
OG0002451	4	4	2	2	3	15
OG0002452	2	6	2	1	4	15
OG0002453	3	6	2	1	3	15
OG0002454	5	4	2	2	2	15
OG0002455	5	4	2	2	2	15
OG0002456	4	4	2	2	3	15
OG0002457	2	8	2	2	1	15
OG0002458	4	8	1	1	1	15
OG0002459	2	9	1	1	2	15
OG0002460	6	3	3	1	2	15
OG0002461	4	8	1	1	1	15
OG0002462	5	6	2	1	1	15
OG0002463	4	4	2	2	3	15
OG0002464	6	2	3	1	3	15
OG0002465	4	10	0	1	0	15
OG0002466	2	7	2	2	2	15
OG0002467	4	5	3	1	2	15
OG0002468	3	0	1	3	8	15
OG0002469	3	6	2	2	2	15
OG0002470	4	2	4	2	3	15
OG0002471	4	5	3	1	2	15
OG0002472	2	8	2	1	2	15
OG0002473	5	4	1	2	3	15
OG0002474	4	8	0	2	1	15
OG0002475	6	4	1	2	2	15
OG0002476	5	1	4	2	3	15
OG0002477	2	2	6	2	3	15
OG0002478	4	4	3	2	2	15
OG0002479	3	8	1	1	2	15
OG0002480	2	9	1	2	1	15
OG0002481	2	4	3	2	4	15
OG0002482	2	8	2	1	2	15
OG0002483	4	8	1	1	1	15
OG0002484	2	1	1	1	10	15
OG0002485	4	2	4	1	4	15
OG0002486	4	0	2	7	2	15
OG0002487	1	9	2	1	2	15
OG0002488	2	5	4	1	3	15
OG0002489	4	3	3	2	3	15
OG0002490	4	4	2	2	3	15
OG0002491	1	6	4	1	3	15
OG0002492	6	4	2	1	2	15
OG0002493	3	6	2	1	3	15
OG0002494	4	5	2	2	2	15
OG0002495	15	0	0	0	0	15
OG0002496	6	2	2	2	3	15
OG0002497	6	5	2	1	1	15
OG0002498	3	10	0	1	1	15
OG0002499	3	5	3	2	2	15
OG0002500	2	8	2	2	1	15
OG0002501	3	8	1	1	2	15
OG0002502	5	6	0	3	1	15
OG0002503	4	6	2	1	2	15
OG0002504	5	6	1	1	2	15
OG0002505	5	2	2	3	3	15
OG0002506	2	10	1	1	1	15
OG0002507	2	7	2	1	3	15
OG0002508	6	4	1	3	1	15
OG0002509	4	4	2	3	2	15
OG0002510	2	2	1	9	1	15
OG0002511	2	8	2	1	2	15
OG0002512	4	2	6	1	2	15
OG0002513	4	6	2	2	1	15
OG0002514	4	4	3	1	3	15
OG0002515	4	7	1	1	2	15
OG0002516	4	7	2	1	1	15
OG0002517	5	7	1	1	1	15
OG0002518	2	8	2	1	2	15
OG0002519	15	0	0	0	0	15
OG0002520	4	5	2	2	2	15
OG0002521	2	4	4	1	4	15
OG0002522	4	3	3	2	3	15
OG0002523	3	5	2	2	3	15
OG0002524	4	6	1	2	2	15
OG0002525	4	4	3	2	2	15
OG0002526	4	2	4	1	4	15
OG0002527	2	5	2	2	4	15
OG0002528	2	7	2	1	3	15
OG0002529	5	0	2	5	3	15
OG0002530	2	10	0	1	2	15
OG0002531	5	3	2	2	3	15
OG0002532	4	4	1	6	0	15
OG0002533	2	8	2	1	2	15
OG0002534	4	8	1	1	1	15
OG0002535	3	2	5	1	4	15
OG0002536	4	1	2	7	1	15
OG0002537	3	1	9	1	1	15
OG0002538	3	3	3	2	4	15
OG0002539	3	2	3	3	4	15
OG0002540	4	4	1	1	5	15
OG0002541	4	4	2	2	3	15
OG0002542	4	4	2	2	3	15
OG0002543	5	4	2	2	2	15
OG0002544	4	7	2	1	1	15
OG0002545	4	6	1	2	2	15
OG0002546	4	5	3	1	2	15
OG0002547	5	3	2	2	3	15
OG0002548	6	2	2	2	3	15
OG0002549	7	4	1	1	2	15
OG0002550	2	8	3	1	1	15
OG0002551	2	6	2	3	2	15
OG0002552	4	2	2	1	6	15
OG0002553	2	3	6	1	3	15
OG0002554	1	5	5	1	3	15
OG0002555	2	4	3	1	5	15
OG0002556	2	8	1	2	2	15
OG0002557	4	8	1	1	1	15
OG0002558	4	2	2	2	5	15
OG0002559	1	4	6	2	2	15
OG0002560	4	5	2	2	2	15
OG0002561	4	2	4	2	3	15
OG0002562	4	6	2	1	2	15
OG0002563	3	4	8	0	0	15
OG0002564	3	6	2	2	2	15
OG0002565	1	7	4	1	2	15
OG0002566	2	8	2	1	2	15
OG0002567	4	2	5	1	3	15
OG0002568	2	8	1	2	2	15
OG0002569	4	8	1	1	1	15
OG0002570	7	5	1	1	1	15
OG0002571	4	4	1	3	3	15
OG0002572	4	8	1	1	1	15
OG0002573	4	4	3	1	3	15
OG0002574	6	4	2	1	2	15
OG0002575	4	6	1	2	2	15
OG0002576	4	4	2	2	3	15
OG0002577	1	7	2	2	3	15
OG0002578	2	5	6	1	1	15
OG0002579	3	2	5	2	3	15
OG0002580	2	7	2	1	3	15
OG0002581	2	7	2	2	2	15
OG0002582	7	2	2	2	2	15
OG0002583	2	7	2	2	2	15
OG0002584	2	5	3	2	3	15
OG0002585	2	1	7	0	5	15
OG0002586	1	11	1	2	0	15
OG0002587	2	7	3	1	2	15
OG0002588	2	8	2	1	2	15
OG0002589	15	0	0	0	0	15
OG0002590	2	6	1	4	2	15
OG0002591	4	2	5	2	2	15
OG0002592	3	2	4	2	4	15
OG0002593	6	2	3	1	3	15
OG0002594	1	4	2	5	3	15
OG0002595	2	5	2	4	2	15
OG0002596	2	7	3	2	1	15
OG0002597	2	8	2	2	1	15
OG0002598	2	5	5	1	2	15
OG0002599	2	6	3	1	3	15
OG0002600	2	9	2	1	1	15
OG0002601	2	2	1	9	1	15
OG0002602	2	10	1	1	1	15
OG0002603	2	5	3	2	3	15
OG0002604	4	7	1	2	1	15
OG0002605	2	7	2	1	3	15
OG0002606	1	7	2	1	4	15
OG0002607	2	12	0	1	0	15
OG0002608	1	9	2	2	1	15
OG0002609	3	7	2	2	1	15
OG0002610	4	0	3	4	4	15
OG0002611	15	0	0	0	0	15
OG0002612	3	9	1	1	1	15
OG0002613	4	5	2	2	2	15
OG0002614	2	4	3	2	4	15
OG0002615	2	6	2	2	3	15
OG0002616	2	9	2	1	1	15
OG0002617	4	4	2	2	3	15
OG0002618	1	4	0	9	1	15
OG0002619	2	5	2	3	3	15
OG0002620	10	2	1	1	1	15
OG0002621	1	0	14	0	0	15
OG0002622	3	5	5	0	2	15
OG0002623	4	2	0	8	1	15
OG0002624	2	5	5	2	1	15
OG0002625	2	6	3	1	3	15
OG0002626	10	2	1	1	1	15
OG0002627	4	5	3	1	2	15
OG0002628	2	6	2	2	3	15
OG0002629	15	0	0	0	0	15
OG0002630	2	6	3	1	3	15
OG0002631	1	6	2	2	4	15
OG0002632	1	0	13	0	1	15
OG0002633	1	8	1	3	2	15
OG0002634	1	2	6	2	4	15
OG0002635	1	6	2	3	3	15
OG0002636	2	9	2	1	1	15
OG0002637	0	15	0	0	0	15
OG0002638	0	11	0	3	1	15
OG0002639	0	15	0	0	0	15
OG0002640	0	15	0	0	0	15
OG0002641	0	15	0	0	0	15
OG0002642	0	10	2	1	2	15
OG0002643	0	15	0	0	0	15
OG0002644	0	15	0	0	0	15
OG0002645	0	15	0	0	0	15
OG0002646	0	15	0	0	0	15
OG0002647	0	15	0	0	0	15
OG0002648	0	15	0	0	0	15
OG0002649	0	15	0	0	0	15
OG0002650	0	15	0	0	0	15
OG0002651	0	15	0	0	0	15
OG0002652	0	10	1	1	3	15
OG0002653	0	15	0	0	0	15
OG0002654	0	5	4	2	4	15
OG0002655	0	1	14	0	0	15
OG0002656	0	15	0	0	0	15
OG0002657	0	7	2	2	4	15
OG0002658	0	8	2	3	2	15
OG0002659	0	15	0	0	0	15
OG0002660	0	11	0	2	2	15
OG0002661	0	15	0	0	0	15
OG0002662	0	15	0	0	0	15
OG0002663	0	2	7	1	5	15
OG0002664	0	15	0	0	0	15
OG0002665	0	14	1	0	0	15
OG0002666	0	15	0	0	0	15
OG0002667	0	15	0	0	0	15
OG0002668	0	12	1	1	1	15
OG0002669	0	15	0	0	0	15
OG0002670	0	14	0	0	1	15
OG0002671	0	15	0	0	0	15
OG0002672	0	15	0	0	0	15
OG0002673	0	6	4	3	2	15
OG0002674	0	15	0	0	0	15
OG0002675	0	4	2	6	3	15
OG0002676	0	6	4	2	3	15
OG0002677	0	2	5	1	7	15
OG0002678	0	0	9	0	6	15
OG0002679	0	0	5	0	10	15
OG0002680	0	0	15	0	0	15
OG0002681	0	0	1	1	13	15
OG0002682	0	0	2	11	2	15
OG0002683	0	0	1	0	14	15
OG0002684	0	0	0	15	0	15
OG0002685	0	0	0	15	0	15
OG0002686	0	0	0	0	15	15
OG0002687	0	0	0	0	15	15
OG0002688	0	0	0	0	15	15
OG0002689	0	0	0	0	15	15
OG0002690	6	2	2	2	2	14
OG0002691	14	0	0	0	0	14
OG0002692	2	7	3	1	1	14
OG0002693	5	5	1	1	2	14
OG0002694	7	2	1	2	2	14
OG0002695	4	2	3	2	3	14
OG0002696	2	4	3	2	3	14
OG0002697	7	4	1	1	1	14
OG0002698	9	1	2	1	1	14
OG0002699	6	4	2	1	1	14
OG0002700	5	5	2	1	1	14
OG0002701	2	2	3	4	3	14
OG0002702	2	6	3	1	2	14
OG0002703	5	4	1	2	2	14
OG0002704	5	6	1	1	1	14
OG0002705	7	4	1	1	1	14
OG0002706	11	1	0	2	0	14
OG0002707	7	2	1	2	2	14
OG0002708	2	2	1	9	0	14
OG0002709	8	0	2	2	2	14
OG0002710	3	4	2	2	3	14
OG0002711	9	2	1	2	0	14
OG0002712	3	4	2	4	1	14
OG0002713	14	0	0	0	0	14
OG0002714	4	6	1	2	1	14
OG0002715	10	1	1	2	0	14
OG0002716	4	7	1	1	1	14
OG0002717	14	0	0	0	0	14
OG0002718	9	0	2	1	2	14
OG0002719	4	4	2	2	2	14
OG0002720	5	0	1	3	5	14
OG0002721	4	6	2	1	1	14
OG0002722	9	2	1	1	1	14
OG0002723	5	0	3	1	5	14
OG0002724	7	4	1	1	1	14
OG0002725	11	2	0	1	0	14
OG0002726	7	4	1	1	1	14
OG0002727	8	2	1	1	2	14
OG0002728	3	2	6	1	2	14
OG0002729	4	4	2	2	2	14
OG0002730	5	4	1	2	2	14
OG0002731	6	4	1	2	1	14
OG0002732	3	4	3	2	2	14
OG0002733	4	4	2	1	3	14
OG0002734	14	0	0	0	0	14
OG0002735	4	4	2	2	2	14
OG0002736	2	6	1	4	1	14
OG0002737	4	2	3	3	2	14
OG0002738	4	1	3	2	4	14
OG0002739	2	5	3	2	2	14
OG0002740	6	4	1	2	1	14
OG0002741	12	2	0	0	0	14
OG0002742	4	5	2	1	2	14
OG0002743	5	3	1	2	3	14
OG0002744	4	5	2	1	2	14
OG0002745	3	2	4	4	1	14
OG0002746	6	4	1	2	1	14
OG0002747	4	5	2	1	2	14
OG0002748	5	4	2	1	2	14
OG0002749	4	1	5	2	2	14
OG0002750	9	2	0	0	3	14
OG0002751	4	4	3	1	2	14
OG0002752	1	0	5	0	8	14
OG0002753	4	3	7	0	0	14
OG0002754	12	0	0	1	1	14
OG0002755	3	8	1	1	1	14
OG0002756	5	3	2	2	2	14
OG0002757	4	5	2	1	2	14
OG0002758	13	1	0	0	0	14
OG0002759	4	3	2	2	3	14
OG0002760	4	6	1	2	1	14
OG0002761	4	4	2	3	1	14
OG0002762	5	6	0	2	1	14
OG0002763	2	0	2	1	9	14
OG0002764	4	5	1	2	2	14
OG0002765	5	1	3	2	3	14
OG0002766	4	6	1	2	1	14
OG0002767	2	5	3	1	3	14
OG0002768	5	7	0	1	1	14
OG0002769	14	0	0	0	0	14
OG0002770	3	3	2	3	3	14
OG0002771	4	8	1	0	1	14
OG0002772	5	4	2	2	1	14
OG0002773	2	6	3	1	2	14
OG0002774	2	8	1	2	1	14
OG0002775	14	0	0	0	0	14
OG0002776	14	0	0	0	0	14
OG0002777	7	2	2	1	2	14
OG0002778	5	4	1	2	2	14
OG0002779	4	4	2	2	2	14
OG0002780	4	3	3	2	2	14
OG0002781	2	5	3	2	2	14
OG0002782	13	1	0	0	0	14
OG0002783	5	3	1	3	2	14
OG0002784	4	4	2	2	2	14
OG0002785	5	3	2	2	2	14
OG0002786	9	0	2	1	2	14
OG0002787	4	4	2	2	2	14
OG0002788	4	4	2	2	2	14
OG0002789	4	4	2	2	2	14
OG0002790	13	0	1	0	0	14
OG0002791	4	5	1	2	2	14
OG0002792	5	5	1	1	2	14
OG0002793	4	6	1	2	1	14
OG0002794	11	0	1	1	1	14
OG0002795	5	2	2	3	2	14
OG0002796	4	2	3	2	3	14
OG0002797	4	4	2	2	2	14
OG0002798	5	6	1	1	1	14
OG0002799	4	6	2	1	1	14
OG0002800	8	1	2	1	2	14
OG0002801	2	2	8	1	1	14
OG0002802	4	5	3	2	0	14
OG0002803	4	5	2	1	2	14
OG0002804	4	4	3	1	2	14
OG0002805	4	4	3	2	1	14
OG0002806	2	7	2	1	2	14
OG0002807	6	2	2	2	2	14
OG0002808	14	0	0	0	0	14
OG0002809	2	4	3	2	3	14
OG0002810	6	3	2	1	2	14
OG0002811	3	7	2	1	1	14
OG0002812	2	4	3	3	2	14
OG0002813	2	6	2	2	2	14
OG0002814	4	4	3	1	2	14
OG0002815	4	6	2	1	1	14
OG0002816	14	0	0	0	0	14
OG0002817	4	4	2	2	2	14
OG0002818	2	7	2	1	2	14
OG0002819	3	3	4	2	2	14
OG0002820	5	2	3	3	1	14
OG0002821	4	4	2	2	2	14
OG0002822	4	3	2	2	3	14
OG0002823	2	4	3	2	3	14
OG0002824	4	6	1	1	2	14
OG0002825	5	4	2	2	1	14
OG0002826	12	0	0	1	1	14
OG0002827	8	2	1	2	1	14
OG0002828	4	2	3	2	3	14
OG0002829	3	2	3	2	4	14
OG0002830	3	4	4	1	2	14
OG0002831	3	6	3	1	1	14
OG0002832	6	2	2	2	2	14
OG0002833	3	0	3	3	5	14
OG0002834	5	4	1	2	2	14
OG0002835	6	0	4	1	3	14
OG0002836	4	4	2	2	2	14
OG0002837	4	5	1	2	2	14
OG0002838	4	3	3	2	2	14
OG0002839	4	3	3	2	2	14
OG0002840	4	4	2	1	3	14
OG0002841	5	4	2	1	2	14
OG0002842	4	2	3	1	4	14
OG0002843	2	5	2	3	2	14
OG0002844	8	2	1	1	2	14
OG0002845	3	5	5	0	1	14
OG0002846	2	6	2	2	2	14
OG0002847	4	4	2	2	2	14
OG0002848	5	0	6	1	2	14
OG0002849	7	2	1	2	2	14
OG0002850	8	3	1	1	1	14
OG0002851	2	7	2	1	2	14
OG0002852	4	6	1	1	2	14
OG0002853	4	7	1	1	1	14
OG0002854	7	2	2	1	2	14
OG0002855	14	0	0	0	0	14
OG0002856	4	6	1	1	2	14
OG0002857	4	2	3	2	3	14
OG0002858	6	2	2	2	2	14
OG0002859	4	2	3	2	3	14
OG0002860	2	5	3	1	3	14
OG0002861	2	6	2	2	2	14
OG0002862	4	7	1	1	1	14
OG0002863	7	4	1	1	1	14
OG0002864	2	4	0	7	1	14
OG0002865	6	2	2	2	2	14
OG0002866	4	2	3	2	3	14
OG0002867	4	8	0	1	1	14
OG0002868	6	4	1	1	2	14
OG0002869	3	6	2	1	2	14
OG0002870	4	6	1	1	2	14
OG0002871	2	8	1	1	2	14
OG0002872	4	3	2	2	3	14
OG0002873	5	2	2	3	2	14
OG0002874	5	5	2	1	1	14
OG0002875	2	9	1	1	1	14
OG0002876	7	4	1	1	1	14
OG0002877	10	0	1	1	2	14
OG0002878	4	6	1	2	1	14
OG0002879	4	2	5	0	3	14
OG0002880	14	0	0	0	0	14
OG0002881	3	4	3	2	2	14
OG0002882	3	7	1	1	2	14
OG0002883	4	5	4	1	0	14
OG0002884	2	4	3	2	3	14
OG0002885	5	4	2	1	2	14
OG0002886	7	1	2	2	2	14
OG0002887	2	7	2	1	2	14
OG0002888	2	7	1	2	2	14
OG0002889	4	5	2	2	1	14
OG0002890	4	2	3	2	3	14
OG0002891	2	8	1	1	2	14
OG0002892	3	7	2	1	1	14
OG0002893	3	8	1	1	1	14
OG0002894	4	5	2	1	2	14
OG0002895	5	0	2	2	5	14
OG0002896	14	0	0	0	0	14
OG0002897	5	6	1	1	1	14
OG0002898	2	0	10	1	1	14
OG0002899	2	2	1	8	1	14
OG0002900	2	7	2	1	2	14
OG0002901	2	5	3	1	3	14
OG0002902	3	6	3	1	1	14
OG0002903	4	6	1	1	2	14
OG0002904	6	3	2	1	2	14
OG0002905	6	5	1	1	1	14
OG0002906	3	6	2	1	2	14
OG0002907	2	5	2	2	3	14
OG0002908	2	0	4	6	2	14
OG0002909	4	5	0	3	2	14
OG0002910	1	1	9	0	3	14
OG0002911	8	3	1	1	1	14
OG0002912	2	8	1	1	2	14
OG0002913	2	6	2	3	1	14
OG0002914	3	6	2	1	2	14
OG0002915	4	4	2	2	2	14
OG0002916	2	8	2	1	1	14
OG0002917	4	2	1	5	2	14
OG0002918	3	3	2	3	3	14
OG0002919	6	1	2	3	2	14
OG0002920	4	4	2	2	2	14
OG0002921	4	5	1	2	2	14
OG0002922	2	6	2	1	3	14
OG0002923	6	4	1	2	1	14
OG0002924	4	5	2	1	2	14
OG0002925	5	2	1	4	2	14
OG0002926	4	4	2	2	2	14
OG0002927	2	7	2	1	2	14
OG0002928	4	5	1	1	3	14
OG0002929	4	4	3	1	2	14
OG0002930	4	4	4	1	1	14
OG0002931	2	7	2	2	1	14
OG0002932	4	6	2	1	1	14
OG0002933	8	0	2	2	2	14
OG0002934	5	5	1	2	1	14
OG0002935	1	9	1	2	1	14
OG0002936	3	4	3	1	3	14
OG0002937	4	1	3	2	4	14
OG0002938	4	5	1	4	0	14
OG0002939	2	8	1	1	2	14
OG0002940	4	5	2	1	2	14
OG0002941	2	6	2	1	3	14
OG0002942	2	6	1	3	2	14
OG0002943	5	2	2	2	3	14
OG0002944	2	5	2	2	3	14
OG0002945	2	9	2	1	0	14
OG0002946	4	4	3	1	2	14
OG0002947	2	7	2	2	1	14
OG0002948	6	2	2	2	2	14
OG0002949	2	6	3	2	1	14
OG0002950	14	0	0	0	0	14
OG0002951	2	9	1	1	1	14
OG0002952	1	6	4	1	2	14
OG0002953	2	9	1	1	1	14
OG0002954	7	0	3	2	2	14
OG0002955	2	7	2	1	2	14
OG0002956	4	7	1	1	1	14
OG0002957	8	3	1	1	1	14
OG0002958	6	4	2	1	1	14
OG0002959	2	8	1	1	2	14
OG0002960	4	4	1	3	2	14
OG0002961	4	2	3	2	3	14
OG0002962	4	4	2	2	2	14
OG0002963	2	7	2	1	2	14
OG0002964	4	4	2	2	2	14
OG0002965	2	5	3	1	3	14
OG0002966	4	4	2	2	2	14
OG0002967	4	5	1	2	2	14
OG0002968	2	4	3	2	3	14
OG0002969	4	3	3	2	2	14
OG0002970	2	6	2	2	2	14
OG0002971	2	6	2	2	2	14
OG0002972	14	0	0	0	0	14
OG0002973	3	8	1	1	1	14
OG0002974	4	6	1	2	1	14
OG0002975	4	7	1	1	1	14
OG0002976	1	2	4	5	2	14
OG0002977	2	8	2	1	1	14
OG0002978	4	4	3	1	2	14
OG0002979	4	7	1	1	1	14
OG0002980	4	5	1	3	1	14
OG0002981	4	4	2	2	2	14
OG0002982	2	4	4	1	3	14
OG0002983	4	5	2	1	2	14
OG0002984	3	8	1	2	0	14
OG0002985	4	5	2	1	2	14
OG0002986	5	2	2	2	3	14
OG0002987	2	2	3	3	4	14
OG0002988	4	3	3	1	3	14
OG0002989	2	6	3	1	2	14
OG0002990	2	6	2	2	2	14
OG0002991	3	5	2	2	2	14
OG0002992	6	5	1	1	1	14
OG0002993	2	9	1	1	1	14
OG0002994	2	4	3	2	3	14
OG0002995	2	6	2	3	1	14
OG0002996	3	6	2	1	2	14
OG0002997	4	5	2	1	2	14
OG0002998	2	6	2	2	2	14
OG0002999	4	4	2	2	2	14
OG0003000	2	5	1	3	3	14
OG0003001	2	4	4	1	3	14
OG0003002	7	4	1	1	1	14
OG0003003	4	7	1	1	1	14
OG0003004	2	6	1	2	3	14
OG0003005	4	4	2	2	2	14
OG0003006	2	9	1	1	1	14
OG0003007	2	4	2	4	2	14
OG0003008	6	5	1	1	1	14
OG0003009	2	4	3	2	3	14
OG0003010	3	2	3	2	4	14
OG0003011	3	5	2	2	2	14
OG0003012	4	5	2	2	1	14
OG0003013	3	8	1	1	1	14
OG0003014	4	2	3	3	2	14
OG0003015	2	4	3	3	2	14
OG0003016	4	6	1	2	1	14
OG0003017	10	3	0	1	0	14
OG0003018	5	4	1	3	1	14
OG0003019	2	7	2	1	2	14
OG0003020	4	3	3	2	2	14
OG0003021	2	5	4	2	1	14
OG0003022	2	7	1	2	2	14
OG0003023	2	2	4	3	3	14
OG0003024	2	5	2	3	2	14
OG0003025	2	3	4	2	3	14
OG0003026	2	2	3	4	3	14
OG0003027	2	6	2	2	2	14
OG0003028	5	2	1	3	3	14
OG0003029	5	2	3	2	2	14
OG0003030	14	0	0	0	0	14
OG0003031	4	5	2	1	2	14
OG0003032	4	4	2	2	2	14
OG0003033	5	4	2	1	2	14
OG0003034	4	3	5	1	1	14
OG0003035	3	3	3	2	3	14
OG0003036	2	6	2	2	2	14
OG0003037	5	6	1	1	1	14
OG0003038	3	8	1	1	1	14
OG0003039	4	0	4	4	2	14
OG0003040	4	4	2	2	2	14
OG0003041	4	3	3	2	2	14
OG0003042	2	7	2	1	2	14
OG0003043	3	4	2	2	3	14
OG0003044	5	5	1	2	1	14
OG0003045	4	2	3	2	3	14
OG0003046	4	7	1	1	1	14
OG0003047	4	4	2	2	2	14
OG0003048	2	6	2	1	3	14
OG0003049	2	3	3	2	4	14
OG0003050	5	2	2	4	1	14
OG0003051	1	5	2	2	4	14
OG0003052	4	5	2	1	2	14
OG0003053	2	6	2	1	3	14
OG0003054	1	3	6	4	0	14
OG0003055	1	8	2	2	1	14
OG0003056	1	3	4	2	4	14
OG0003057	1	4	5	2	2	14
OG0003058	2	9	1	1	1	14
OG0003059	2	7	2	1	2	14
OG0003060	2	4	3	2	3	14
OG0003061	5	2	1	2	4	14
OG0003062	2	6	2	2	2	14
OG0003063	2	8	1	1	2	14
OG0003064	2	9	1	1	1	14
OG0003065	2	6	4	1	1	14
OG0003066	4	5	2	1	2	14
OG0003067	4	4	2	2	2	14
OG0003068	2	9	1	1	1	14
OG0003069	2	10	0	2	0	14
OG0003070	4	4	2	2	2	14
OG0003071	2	5	3	2	2	14
OG0003072	4	6	2	2	0	14
OG0003073	2	4	4	1	3	14
OG0003074	2	8	1	2	1	14
OG0003075	2	8	1	2	1	14
OG0003076	2	6	2	2	2	14
OG0003077	1	2	3	4	4	14
OG0003078	1	8	2	2	1	14
OG0003079	2	5	2	2	3	14
OG0003080	2	0	10	0	2	14
OG0003081	1	7	3	2	1	14
OG0003082	3	0	9	1	1	14
OG0003083	6	5	1	1	1	14
OG0003084	3	5	2	2	2	14
OG0003085	2	7	2	1	2	14
OG0003086	6	2	3	2	1	14
OG0003087	2	6	2	2	2	14
OG0003088	2	9	1	1	1	14
OG0003089	4	4	2	2	2	14
OG0003090	2	0	1	10	1	14
OG0003091	2	7	2	1	2	14
OG0003092	4	4	2	2	2	14
OG0003093	4	7	1	1	1	14
OG0003094	5	5	2	0	2	14
OG0003095	2	4	3	2	3	14
OG0003096	2	7	2	2	1	14
OG0003097	3	6	2	1	2	14
OG0003098	6	2	2	2	2	14
OG0003099	2	9	1	1	1	14
OG0003100	7	2	2	2	1	14
OG0003101	2	6	2	2	2	14
OG0003102	3	5	2	2	2	14
OG0003103	1	0	11	0	2	14
OG0003104	3	2	8	0	1	14
OG0003105	1	7	2	2	2	14
OG0003106	1	4	8	0	1	14
OG0003107	2	9	1	1	1	14
OG0003108	1	9	2	1	1	14
OG0003109	1	7	2	2	2	14
OG0003110	0	14	0	0	0	14
OG0003111	0	14	0	0	0	14
OG0003112	0	14	0	0	0	14
OG0003113	0	4	2	7	1	14
OG0003114	0	14	0	0	0	14
OG0003115	0	14	0	0	0	14
OG0003116	0	11	3	0	0	14
OG0003117	0	14	0	0	0	14
OG0003118	0	14	0	0	0	14
OG0003119	0	14	0	0	0	14
OG0003120	0	14	0	0	0	14
OG0003121	0	14	0	0	0	14
OG0003122	0	14	0	0	0	14
OG0003123	0	14	0	0	0	14
OG0003124	0	14	0	0	0	14
OG0003125	0	14	0	0	0	14
OG0003126	0	8	1	3	2	14
OG0003127	0	14	0	0	0	14
OG0003128	0	14	0	0	0	14
OG0003129	0	14	0	0	0	14
OG0003130	0	3	8	1	2	14
OG0003131	0	14	0	0	0	14
OG0003132	0	14	0	0	0	14
OG0003133	0	14	0	0	0	14
OG0003134	0	14	0	0	0	14
OG0003135	0	14	0	0	0	14
OG0003136	0	14	0	0	0	14
OG0003137	0	14	0	0	0	14
OG0003138	0	14	0	0	0	14
OG0003139	0	9	2	2	1	14
OG0003140	0	14	0	0	0	14
OG0003141	0	8	2	2	2	14
OG0003142	0	14	0	0	0	14
OG0003143	0	14	0	0	0	14
OG0003144	0	14	0	0	0	14
OG0003145	0	14	0	0	0	14
OG0003146	0	14	0	0	0	14
OG0003147	0	14	0	0	0	14
OG0003148	0	6	2	3	3	14
OG0003149	0	13	0	1	0	14
OG0003150	0	14	0	0	0	14
OG0003151	0	5	4	2	3	14
OG0003152	0	14	0	0	0	14
OG0003153	0	2	1	10	1	14
OG0003154	0	14	0	0	0	14
OG0003155	0	4	4	4	2	14
OG0003156	0	4	3	3	4	14
OG0003157	0	14	0	0	0	14
OG0003158	0	14	0	0	0	14
OG0003159	0	14	0	0	0	14
OG0003160	0	14	0	0	0	14
OG0003161	0	14	0	0	0	14
OG0003162	0	1	7	0	6	14
OG0003163	0	14	0	0	0	14
OG0003164	0	6	3	1	4	14
OG0003165	0	0	14	0	0	14
OG0003166	0	0	11	0	3	14
OG0003167	0	0	5	0	9	14
OG0003168	0	0	13	0	1	14
OG0003169	0	0	12	1	1	14
OG0003170	0	0	11	0	3	14
OG0003171	0	0	10	0	4	14
OG0003172	0	0	1	0	13	14
OG0003173	0	0	10	0	4	14
OG0003174	0	0	14	0	0	14
OG0003175	0	0	6	1	7	14
OG0003176	0	0	12	0	2	14
OG0003177	0	0	5	2	7	14
OG0003178	0	0	9	0	5	14
OG0003179	0	0	2	9	3	14
OG0003180	0	0	2	1	11	14
OG0003181	0	0	6	0	8	14
OG0003182	0	0	2	0	12	14
OG0003183	0	0	4	0	10	14
OG0003184	0	0	1	0	13	14
OG0003185	0	0	1	0	13	14
OG0003186	0	0	0	14	0	14
OG0003187	0	0	0	14	0	14
OG0003188	0	0	0	14	0	14
OG0003189	0	0	0	14	0	14
OG0003190	0	0	0	14	0	14
OG0003191	0	0	0	14	0	14
OG0003192	0	0	0	0	14	14
OG0003193	0	0	0	0	14	14
OG0003194	0	0	0	0	14	14
OG0003195	0	0	0	0	14	14
OG0003196	0	0	0	0	14	14
OG0003197	0	0	0	0	14	14
OG0003198	0	0	0	0	14	14
OG0003199	0	0	0	0	14	14
OG0003200	0	0	0	0	14	14
OG0003201	0	0	0	0	14	14
OG0003202	0	0	0	0	14	14
OG0003203	0	0	0	0	14	14
OG0003204	4	6	1	1	1	13
OG0003205	13	0	0	0	0	13
OG0003206	5	2	2	2	2	13
OG0003207	4	4	1	1	3	13
OG0003208	2	2	4	2	3	13
OG0003209	2	9	1	1	0	13
OG0003210	13	0	0	0	0	13
OG0003211	4	2	2	2	3	13
OG0003212	4	0	6	2	1	13
OG0003213	3	7	1	1	1	13
OG0003214	5	2	3	2	1	13
OG0003215	4	4	2	1	2	13
OG0003216	2	2	3	2	4	13
OG0003217	13	0	0	0	0	13
OG0003218	3	5	3	1	1	13
OG0003219	13	0	0	0	0	13
OG0003220	5	4	0	3	1	13
OG0003221	6	4	1	1	1	13
OG0003222	7	4	0	1	1	13
OG0003223	6	4	1	1	1	13
OG0003224	2	5	1	1	4	13
OG0003225	2	6	2	1	2	13
OG0003226	6	4	1	1	1	13
OG0003227	2	5	2	2	2	13
OG0003228	2	2	7	1	1	13
OG0003229	2	4	2	3	2	13
OG0003230	4	6	1	1	1	13
OG0003231	4	6	1	1	1	13
OG0003232	4	6	1	1	1	13
OG0003233	4	4	2	1	2	13
OG0003234	13	0	0	0	0	13
OG0003235	5	4	0	2	2	13
OG0003236	4	4	2	1	2	13
OG0003237	2	4	3	2	2	13
OG0003238	5	2	2	1	3	13
OG0003239	4	4	2	1	2	13
OG0003240	13	0	0	0	0	13
OG0003241	2	7	1	1	2	13
OG0003242	4	4	2	1	2	13
OG0003243	13	0	0	0	0	13
OG0003244	10	0	1	1	1	13
OG0003245	4	2	3	1	3	13
OG0003246	2	6	2	1	2	13
OG0003247	4	3	2	2	2	13
OG0003248	4	1	4	1	3	13
OG0003249	2	5	2	1	3	13
OG0003250	6	4	1	1	1	13
OG0003251	5	0	4	0	4	13
OG0003252	2	4	3	1	3	13
OG0003253	9	0	0	2	2	13
OG0003254	2	6	1	2	2	13
OG0003255	5	0	4	2	2	13
OG0003256	4	4	2	1	2	13
OG0003257	2	8	1	1	1	13
OG0003258	4	4	2	1	2	13
OG0003259	5	5	1	1	1	13
OG0003260	4	1	3	2	3	13
OG0003261	4	0	4	1	4	13
OG0003262	5	4	1	1	2	13
OG0003263	4	4	3	1	1	13
OG0003264	3	7	1	1	1	13
OG0003265	6	2	2	2	1	13
OG0003266	2	4	2	4	1	13
OG0003267	4	5	1	1	2	13
OG0003268	2	6	1	1	3	13
OG0003269	2	7	1	2	1	13
OG0003270	4	4	3	1	1	13
OG0003271	2	6	2	1	2	13
OG0003272	9	0	1	2	1	13
OG0003273	4	3	2	2	2	13
OG0003274	3	4	2	2	2	13
OG0003275	13	0	0	0	0	13
OG0003276	13	0	0	0	0	13
OG0003277	2	6	2	1	2	13
OG0003278	3	6	1	2	1	13
OG0003279	4	6	1	1	1	13
OG0003280	5	2	2	2	2	13
OG0003281	1	1	4	2	5	13
OG0003282	4	6	1	1	1	13
OG0003283	4	2	3	2	2	13
OG0003284	3	5	1	3	1	13
OG0003285	4	0	5	1	3	13
OG0003286	2	4	3	1	3	13
OG0003287	4	4	3	1	1	13
OG0003288	4	4	2	1	2	13
OG0003289	4	4	2	1	2	13
OG0003290	5	3	3	1	1	13
OG0003291	3	6	3	1	0	13
OG0003292	3	5	2	1	2	13
OG0003293	2	7	2	1	1	13
OG0003294	5	5	1	1	1	13
OG0003295	4	4	2	2	1	13
OG0003296	4	4	2	1	2	13
OG0003297	3	4	2	2	2	13
OG0003298	2	1	8	0	2	13
OG0003299	11	1	0	0	1	13
OG0003300	13	0	0	0	0	13
OG0003301	5	4	1	1	2	13
OG0003302	4	6	1	1	1	13
OG0003303	3	7	1	1	1	13
OG0003304	7	3	1	1	1	13
OG0003305	4	3	2	2	2	13
OG0003306	3	7	1	1	1	13
OG0003307	8	2	1	1	1	13
OG0003308	2	8	1	1	1	13
OG0003309	3	0	8	1	1	13
OG0003310	4	4	1	2	2	13
OG0003311	2	9	0	1	1	13
OG0003312	2	5	2	2	2	13
OG0003313	6	4	1	1	1	13
OG0003314	2	5	3	1	2	13
OG0003315	7	1	2	1	2	13
OG0003316	2	3	5	1	2	13
OG0003317	3	4	2	2	2	13
OG0003318	5	1	1	3	3	13
OG0003319	4	2	2	2	3	13
OG0003320	4	2	2	2	3	13
OG0003321	3	0	8	1	1	13
OG0003322	2	6	2	2	1	13
OG0003323	2	6	1	3	1	13
OG0003324	4	6	1	1	1	13
OG0003325	7	2	2	1	1	13
OG0003326	2	3	2	3	3	13
OG0003327	13	0	0	0	0	13
OG0003328	4	4	2	2	1	13
OG0003329	3	1	3	3	3	13
OG0003330	5	2	3	1	2	13
OG0003331	5	5	1	1	1	13
OG0003332	4	4	1	2	2	13
OG0003333	8	2	1	1	1	13
OG0003334	7	3	1	1	1	13
OG0003335	4	1	4	1	3	13
OG0003336	3	4	2	2	2	13
OG0003337	1	7	2	1	2	13
OG0003338	3	6	1	1	2	13
OG0003339	2	6	2	1	2	13
OG0003340	1	11	0	0	1	13
OG0003341	13	0	0	0	0	13
OG0003342	3	4	3	2	1	13
OG0003343	3	4	3	1	2	13
OG0003344	13	0	0	0	0	13
OG0003345	11	1	1	0	0	13
OG0003346	12	0	0	1	0	13
OG0003347	7	2	1	2	1	13
OG0003348	2	6	2	2	1	13
OG0003349	7	2	1	2	1	13
OG0003350	4	3	1	1	4	13
OG0003351	13	0	0	0	0	13
OG0003352	2	8	1	1	1	13
OG0003353	4	4	2	1	2	13
OG0003354	4	4	2	1	2	13
OG0003355	4	6	1	1	1	13
OG0003356	7	3	1	1	1	13
OG0003357	4	6	1	1	1	13
OG0003358	4	6	1	1	1	13
OG0003359	2	5	2	1	3	13
OG0003360	4	6	1	1	1	13
OG0003361	6	0	2	2	3	13
OG0003362	4	3	2	2	2	13
OG0003363	5	5	1	1	1	13
OG0003364	2	4	2	2	3	13
OG0003365	13	0	0	0	0	13
OG0003366	2	0	7	2	2	13
OG0003367	13	0	0	0	0	13
OG0003368	13	0	0	0	0	13
OG0003369	2	4	2	2	3	13
OG0003370	4	4	2	1	2	13
OG0003371	2	0	9	1	1	13
OG0003372	4	6	1	1	1	13
OG0003373	13	0	0	0	0	13
OG0003374	4	3	2	2	2	13
OG0003375	9	1	2	0	1	13
OG0003376	4	3	2	2	2	13
OG0003377	4	6	1	1	1	13
OG0003378	4	4	3	1	1	13
OG0003379	4	3	3	1	2	13
OG0003380	4	1	3	2	3	13
OG0003381	2	4	1	3	3	13
OG0003382	5	5	1	1	1	13
OG0003383	2	5	2	2	2	13
OG0003384	2	6	2	1	2	13
OG0003385	4	3	2	1	3	13
OG0003386	3	4	2	3	1	13
OG0003387	2	6	2	1	2	13
OG0003388	2	2	4	2	3	13
OG0003389	10	0	1	1	1	13
OG0003390	4	4	2	1	2	13
OG0003391	6	2	1	3	1	13
OG0003392	13	0	0	0	0	13
OG0003393	4	5	1	2	1	13
OG0003394	4	4	2	2	1	13
OG0003395	4	2	2	3	2	13
OG0003396	4	4	1	1	3	13
OG0003397	4	2	3	1	3	13
OG0003398	2	6	1	3	1	13
OG0003399	2	5	3	1	2	13
OG0003400	2	7	2	2	0	13
OG0003401	4	3	4	1	1	13
OG0003402	1	8	0	2	2	13
OG0003403	4	4	2	2	1	13
OG0003404	4	4	2	1	2	13
OG0003405	2	6	2	1	2	13
OG0003406	6	5	0	1	1	13
OG0003407	7	2	0	4	0	13
OG0003408	4	3	1	3	2	13
OG0003409	4	3	2	1	3	13
OG0003410	4	4	2	1	2	13
OG0003411	1	3	3	2	4	13
OG0003412	4	3	1	3	2	13
OG0003413	3	5	2	2	1	13
OG0003414	6	4	1	1	1	13
OG0003415	2	5	2	3	1	13
OG0003416	4	4	1	2	2	13
OG0003417	5	2	2	2	2	13
OG0003418	5	5	1	1	1	13
OG0003419	13	0	0	0	0	13
OG0003420	4	5	2	1	1	13
OG0003421	7	2	2	1	1	13
OG0003422	2	6	2	1	2	13
OG0003423	2	9	0	1	1	13
OG0003424	1	2	5	2	3	13
OG0003425	4	0	3	2	4	13
OG0003426	5	0	3	4	1	13
OG0003427	4	4	2	2	1	13
OG0003428	2	2	3	3	3	13
OG0003429	4	4	1	2	2	13
OG0003430	4	6	1	1	1	13
OG0003431	2	0	2	6	3	13
OG0003432	4	2	2	2	3	13
OG0003433	2	6	2	2	1	13
OG0003434	4	2	2	2	3	13
OG0003435	4	4	2	1	2	13
OG0003436	5	4	2	1	1	13
OG0003437	4	5	1	1	2	13
OG0003438	4	2	3	2	2	13
OG0003439	2	8	1	1	1	13
OG0003440	5	3	1	0	4	13
OG0003441	2	6	2	1	2	13
OG0003442	4	3	2	2	2	13
OG0003443	2	6	2	2	1	13
OG0003444	2	5	3	1	2	13
OG0003445	1	6	2	2	2	13
OG0003446	4	4	1	3	1	13
OG0003447	2	6	2	1	2	13
OG0003448	1	6	2	2	2	13
OG0003449	7	2	1	2	1	13
OG0003450	4	4	2	1	2	13
OG0003451	4	4	2	1	2	13
OG0003452	13	0	0	0	0	13
OG0003453	4	5	1	2	1	13
OG0003454	3	5	3	1	1	13
OG0003455	4	4	1	2	2	13
OG0003456	4	0	4	2	3	13
OG0003457	4	4	2	1	2	13
OG0003458	5	5	1	1	1	13
OG0003459	2	6	1	1	3	13
OG0003460	4	2	2	1	4	13
OG0003461	2	8	1	1	1	13
OG0003462	4	3	2	1	3	13
OG0003463	4	3	2	2	2	13
OG0003464	4	2	2	3	2	13
OG0003465	4	6	0	2	1	13
OG0003466	2	7	1	1	2	13
OG0003467	4	2	2	3	2	13
OG0003468	3	4	2	2	2	13
OG0003469	4	2	2	2	3	13
OG0003470	2	6	1	2	2	13
OG0003471	8	0	3	1	1	13
OG0003472	6	4	1	1	1	13
OG0003473	5	2	2	2	2	13
OG0003474	2	0	2	7	2	13
OG0003475	3	4	2	2	2	13
OG0003476	2	8	1	1	1	13
OG0003477	4	2	3	1	3	13
OG0003478	5	1	2	2	3	13
OG0003479	4	3	2	2	2	13
OG0003480	4	5	1	1	2	13
OG0003481	4	5	1	2	1	13
OG0003482	4	4	2	1	2	13
OG0003483	2	8	1	1	1	13
OG0003484	2	8	1	1	1	13
OG0003485	4	1	3	2	3	13
OG0003486	2	6	1	2	2	13
OG0003487	6	2	2	1	2	13
OG0003488	4	2	1	1	5	13
OG0003489	6	1	2	2	2	13
OG0003490	4	0	3	2	4	13
OG0003491	4	1	3	2	3	13
OG0003492	4	4	1	2	2	13
OG0003493	2	4	2	1	4	13
OG0003494	2	7	1	2	1	13
OG0003495	4	5	1	1	2	13
OG0003496	4	3	2	2	2	13
OG0003497	2	6	3	1	1	13
OG0003498	10	1	0	1	1	13
OG0003499	2	4	2	1	4	13
OG0003500	4	4	2	1	2	13
OG0003501	4	2	2	2	3	13
OG0003502	5	7	0	1	0	13
OG0003503	4	5	2	1	1	13
OG0003504	4	5	2	1	1	13
OG0003505	2	6	2	1	2	13
OG0003506	2	7	2	1	1	13
OG0003507	4	4	1	2	2	13
OG0003508	4	2	2	1	4	13
OG0003509	2	6	3	1	1	13
OG0003510	2	6	2	1	2	13
OG0003511	1	9	1	1	1	13
OG0003512	2	5	2	2	2	13
OG0003513	4	3	2	2	2	13
OG0003514	4	0	4	2	3	13
OG0003515	4	6	1	1	1	13
OG0003516	2	0	3	2	6	13
OG0003517	5	6	0	1	1	13
OG0003518	2	4	1	5	1	13
OG0003519	4	2	2	2	3	13
OG0003520	4	3	4	1	1	13
OG0003521	13	0	0	0	0	13
OG0003522	2	8	1	1	1	13
OG0003523	3	8	0	1	1	13
OG0003524	3	3	3	2	2	13
OG0003525	4	4	2	1	2	13
OG0003526	2	4	3	2	2	13
OG0003527	4	6	1	1	1	13
OG0003528	4	4	1	2	2	13
OG0003529	4	4	2	1	2	13
OG0003530	4	6	1	1	1	13
OG0003531	2	7	2	1	1	13
OG0003532	5	3	2	2	1	13
OG0003533	2	3	2	5	1	13
OG0003534	4	1	4	2	2	13
OG0003535	7	1	2	1	2	13
OG0003536	2	6	2	1	2	13
OG0003537	4	4	1	1	3	13
OG0003538	2	7	2	1	1	13
OG0003539	4	6	1	1	1	13
OG0003540	4	5	1	1	2	13
OG0003541	2	6	1	2	2	13
OG0003542	4	6	1	1	1	13
OG0003543	4	4	2	2	1	13
OG0003544	8	2	1	1	1	13
OG0003545	2	6	3	1	1	13
OG0003546	2	6	2	1	2	13
OG0003547	2	7	2	1	1	13
OG0003548	2	4	3	3	1	13
OG0003549	4	5	1	2	1	13
OG0003550	4	3	2	2	2	13
OG0003551	4	4	2	1	2	13
OG0003552	2	4	2	3	2	13
OG0003553	2	6	2	1	2	13
OG0003554	5	4	2	1	1	13
OG0003555	2	5	1	3	2	13
OG0003556	3	1	3	3	3	13
OG0003557	6	3	1	2	1	13
OG0003558	3	3	2	2	3	13
OG0003559	4	4	2	2	1	13
OG0003560	2	6	2	1	2	13
OG0003561	2	6	2	1	2	13
OG0003562	2	6	2	1	2	13
OG0003563	3	4	2	2	2	13
OG0003564	2	3	3	2	3	13
OG0003565	4	4	1	2	2	13
OG0003566	2	6	2	1	2	13
OG0003567	2	6	2	1	2	13
OG0003568	4	5	1	1	2	13
OG0003569	2	5	3	1	2	13
OG0003570	2	6	2	1	2	13
OG0003571	2	2	7	1	1	13
OG0003572	3	7	1	1	1	13
OG0003573	6	2	2	1	2	13
OG0003574	2	5	3	1	2	13
OG0003575	2	5	2	2	2	13
OG0003576	6	5	0	1	1	13
OG0003577	3	2	3	3	2	13
OG0003578	3	2	2	4	2	13
OG0003579	4	6	1	1	1	13
OG0003580	4	3	3	1	2	13
OG0003581	2	6	2	1	2	13
OG0003582	2	3	3	2	3	13
OG0003583	2	8	1	1	1	13
OG0003584	4	4	1	2	2	13
OG0003585	2	2	7	1	1	13
OG0003586	3	2	3	2	3	13
OG0003587	4	4	2	1	2	13
OG0003588	2	6	2	1	2	13
OG0003589	2	6	1	2	2	13
OG0003590	3	4	4	2	0	13
OG0003591	4	0	4	1	4	13
OG0003592	4	3	2	2	2	13
OG0003593	2	2	4	1	4	13
OG0003594	6	3	2	1	1	13
OG0003595	2	6	2	2	1	13
OG0003596	4	2	2	1	4	13
OG0003597	4	3	2	2	2	13
OG0003598	2	2	4	1	4	13
OG0003599	4	6	1	1	1	13
OG0003600	4	3	1	2	3	13
OG0003601	4	4	2	2	1	13
OG0003602	3	4	1	2	3	13
OG0003603	2	4	3	1	3	13
OG0003604	2	4	2	2	3	13
OG0003605	2	4	2	3	2	13
OG0003606	2	8	1	1	1	13
OG0003607	7	2	1	1	2	13
OG0003608	2	6	2	1	2	13
OG0003609	4	1	4	1	3	13
OG0003610	3	7	1	1	1	13
OG0003611	10	2	1	0	0	13
OG0003612	4	3	2	2	2	13
OG0003613	13	0	0	0	0	13
OG0003614	2	8	1	1	1	13
OG0003615	2	7	2	1	1	13
OG0003616	2	6	2	1	2	13
OG0003617	3	4	2	2	2	13
OG0003618	4	3	2	2	2	13
OG0003619	2	4	3	1	3	13
OG0003620	4	4	2	1	2	13
OG0003621	4	4	2	1	2	13
OG0003622	2	6	2	1	2	13
OG0003623	2	5	2	1	3	13
OG0003624	2	6	2	1	2	13
OG0003625	2	3	1	6	1	13
OG0003626	2	5	1	2	3	13
OG0003627	4	5	2	1	1	13
OG0003628	5	4	1	2	1	13
OG0003629	4	2	2	2	3	13
OG0003630	4	5	1	1	2	13
OG0003631	6	2	3	1	1	13
OG0003632	6	4	1	1	1	13
OG0003633	2	8	1	1	1	13
OG0003634	3	5	1	3	1	13
OG0003635	5	5	1	1	1	13
OG0003636	4	4	2	1	2	13
OG0003637	2	8	1	1	1	13
OG0003638	2	6	2	1	2	13
OG0003639	4	6	1	1	1	13
OG0003640	4	3	2	2	2	13
OG0003641	4	3	2	1	3	13
OG0003642	4	4	2	1	2	13
OG0003643	4	4	2	1	2	13
OG0003644	2	6	2	1	2	13
OG0003645	2	2	2	2	5	13
OG0003646	3	4	3	1	2	13
OG0003647	2	4	2	3	2	13
OG0003648	4	2	2	2	3	13
OG0003649	2	4	2	2	3	13
OG0003650	2	6	2	2	1	13
OG0003651	2	9	0	1	1	13
OG0003652	3	2	3	2	3	13
OG0003653	2	4	2	2	3	13
OG0003654	4	4	2	2	1	13
OG0003655	2	0	2	7	2	13
OG0003656	1	5	2	3	2	13
OG0003657	2	7	1	1	2	13
OG0003658	5	3	2	1	2	13
OG0003659	2	6	2	1	2	13
OG0003660	2	6	1	3	1	13
OG0003661	4	2	1	2	4	13
OG0003662	3	5	1	3	1	13
OG0003663	2	8	1	1	1	13
OG0003664	2	8	1	1	1	13
OG0003665	5	4	1	2	1	13
OG0003666	12	0	0	1	0	13
OG0003667	3	2	1	5	2	13
OG0003668	2	7	1	2	1	13
OG0003669	4	2	4	1	2	13
OG0003670	4	6	1	1	1	13
OG0003671	4	3	2	2	2	13
OG0003672	4	6	1	1	1	13
OG0003673	5	5	2	1	0	13
OG0003674	4	5	1	2	1	13
OG0003675	2	8	1	1	1	13
OG0003676	4	3	3	2	1	13
OG0003677	2	4	3	2	2	13
OG0003678	4	3	2	2	2	13
OG0003679	2	5	2	2	2	13
OG0003680	3	5	1	2	2	13
OG0003681	2	6	3	1	1	13
OG0003682	4	5	1	1	2	13
OG0003683	2	6	1	2	2	13
OG0003684	2	5	2	2	2	13
OG0003685	1	8	1	2	1	13
OG0003686	2	7	1	2	1	13
OG0003687	3	5	2	1	2	13
OG0003688	4	2	3	2	2	13
OG0003689	4	5	1	1	2	13
OG0003690	4	4	2	1	2	13
OG0003691	2	6	3	1	1	13
OG0003692	4	4	2	1	2	13
OG0003693	13	0	0	0	0	13
OG0003694	3	6	1	2	1	13
OG0003695	2	8	1	1	1	13
OG0003696	2	2	2	5	2	13
OG0003697	7	3	1	1	1	13
OG0003698	2	8	0	2	1	13
OG0003699	4	4	2	1	2	13
OG0003700	4	6	1	1	1	13
OG0003701	4	4	2	1	2	13
OG0003702	2	6	2	1	2	13
OG0003703	4	7	1	0	1	13
OG0003704	4	2	3	1	3	13
OG0003705	3	2	3	3	2	13
OG0003706	4	6	1	1	1	13
OG0003707	4	4	2	1	2	13
OG0003708	2	6	2	1	2	13
OG0003709	4	6	1	1	1	13
OG0003710	2	3	1	5	2	13
OG0003711	4	3	2	1	3	13
OG0003712	2	5	2	1	3	13
OG0003713	2	0	9	1	1	13
OG0003714	2	8	1	1	1	13
OG0003715	3	4	2	2	2	13
OG0003716	2	8	1	1	1	13
OG0003717	4	3	2	2	2	13
OG0003718	3	6	2	1	1	13
OG0003719	1	4	6	1	1	13
OG0003720	2	5	2	2	2	13
OG0003721	6	3	1	2	1	13
OG0003722	2	4	2	1	4	13
OG0003723	2	5	2	2	2	13
OG0003724	2	6	2	1	2	13
OG0003725	4	6	1	1	1	13
OG0003726	2	6	1	2	2	13
OG0003727	2	7	1	2	1	13
OG0003728	2	4	2	2	3	13
OG0003729	3	7	1	1	1	13
OG0003730	2	5	2	1	3	13
OG0003731	5	5	1	1	1	13
OG0003732	3	4	3	1	2	13
OG0003733	2	9	0	1	1	13
OG0003734	3	4	3	1	2	13
OG0003735	2	6	2	1	2	13
OG0003736	4	2	3	1	3	13
OG0003737	2	2	3	2	4	13
OG0003738	2	6	1	3	1	13
OG0003739	2	6	2	1	2	13
OG0003740	2	5	2	2	2	13
OG0003741	4	1	3	2	3	13
OG0003742	4	5	1	2	1	13
OG0003743	2	6	2	1	2	13
OG0003744	2	8	1	1	1	13
OG0003745	2	4	3	2	2	13
OG0003746	2	4	2	2	3	13
OG0003747	1	8	2	1	1	13
OG0003748	2	8	1	1	1	13
OG0003749	1	6	2	1	3	13
OG0003750	3	2	3	2	3	13
OG0003751	2	8	1	1	1	13
OG0003752	2	6	2	1	2	13
OG0003753	2	3	7	0	1	13
OG0003754	2	5	3	2	1	13
OG0003755	2	6	2	1	2	13
OG0003756	2	7	0	2	2	13
OG0003757	2	3	3	2	3	13
OG0003758	3	1	3	3	3	13
OG0003759	1	7	1	2	2	13
OG0003760	1	5	2	3	2	13
OG0003761	3	2	1	5	2	13
OG0003762	4	6	1	1	1	13
OG0003763	4	1	1	3	4	13
OG0003764	4	4	1	2	2	13
OG0003765	6	2	2	2	1	13
OG0003766	2	6	2	1	2	13
OG0003767	2	5	2	1	3	13
OG0003768	6	5	0	1	1	13
OG0003769	2	6	3	1	1	13
OG0003770	1	3	3	3	3	13
OG0003771	2	4	5	1	1	13
OG0003772	2	8	1	1	1	13
OG0003773	2	4	3	2	2	13
OG0003774	4	4	2	2	1	13
OG0003775	2	2	1	7	1	13
OG0003776	2	3	1	1	6	13
OG0003777	2	7	2	1	1	13
OG0003778	2	8	1	1	1	13
OG0003779	2	5	3	1	2	13
OG0003780	1	2	5	2	3	13
OG0003781	2	8	1	1	1	13
OG0003782	6	3	1	2	1	13
OG0003783	2	2	2	2	5	13
OG0003784	1	4	4	2	2	13
OG0003785	1	3	3	2	4	13
OG0003786	2	6	2	1	2	13
OG0003787	13	0	0	0	0	13
OG0003788	3	6	1	1	2	13
OG0003789	2	5	2	2	2	13
OG0003790	2	7	1	2	1	13
OG0003791	2	6	2	1	2	13
OG0003792	5	3	2	2	1	13
OG0003793	1	7	2	1	2	13
OG0003794	2	2	3	3	3	13
OG0003795	5	4	1	2	1	13
OG0003796	4	2	0	7	0	13
OG0003797	2	4	3	1	3	13
OG0003798	2	6	1	2	2	13
OG0003799	2	5	3	1	2	13
OG0003800	2	6	2	1	2	13
OG0003801	2	8	1	1	1	13
OG0003802	2	2	3	2	4	13
OG0003803	5	4	2	1	1	13
OG0003804	2	5	2	2	2	13
OG0003805	2	4	2	2	3	13
OG0003806	2	3	1	1	6	13
OG0003807	2	6	1	1	3	13
OG0003808	2	4	4	1	2	13
OG0003809	2	0	2	8	1	13
OG0003810	2	0	6	5	0	13
OG0003811	2	4	1	5	1	13
OG0003812	2	2	3	3	3	13
OG0003813	1	8	1	1	2	13
OG0003814	1	2	4	2	4	13
OG0003815	2	0	9	0	2	13
OG0003816	2	5	3	1	2	13
OG0003817	2	6	1	2	2	13
OG0003818	1	4	2	4	2	13
OG0003819	2	6	2	1	2	13
OG0003820	0	13	0	0	0	13
OG0003821	0	13	0	0	0	13
OG0003822	0	13	0	0	0	13
OG0003823	0	13	0	0	0	13
OG0003824	0	13	0	0	0	13
OG0003825	0	9	1	1	2	13
OG0003826	0	13	0	0	0	13
OG0003827	0	13	0	0	0	13
OG0003828	0	9	2	1	1	13
OG0003829	0	13	0	0	0	13
OG0003830	0	13	0	0	0	13
OG0003831	0	13	0	0	0	13
OG0003832	0	13	0	0	0	13
OG0003833	0	13	0	0	0	13
OG0003834	0	13	0	0	0	13
OG0003835	0	13	0	0	0	13
OG0003836	0	13	0	0	0	13
OG0003837	0	13	0	0	0	13
OG0003838	0	13	0	0	0	13
OG0003839	0	10	1	1	1	13
OG0003840	0	13	0	0	0	13
OG0003841	0	13	0	0	0	13
OG0003842	0	13	0	0	0	13
OG0003843	0	8	2	1	2	13
OG0003844	0	13	0	0	0	13
OG0003845	0	6	3	1	3	13
OG0003846	0	13	0	0	0	13
OG0003847	0	13	0	0	0	13
OG0003848	0	13	0	0	0	13
OG0003849	0	13	0	0	0	13
OG0003850	0	13	0	0	0	13
OG0003851	0	13	0	0	0	13
OG0003852	0	13	0	0	0	13
OG0003853	0	5	2	4	2	13
OG0003854	0	13	0	0	0	13
OG0003855	0	13	0	0	0	13
OG0003856	0	13	0	0	0	13
OG0003857	0	13	0	0	0	13
OG0003858	0	11	1	1	0	13
OG0003859	0	13	0	0	0	13
OG0003860	0	13	0	0	0	13
OG0003861	0	13	0	0	0	13
OG0003862	0	13	0	0	0	13
OG0003863	0	13	0	0	0	13
OG0003864	0	7	3	1	2	13
OG0003865	0	13	0	0	0	13
OG0003866	0	5	3	2	3	13
OG0003867	0	13	0	0	0	13
OG0003868	0	11	1	1	0	13
OG0003869	0	4	9	0	0	13
OG0003870	0	13	0	0	0	13
OG0003871	0	6	0	6	1	13
OG0003872	0	13	0	0	0	13
OG0003873	0	3	7	0	3	13
OG0003874	0	11	1	1	0	13
OG0003875	0	11	1	1	0	13
OG0003876	0	13	0	0	0	13
OG0003877	0	13	0	0	0	13
OG0003878	0	10	1	1	1	13
OG0003879	0	8	2	1	2	13
OG0003880	0	13	0	0	0	13
OG0003881	0	13	0	0	0	13
OG0003882	0	10	1	1	1	13
OG0003883	0	13	0	0	0	13
OG0003884	0	13	0	0	0	13
OG0003885	0	13	0	0	0	13
OG0003886	0	13	0	0	0	13
OG0003887	0	13	0	0	0	13
OG0003888	0	7	2	3	1	13
OG0003889	0	13	0	0	0	13
OG0003890	0	13	0	0	0	13
OG0003891	0	1	7	0	5	13
OG0003892	0	1	7	0	5	13
OG0003893	0	2	9	1	1	13
OG0003894	0	0	13	0	0	13
OG0003895	0	0	11	0	2	13
OG0003896	0	0	10	0	3	13
OG0003897	0	0	13	0	0	13
OG0003898	0	0	13	0	0	13
OG0003899	0	0	9	1	3	13
OG0003900	0	0	13	0	0	13
OG0003901	0	0	4	2	7	13
OG0003902	0	0	13	0	0	13
OG0003903	0	0	1	0	12	13
OG0003904	0	0	10	3	0	13
OG0003905	0	0	2	0	11	13
OG0003906	0	0	11	2	0	13
OG0003907	0	0	12	0	1	13
OG0003908	0	0	8	0	5	13
OG0003909	0	0	12	0	1	13
OG0003910	0	0	1	0	12	13
OG0003911	0	0	3	0	10	13
OG0003912	0	0	2	0	11	13
OG0003913	0	0	1	11	1	13
OG0003914	0	0	13	0	0	13
OG0003915	0	0	0	12	1	13
OG0003916	0	0	0	13	0	13
OG0003917	0	0	0	13	0	13
OG0003918	0	0	0	12	1	13
OG0003919	0	0	0	0	13	13
OG0003920	0	0	0	0	13	13
OG0003921	0	0	0	0	13	13
OG0003922	0	0	0	0	13	13
OG0003923	0	0	0	0	13	13
OG0003924	0	0	0	0	13	13
OG0003925	7	0	2	0	3	12
OG0003926	3	4	1	2	2	12
OG0003927	6	3	2	0	1	12
OG0003928	4	2	3	1	2	12
OG0003929	4	4	1	1	2	12
OG0003930	2	8	1	0	1	12
OG0003931	5	2	3	1	1	12
OG0003932	4	3	3	1	1	12
OG0003933	3	3	3	1	2	12
OG0003934	5	1	2	2	2	12
OG0003935	2	5	2	1	2	12
OG0003936	4	5	1	1	1	12
OG0003937	2	5	2	1	2	12
OG0003938	4	4	1	1	2	12
OG0003939	4	5	1	1	1	12
OG0003940	2	6	1	1	2	12
OG0003941	2	1	4	2	3	12
OG0003942	10	2	0	0	0	12
OG0003943	12	0	0	0	0	12
OG0003944	5	4	1	1	1	12
OG0003945	4	3	2	1	2	12
OG0003946	6	2	1	1	2	12
OG0003947	6	1	2	1	2	12
OG0003948	4	4	2	1	1	12
OG0003949	4	2	1	1	4	12
OG0003950	7	4	0	1	0	12
OG0003951	4	4	1	2	1	12
OG0003952	4	3	2	1	2	12
OG0003953	4	0	1	1	6	12
OG0003954	3	4	2	1	2	12
OG0003955	4	2	2	2	2	12
OG0003956	2	4	1	2	3	12
OG0003957	2	3	3	2	2	12
OG0003958	6	4	0	1	1	12
OG0003959	3	2	3	2	2	12
OG0003960	7	0	2	1	2	12
OG0003961	12	0	0	0	0	12
OG0003962	4	4	2	1	1	12
OG0003963	5	0	7	0	0	12
OG0003964	2	4	2	2	2	12
OG0003965	5	5	0	1	1	12
OG0003966	4	4	0	3	1	12
OG0003967	8	1	1	1	1	12
OG0003968	4	4	2	1	1	12
OG0003969	5	2	1	1	3	12
OG0003970	1	3	3	2	3	12
OG0003971	2	6	2	1	1	12
OG0003972	12	0	0	0	0	12
OG0003973	1	6	1	2	2	12
OG0003974	2	4	3	1	2	12
OG0003975	7	2	0	2	1	12
OG0003976	4	4	1	2	1	12
OG0003977	5	2	2	1	2	12
OG0003978	4	4	1	1	2	12
OG0003979	10	0	1	1	0	12
OG0003980	5	4	1	1	1	12
OG0003981	2	0	7	1	2	12
OG0003982	12	0	0	0	0	12
OG0003983	2	4	2	2	2	12
OG0003984	3	2	2	3	2	12
OG0003985	4	3	2	1	2	12
OG0003986	2	2	3	2	3	12
OG0003987	11	0	0	0	1	12
OG0003988	4	5	1	1	1	12
OG0003989	2	4	2	1	3	12
OG0003990	8	0	1	2	1	12
OG0003991	4	1	3	1	3	12
OG0003992	5	4	1	1	1	12
OG0003993	4	4	1	1	2	12
OG0003994	4	3	2	1	2	12
OG0003995	5	0	3	1	3	12
OG0003996	7	2	1	1	1	12
OG0003997	4	3	2	1	2	12
OG0003998	4	5	1	1	1	12
OG0003999	4	5	1	1	1	12
OG0004000	5	3	1	1	2	12
OG0004001	7	2	1	1	1	12
OG0004002	4	4	1	2	1	12
OG0004003	2	5	2	1	2	12
OG0004004	4	2	3	1	2	12
OG0004005	7	0	1	1	3	12
OG0004006	4	5	1	1	1	12
OG0004007	2	4	3	1	2	12
OG0004008	12	0	0	0	0	12
OG0004009	4	4	1	1	2	12
OG0004010	2	7	0	2	1	12
OG0004011	4	2	2	1	3	12
OG0004012	2	3	2	4	1	12
OG0004013	3	5	2	1	1	12
OG0004014	3	5	2	1	1	12
OG0004015	4	2	1	2	3	12
OG0004016	2	2	2	1	5	12
OG0004017	1	6	1	1	3	12
OG0004018	6	0	2	2	2	12
OG0004019	4	4	2	1	1	12
OG0004020	4	0	4	2	2	12
OG0004021	4	5	1	1	1	12
OG0004022	4	4	1	1	2	12
OG0004023	2	4	2	2	2	12
OG0004024	2	6	1	2	1	12
OG0004025	2	5	2	1	2	12
OG0004026	2	6	0	4	0	12
OG0004027	2	2	4	3	1	12
OG0004028	2	6	1	1	2	12
OG0004029	4	5	1	1	1	12
OG0004030	6	3	1	1	1	12
OG0004031	6	3	1	1	1	12
OG0004032	12	0	0	0	0	12
OG0004033	5	4	1	0	2	12
OG0004034	12	0	0	0	0	12
OG0004035	4	4	1	1	2	12
OG0004036	4	4	1	1	2	12
OG0004037	2	3	3	2	2	12
OG0004038	9	0	1	1	1	12
OG0004039	2	4	2	1	3	12
OG0004040	12	0	0	0	0	12
OG0004041	5	4	1	1	1	12
OG0004042	4	3	2	1	2	12
OG0004043	4	1	7	0	0	12
OG0004044	4	5	1	1	1	12
OG0004045	6	2	1	3	0	12
OG0004046	4	6	0	1	1	12
OG0004047	2	0	5	3	2	12
OG0004048	4	4	1	2	1	12
OG0004049	2	5	1	2	2	12
OG0004050	4	1	2	2	3	12
OG0004051	7	0	2	1	2	12
OG0004052	2	5	2	1	2	12
OG0004053	2	5	2	2	1	12
OG0004054	8	0	2	1	1	12
OG0004055	2	7	1	1	1	12
OG0004056	4	5	1	1	1	12
OG0004057	3	6	1	1	1	12
OG0004058	2	7	1	1	1	12
OG0004059	2	6	1	1	2	12
OG0004060	2	5	2	1	2	12
OG0004061	8	2	1	1	0	12
OG0004062	4	5	1	1	1	12
OG0004063	5	4	1	1	1	12
OG0004064	6	4	1	1	0	12
OG0004065	2	6	1	1	2	12
OG0004066	2	4	2	2	2	12
OG0004067	3	0	8	0	1	12
OG0004068	4	1	3	2	2	12
OG0004069	4	6	0	2	0	12
OG0004070	2	3	2	1	4	12
OG0004071	2	4	2	2	2	12
OG0004072	3	4	2	1	2	12
OG0004073	2	6	2	1	1	12
OG0004074	1	5	4	1	1	12
OG0004075	4	5	1	1	1	12
OG0004076	2	0	8	0	2	12
OG0004077	4	1	2	2	3	12
OG0004078	4	3	2	1	2	12
OG0004079	2	6	1	1	2	12
OG0004080	2	3	1	4	2	12
OG0004081	2	4	3	1	2	12
OG0004082	2	7	1	1	1	12
OG0004083	7	2	1	2	0	12
OG0004084	3	4	2	1	2	12
OG0004085	2	2	2	2	4	12
OG0004086	5	2	2	1	2	12
OG0004087	6	3	1	1	1	12
OG0004088	2	6	1	2	1	12
OG0004089	12	0	0	0	0	12
OG0004090	12	0	0	0	0	12
OG0004091	6	2	1	2	1	12
OG0004092	4	2	3	1	2	12
OG0004093	4	2	2	2	2	12
OG0004094	4	5	1	1	1	12
OG0004095	3	2	3	1	3	12
OG0004096	2	6	2	1	1	12
OG0004097	2	4	3	2	1	12
OG0004098	2	4	3	2	1	12
OG0004099	12	0	0	0	0	12
OG0004100	4	4	2	1	1	12
OG0004101	4	2	2	1	3	12
OG0004102	4	3	2	1	2	12
OG0004103	2	6	1	2	1	12
OG0004104	4	5	1	1	1	12
OG0004105	5	0	2	2	3	12
OG0004106	4	4	2	1	1	12
OG0004107	2	6	1	2	1	12
OG0004108	2	4	2	2	2	12
OG0004109	4	2	2	3	1	12
OG0004110	4	2	2	2	2	12
OG0004111	12	0	0	0	0	12
OG0004112	2	6	1	2	1	12
OG0004113	11	0	0	0	1	12
OG0004114	3	3	2	2	2	12
OG0004115	4	5	1	1	1	12
OG0004116	1	4	4	1	2	12
OG0004117	6	0	2	2	2	12
OG0004118	4	3	2	1	2	12
OG0004119	3	6	1	1	1	12
OG0004120	1	6	2	1	2	12
OG0004121	6	3	1	1	1	12
OG0004122	2	4	3	1	2	12
OG0004123	2	6	1	2	1	12
OG0004124	4	4	2	1	1	12
OG0004125	4	4	2	1	1	12
OG0004126	7	1	1	1	2	12
OG0004127	3	5	1	1	2	12
OG0004128	4	2	2	2	2	12
OG0004129	4	2	2	1	3	12
OG0004130	4	2	2	2	2	12
OG0004131	3	4	2	1	2	12
OG0004132	4	2	2	1	3	12
OG0004133	2	5	1	2	2	12
OG0004134	2	8	0	2	0	12
OG0004135	4	4	1	2	1	12
OG0004136	4	4	1	2	1	12
OG0004137	4	5	1	1	1	12
OG0004138	12	0	0	0	0	12
OG0004139	1	5	1	1	4	12
OG0004140	2	4	3	1	2	12
OG0004141	2	4	3	1	2	12
OG0004142	2	7	1	1	1	12
OG0004143	3	0	2	5	2	12
OG0004144	4	3	2	2	1	12
OG0004145	2	6	1	1	2	12
OG0004146	3	5	1	1	2	12
OG0004147	2	4	3	1	2	12
OG0004148	4	2	1	1	4	12
OG0004149	4	4	1	2	1	12
OG0004150	2	6	2	1	1	12
OG0004151	7	2	1	1	1	12
OG0004152	3	4	1	1	3	12
OG0004153	4	5	1	1	1	12
OG0004154	5	4	1	1	1	12
OG0004155	2	6	2	1	1	12
OG0004156	4	2	3	1	2	12
OG0004157	2	5	2	1	2	12
OG0004158	2	4	2	2	2	12
OG0004159	12	0	0	0	0	12
OG0004160	3	2	2	2	3	12
OG0004161	1	0	0	7	4	12
OG0004162	4	3	2	1	2	12
OG0004163	4	1	1	3	3	12
OG0004164	2	0	1	0	9	12
OG0004165	5	4	1	1	1	12
OG0004166	3	2	3	1	3	12
OG0004167	4	3	2	1	2	12
OG0004168	4	4	2	1	1	12
OG0004169	2	6	1	2	1	12
OG0004170	2	4	2	2	2	12
OG0004171	3	6	1	1	1	12
OG0004172	2	6	2	1	1	12
OG0004173	2	6	1	2	1	12
OG0004174	1	6	2	1	2	12
OG0004175	7	2	1	1	1	12
OG0004176	2	4	3	1	2	12
OG0004177	9	1	1	0	1	12
OG0004178	3	3	1	3	2	12
OG0004179	4	3	2	1	2	12
OG0004180	2	4	2	1	3	12
OG0004181	4	6	1	1	0	12
OG0004182	4	5	0	2	1	12
OG0004183	4	4	2	1	1	12
OG0004184	1	3	3	2	3	12
OG0004185	1	1	4	0	6	12
OG0004186	3	3	2	2	2	12
OG0004187	5	3	1	2	1	12
OG0004188	1	5	2	3	1	12
OG0004189	1	3	2	5	1	12
OG0004190	2	4	1	1	4	12
OG0004191	2	2	6	1	1	12
OG0004192	5	4	1	1	1	12
OG0004193	4	2	2	1	3	12
OG0004194	5	4	1	1	1	12
OG0004195	2	5	1	2	2	12
OG0004196	4	5	1	1	1	12
OG0004197	3	2	3	2	2	12
OG0004198	3	3	2	2	2	12
OG0004199	2	6	2	1	1	12
OG0004200	2	4	3	1	2	12
OG0004201	4	3	2	1	2	12
OG0004202	4	4	2	1	1	12
OG0004203	4	4	1	2	1	12
OG0004204	2	7	1	1	1	12
OG0004205	4	4	2	1	1	12
OG0004206	4	2	2	1	3	12
OG0004207	4	3	2	1	2	12
OG0004208	2	5	2	1	2	12
OG0004209	3	2	2	2	3	12
OG0004210	1	0	10	0	1	12
OG0004211	5	4	1	1	1	12
OG0004212	5	4	1	1	1	12
OG0004213	8	2	0	1	1	12
OG0004214	7	2	1	1	1	12
OG0004215	4	2	2	2	2	12
OG0004216	2	5	2	1	2	12
OG0004217	12	0	0	0	0	12
OG0004218	3	6	1	1	1	12
OG0004219	4	2	3	2	1	12
OG0004220	4	2	2	2	2	12
OG0004221	4	4	1	1	2	12
OG0004222	3	2	3	2	2	12
OG0004223	2	4	1	4	1	12
OG0004224	5	3	2	1	1	12
OG0004225	3	6	1	1	1	12
OG0004226	6	3	1	1	1	12
OG0004227	4	5	1	1	1	12
OG0004228	4	4	2	1	1	12
OG0004229	4	2	2	2	2	12
OG0004230	8	0	1	1	2	12
OG0004231	2	7	1	1	1	12
OG0004232	4	4	1	2	1	12
OG0004233	2	7	1	1	1	12
OG0004234	5	4	1	1	1	12
OG0004235	4	3	3	1	1	12
OG0004236	4	3	2	1	2	12
OG0004237	12	0	0	0	0	12
OG0004238	4	2	1	4	1	12
OG0004239	8	2	0	1	1	12
OG0004240	2	6	2	1	1	12
OG0004241	2	7	1	1	1	12
OG0004242	4	5	1	1	1	12
OG0004243	3	2	3	2	2	12
OG0004244	2	4	3	1	2	12
OG0004245	2	7	0	2	1	12
OG0004246	4	5	0	2	1	12
OG0004247	9	0	0	2	1	12
OG0004248	4	3	1	1	3	12
OG0004249	3	6	1	1	1	12
OG0004250	2	4	2	3	1	12
OG0004251	4	2	3	1	2	12
OG0004252	4	0	2	3	3	12
OG0004253	5	4	1	1	1	12
OG0004254	2	4	2	2	2	12
OG0004255	2	2	3	2	3	12
OG0004256	6	2	2	1	1	12
OG0004257	2	5	2	1	2	12
OG0004258	1	8	1	1	1	12
OG0004259	3	6	1	1	1	12
OG0004260	5	4	1	1	1	12
OG0004261	5	4	1	1	1	12
OG0004262	3	2	1	5	1	12
OG0004263	3	3	2	2	2	12
OG0004264	12	0	0	0	0	12
OG0004265	2	3	3	1	3	12
OG0004266	2	6	1	1	2	12
OG0004267	5	4	1	1	1	12
OG0004268	1	3	3	2	3	12
OG0004269	2	6	1	2	1	12
OG0004270	2	6	2	1	1	12
OG0004271	2	7	1	1	1	12
OG0004272	6	4	1	1	0	12
OG0004273	3	6	1	1	1	12
OG0004274	2	4	1	3	2	12
OG0004275	2	5	2	1	2	12
OG0004276	2	4	3	1	2	12
OG0004277	6	0	3	2	1	12
OG0004278	4	2	4	1	1	12
OG0004279	5	5	0	1	1	12
OG0004280	2	6	1	2	1	12
OG0004281	6	2	1	2	1	12
OG0004282	3	6	1	1	1	12
OG0004283	2	4	2	2	2	12
OG0004284	4	0	3	2	3	12
OG0004285	2	5	2	2	1	12
OG0004286	4	3	2	1	2	12
OG0004287	2	4	2	2	2	12
OG0004288	4	5	1	1	1	12
OG0004289	1	4	2	2	3	12
OG0004290	5	4	1	1	1	12
OG0004291	4	3	2	2	1	12
OG0004292	2	5	1	1	3	12
OG0004293	2	2	3	2	3	12
OG0004294	2	6	2	1	1	12
OG0004295	9	2	0	1	0	12
OG0004296	3	5	2	1	1	12
OG0004297	1	6	2	1	2	12
OG0004298	3	3	3	2	1	12
OG0004299	4	6	0	1	1	12
OG0004300	2	7	1	1	1	12
OG0004301	3	6	1	1	1	12
OG0004302	2	3	3	2	2	12
OG0004303	2	4	2	1	3	12
OG0004304	4	5	1	1	1	12
OG0004305	4	4	1	1	2	12
OG0004306	4	5	1	1	1	12
OG0004307	2	7	1	1	1	12
OG0004308	4	4	2	1	1	12
OG0004309	4	2	2	2	2	12
OG0004310	2	5	3	1	1	12
OG0004311	5	4	1	1	1	12
OG0004312	4	2	2	2	2	12
OG0004313	4	2	2	2	2	12
OG0004314	4	4	2	1	1	12
OG0004315	4	5	1	1	1	12
OG0004316	2	7	1	1	1	12
OG0004317	2	6	1	2	1	12
OG0004318	6	0	2	2	2	12
OG0004319	2	6	1	1	2	12
OG0004320	3	5	1	2	1	12
OG0004321	2	5	1	1	3	12
OG0004322	2	6	1	2	1	12
OG0004323	3	5	2	1	1	12
OG0004324	2	5	2	1	2	12
OG0004325	3	2	2	2	3	12
OG0004326	3	4	1	1	3	12
OG0004327	2	4	2	2	2	12
OG0004328	6	2	1	2	1	12
OG0004329	6	4	0	1	1	12
OG0004330	4	2	2	2	2	12
OG0004331	8	0	4	0	0	12
OG0004332	5	4	1	1	1	12
OG0004333	4	4	2	1	1	12
OG0004334	6	1	1	2	2	12
OG0004335	4	2	4	1	1	12
OG0004336	4	4	1	1	2	12
OG0004337	4	2	2	2	2	12
OG0004338	3	0	4	2	3	12
OG0004339	5	4	1	1	1	12
OG0004340	5	1	2	1	3	12
OG0004341	5	0	2	2	3	12
OG0004342	7	2	1	1	1	12
OG0004343	12	0	0	0	0	12
OG0004344	6	2	1	2	1	12
OG0004345	2	4	3	2	1	12
OG0004346	4	4	1	1	2	12
OG0004347	12	0	0	0	0	12
OG0004348	2	6	1	1	2	12
OG0004349	2	6	2	1	1	12
OG0004350	2	5	2	2	1	12
OG0004351	5	4	1	1	1	12
OG0004352	2	6	1	2	1	12
OG0004353	2	7	1	1	1	12
OG0004354	2	8	0	1	1	12
OG0004355	2	0	9	0	1	12
OG0004356	4	2	2	2	2	12
OG0004357	2	6	1	1	2	12
OG0004358	6	1	1	2	2	12
OG0004359	2	6	2	1	1	12
OG0004360	1	5	2	2	2	12
OG0004361	2	5	1	3	1	12
OG0004362	2	4	3	1	2	12
OG0004363	4	4	1	2	1	12
OG0004364	4	4	2	1	1	12
OG0004365	3	3	2	1	3	12
OG0004366	2	5	2	1	2	12
OG0004367	5	4	1	1	1	12
OG0004368	4	6	0	1	1	12
OG0004369	2	6	1	1	2	12
OG0004370	3	4	3	1	1	12
OG0004371	2	4	2	1	3	12
OG0004372	3	4	2	2	1	12
OG0004373	2	6	2	1	1	12
OG0004374	2	3	3	2	2	12
OG0004375	3	4	1	1	3	12
OG0004376	4	3	2	1	2	12
OG0004377	1	7	1	1	2	12
OG0004378	4	4	1	1	2	12
OG0004379	4	3	2	1	2	12
OG0004380	7	2	1	1	1	12
OG0004381	2	2	2	1	5	12
OG0004382	2	4	3	2	1	12
OG0004383	2	5	3	1	1	12
OG0004384	2	6	1	1	2	12
OG0004385	3	5	1	2	1	12
OG0004386	2	3	3	2	2	12
OG0004387	2	4	1	3	2	12
OG0004388	3	5	2	1	1	12
OG0004389	6	1	2	2	1	12
OG0004390	4	2	2	2	2	12
OG0004391	2	2	2	4	2	12
OG0004392	2	4	2	2	2	12
OG0004393	2	4	2	1	3	12
OG0004394	2	2	3	2	3	12
OG0004395	3	6	1	1	1	12
OG0004396	2	4	2	2	2	12
OG0004397	5	4	1	1	1	12
OG0004398	2	7	1	1	1	12
OG0004399	2	7	1	1	1	12
OG0004400	2	4	2	1	3	12
OG0004401	2	7	1	1	1	12
OG0004402	4	2	2	2	2	12
OG0004403	4	2	1	1	4	12
OG0004404	3	5	2	1	1	12
OG0004405	2	6	1	2	1	12
OG0004406	3	3	3	1	2	12
OG0004407	4	4	2	1	1	12
OG0004408	2	6	1	1	2	12
OG0004409	4	4	2	1	1	12
OG0004410	2	5	2	1	2	12
OG0004411	4	4	1	2	1	12
OG0004412	2	4	2	2	2	12
OG0004413	5	3	2	1	1	12
OG0004414	3	6	1	1	1	12
OG0004415	2	6	2	1	1	12
OG0004416	4	4	2	1	1	12
OG0004417	2	2	2	3	3	12
OG0004418	2	3	3	1	3	12
OG0004419	2	6	1	2	1	12
OG0004420	9	3	0	0	0	12
OG0004421	4	5	1	1	1	12
OG0004422	2	4	2	2	2	12
OG0004423	3	2	2	3	2	12
OG0004424	2	2	3	2	3	12
OG0004425	2	6	2	1	1	12
OG0004426	4	2	2	2	2	12
OG0004427	4	4	1	2	1	12
OG0004428	2	4	2	1	3	12
OG0004429	2	7	1	1	1	12
OG0004430	4	4	1	1	2	12
OG0004431	2	5	2	1	2	12
OG0004432	2	4	2	1	3	12
OG0004433	3	1	2	3	3	12
OG0004434	2	4	2	2	2	12
OG0004435	2	3	3	2	2	12
OG0004436	2	2	2	5	1	12
OG0004437	2	2	4	3	1	12
OG0004438	3	4	2	1	2	12
OG0004439	6	2	1	1	2	12
OG0004440	2	7	1	1	1	12
OG0004441	2	4	1	3	2	12
OG0004442	2	5	2	1	2	12
OG0004443	6	1	2	2	1	12
OG0004444	3	2	2	2	3	12
OG0004445	2	7	1	1	1	12
OG0004446	2	1	4	2	3	12
OG0004447	4	4	1	1	2	12
OG0004448	2	6	2	1	1	12
OG0004449	2	1	2	3	4	12
OG0004450	4	5	1	1	1	12
OG0004451	4	2	2	2	2	12
OG0004452	2	6	1	1	2	12
OG0004453	2	2	2	3	3	12
OG0004454	4	5	1	1	1	12
OG0004455	4	2	3	1	2	12
OG0004456	4	4	2	1	1	12
OG0004457	2	5	1	2	2	12
OG0004458	3	4	2	2	1	12
OG0004459	2	4	2	2	2	12
OG0004460	2	6	2	1	1	12
OG0004461	2	2	5	1	2	12
OG0004462	5	4	1	1	1	12
OG0004463	2	2	5	1	2	12
OG0004464	3	4	2	2	1	12
OG0004465	2	8	1	1	0	12
OG0004466	2	6	1	1	2	12
OG0004467	2	4	2	2	2	12
OG0004468	2	6	1	2	1	12
OG0004469	2	4	1	1	4	12
OG0004470	4	5	1	1	1	12
OG0004471	2	7	1	2	0	12
OG0004472	4	4	2	1	1	12
OG0004473	4	4	1	1	2	12
OG0004474	1	6	1	2	2	12
OG0004475	4	4	1	1	2	12
OG0004476	4	2	2	2	2	12
OG0004477	2	5	2	1	2	12
OG0004478	1	5	4	1	1	12
OG0004479	2	5	2	1	2	12
OG0004480	4	4	1	2	1	12
OG0004481	2	6	2	1	1	12
OG0004482	2	6	2	1	1	12
OG0004483	5	2	2	1	2	12
OG0004484	7	2	1	1	1	12
OG0004485	2	4	2	2	2	12
OG0004486	3	4	1	1	3	12
OG0004487	3	3	2	3	1	12
OG0004488	4	2	3	1	2	12
OG0004489	4	5	1	1	1	12
OG0004490	2	4	3	1	2	12
OG0004491	2	6	1	2	1	12
OG0004492	6	2	2	1	1	12
OG0004493	2	4	2	1	3	12
OG0004494	2	5	1	1	3	12
OG0004495	2	5	2	1	2	12
OG0004496	2	2	2	3	3	12
OG0004497	4	4	2	1	1	12
OG0004498	2	5	3	1	1	12
OG0004499	4	3	2	1	2	12
OG0004500	4	2	2	2	2	12
OG0004501	2	5	2	1	2	12
OG0004502	1	0	1	0	10	12
OG0004503	4	5	1	1	1	12
OG0004504	2	5	2	1	2	12
OG0004505	4	1	2	2	3	12
OG0004506	3	4	2	1	2	12
OG0004507	4	4	1	2	1	12
OG0004508	4	5	1	1	1	12
OG0004509	1	6	2	1	2	12
OG0004510	2	2	1	6	1	12
OG0004511	5	2	3	1	1	12
OG0004512	2	6	2	1	1	12
OG0004513	4	2	2	2	2	12
OG0004514	2	4	1	1	4	12
OG0004515	2	7	1	1	1	12
OG0004516	4	5	1	1	1	12
OG0004517	4	4	2	1	1	12
OG0004518	2	4	3	1	2	12
OG0004519	2	7	1	1	1	12
OG0004520	4	2	2	2	2	12
OG0004521	2	8	0	1	1	12
OG0004522	2	7	1	1	1	12
OG0004523	5	4	1	1	1	12
OG0004524	2	4	4	1	1	12
OG0004525	2	7	1	1	1	12
OG0004526	3	5	1	2	1	12
OG0004527	4	4	1	2	1	12
OG0004528	4	0	3	3	2	12
OG0004529	2	5	2	1	2	12
OG0004530	4	5	1	1	1	12
OG0004531	2	5	2	1	2	12
OG0004532	2	0	2	6	2	12
OG0004533	4	3	2	1	2	12
OG0004534	2	4	3	2	1	12
OG0004535	2	2	3	2	3	12
OG0004536	2	0	1	8	1	12
OG0004537	4	2	2	2	2	12
OG0004538	2	7	1	1	1	12
OG0004539	2	4	5	0	1	12
OG0004540	2	4	2	2	2	12
OG0004541	4	5	1	1	1	12
OG0004542	2	4	3	1	2	12
OG0004543	2	7	1	1	1	12
OG0004544	3	6	1	1	1	12
OG0004545	2	8	0	1	1	12
OG0004546	4	3	1	1	3	12
OG0004547	2	3	3	2	2	12
OG0004548	4	4	2	1	1	12
OG0004549	4	3	2	2	1	12
OG0004550	12	0	0	0	0	12
OG0004551	3	6	1	1	1	12
OG0004552	3	6	1	1	1	12
OG0004553	2	8	1	1	0	12
OG0004554	1	9	1	1	0	12
OG0004555	4	2	2	1	3	12
OG0004556	2	4	2	2	2	12
OG0004557	2	4	3	1	2	12
OG0004558	2	6	1	2	1	12
OG0004559	3	3	3	1	2	12
OG0004560	2	6	1	1	2	12
OG0004561	2	4	2	3	1	12
OG0004562	2	7	1	1	1	12
OG0004563	2	6	2	1	1	12
OG0004564	4	4	1	2	1	12
OG0004565	2	4	4	1	1	12
OG0004566	4	0	3	2	3	12
OG0004567	4	3	2	1	2	12
OG0004568	2	3	2	3	2	12
OG0004569	2	3	3	2	2	12
OG0004570	4	3	2	1	2	12
OG0004571	2	7	1	1	1	12
OG0004572	2	3	2	1	4	12
OG0004573	1	7	2	1	1	12
OG0004574	3	6	1	2	0	12
OG0004575	5	4	1	1	1	12
OG0004576	2	6	2	1	1	12
OG0004577	2	6	2	1	1	12
OG0004578	6	3	1	1	1	12
OG0004579	1	4	3	3	1	12
OG0004580	2	6	1	1	2	12
OG0004581	2	8	0	1	1	12
OG0004582	2	6	1	1	2	12
OG0004583	1	1	3	3	4	12
OG0004584	2	7	1	1	1	12
OG0004585	2	5	1	3	1	12
OG0004586	2	4	3	1	2	12
OG0004587	2	4	2	2	2	12
OG0004588	1	5	2	2	2	12
OG0004589	1	2	3	3	3	12
OG0004590	1	8	2	1	0	12
OG0004591	1	2	7	0	2	12
OG0004592	2	4	2	3	1	12
OG0004593	2	4	2	2	2	12
OG0004594	3	4	2	1	2	12
OG0004595	1	2	9	0	0	12
OG0004596	1	8	1	1	1	12
OG0004597	5	4	1	1	1	12
OG0004598	6	0	1	4	1	12
OG0004599	3	1	1	6	1	12
OG0004600	3	5	1	1	2	12
OG0004601	2	8	0	2	0	12
OG0004602	2	6	2	1	1	12
OG0004603	4	5	1	1	1	12
OG0004604	4	4	1	2	1	12
OG0004605	2	4	2	2	2	12
OG0004606	2	2	1	6	1	12
OG0004607	2	6	1	1	2	12
OG0004608	3	4	3	1	1	12
OG0004609	1	10	0	1	0	12
OG0004610	5	4	1	1	1	12
OG0004611	2	2	4	1	3	12
OG0004612	2	5	2	1	2	12
OG0004613	2	4	2	2	2	12
OG0004614	2	4	3	1	2	12
OG0004615	3	2	2	2	3	12
OG0004616	2	4	2	2	2	12
OG0004617	4	3	3	1	1	12
OG0004618	3	4	3	1	1	12
OG0004619	2	4	3	1	2	12
OG0004620	2	6	1	1	2	12
OG0004621	4	5	1	1	1	12
OG0004622	3	2	2	2	3	12
OG0004623	2	6	1	1	2	12
OG0004624	1	6	3	1	1	12
OG0004625	4	4	1	1	2	12
OG0004626	2	4	3	2	1	12
OG0004627	2	4	2	2	2	12
OG0004628	2	0	9	0	1	12
OG0004629	2	2	3	2	3	12
OG0004630	3	2	2	2	3	12
OG0004631	2	2	4	1	3	12
OG0004632	1	2	2	3	4	12
OG0004633	1	4	3	2	2	12
OG0004634	1	6	1	2	2	12
OG0004635	1	11	0	0	0	12
OG0004636	1	7	2	1	1	12
OG0004637	1	2	3	3	3	12
OG0004638	1	3	3	2	3	12
OG0004639	2	6	1	2	1	12
OG0004640	2	5	2	1	2	12
OG0004641	2	5	2	1	2	12
OG0004642	2	6	1	1	2	12
OG0004643	2	7	1	1	1	12
OG0004644	2	5	2	2	1	12
OG0004645	2	8	0	1	1	12
OG0004646	2	7	1	1	1	12
OG0004647	1	6	3	1	1	12
OG0004648	2	6	1	2	1	12
OG0004649	2	6	2	1	1	12
OG0004650	2	7	1	1	1	12
OG0004651	2	7	1	1	1	12
OG0004652	2	6	2	1	1	12
OG0004653	2	4	2	2	2	12
OG0004654	4	2	1	2	3	12
OG0004655	2	6	2	1	1	12
OG0004656	7	2	1	1	1	12
OG0004657	2	7	1	1	1	12
OG0004658	2	5	2	1	2	12
OG0004659	2	4	2	2	2	12
OG0004660	2	3	2	3	2	12
OG0004661	2	5	3	1	1	12
OG0004662	4	3	2	1	2	12
OG0004663	2	7	1	1	1	12
OG0004664	2	7	1	1	1	12
OG0004665	2	3	2	1	4	12
OG0004666	2	7	1	1	1	12
OG0004667	2	2	3	2	3	12
OG0004668	2	6	1	1	2	12
OG0004669	2	7	1	1	1	12
OG0004670	2	7	1	1	1	12
OG0004671	2	3	1	2	4	12
OG0004672	2	6	1	1	2	12
OG0004673	2	5	2	1	2	12
OG0004674	2	6	1	1	2	12
OG0004675	2	7	1	1	1	12
OG0004676	4	3	2	1	2	12
OG0004677	2	4	2	2	2	12
OG0004678	2	6	1	1	2	12
OG0004679	2	4	1	4	1	12
OG0004680	2	7	0	2	1	12
OG0004681	2	6	1	1	2	12
OG0004682	3	1	4	0	4	12
OG0004683	1	7	1	1	2	12
OG0004684	2	7	1	1	1	12
OG0004685	1	6	1	3	1	12
OG0004686	1	7	1	1	2	12
OG0004687	1	4	4	1	2	12
OG0004688	1	5	2	1	3	12
OG0004689	1	4	3	1	3	12
OG0004690	1	6	2	1	2	12
OG0004691	2	5	2	1	2	12
OG0004692	1	3	2	3	3	12
OG0004693	1	7	1	2	1	12
OG0004694	0	12	0	0	0	12
OG0004695	0	12	0	0	0	12
OG0004696	0	9	1	1	1	12
OG0004697	0	7	2	2	1	12
OG0004698	0	9	1	2	0	12
OG0004699	0	12	0	0	0	12
OG0004700	0	12	0	0	0	12
OG0004701	0	12	0	0	0	12
OG0004702	0	12	0	0	0	12
OG0004703	0	2	4	2	4	12
OG0004704	0	7	1	1	3	12
OG0004705	0	11	0	1	0	12
OG0004706	0	12	0	0	0	12
OG0004707	0	12	0	0	0	12
OG0004708	0	12	0	0	0	12
OG0004709	0	12	0	0	0	12
OG0004710	0	12	0	0	0	12
OG0004711	0	12	0	0	0	12
OG0004712	0	12	0	0	0	12
OG0004713	0	12	0	0	0	12
OG0004714	0	12	0	0	0	12
OG0004715	0	9	1	1	1	12
OG0004716	0	12	0	0	0	12
OG0004717	0	12	0	0	0	12
OG0004718	0	6	3	1	2	12
OG0004719	0	12	0	0	0	12
OG0004720	0	8	2	1	1	12
OG0004721	0	12	0	0	0	12
OG0004722	0	12	0	0	0	12
OG0004723	0	12	0	0	0	12
OG0004724	0	8	2	1	1	12
OG0004725	0	12	0	0	0	12
OG0004726	0	12	0	0	0	12
OG0004727	0	12	0	0	0	12
OG0004728	0	12	0	0	0	12
OG0004729	0	12	0	0	0	12
OG0004730	0	9	1	2	0	12
OG0004731	0	12	0	0	0	12
OG0004732	0	6	3	1	2	12
OG0004733	0	12	0	0	0	12
OG0004734	0	12	0	0	0	12
OG0004735	0	12	0	0	0	12
OG0004736	0	12	0	0	0	12
OG0004737	0	8	1	2	1	12
OG0004738	0	12	0	0	0	12
OG0004739	0	12	0	0	0	12
OG0004740	0	4	1	2	5	12
OG0004741	0	12	0	0	0	12
OG0004742	0	12	0	0	0	12
OG0004743	0	12	0	0	0	12
OG0004744	0	7	1	2	2	12
OG0004745	0	12	0	0	0	12
OG0004746	0	11	1	0	0	12
OG0004747	0	12	0	0	0	12
OG0004748	0	9	1	1	1	12
OG0004749	0	12	0	0	0	12
OG0004750	0	12	0	0	0	12
OG0004751	0	12	0	0	0	12
OG0004752	0	12	0	0	0	12
OG0004753	0	6	2	2	2	12
OG0004754	0	12	0	0	0	12
OG0004755	0	12	0	0	0	12
OG0004756	0	6	3	1	2	12
OG0004757	0	12	0	0	0	12
OG0004758	0	8	1	2	1	12
OG0004759	0	12	0	0	0	12
OG0004760	0	7	2	2	1	12
OG0004761	0	12	0	0	0	12
OG0004762	0	12	0	0	0	12
OG0004763	0	3	7	0	2	12
OG0004764	0	7	1	2	2	12
OG0004765	0	12	0	0	0	12
OG0004766	0	12	0	0	0	12
OG0004767	0	1	9	0	2	12
OG0004768	0	9	1	1	1	12
OG0004769	0	4	1	6	1	12
OG0004770	0	6	1	0	5	12
OG0004771	0	7	2	0	3	12
OG0004772	0	3	3	1	5	12
OG0004773	0	6	2	2	2	12
OG0004774	0	12	0	0	0	12
OG0004775	0	4	2	4	2	12
OG0004776	0	4	6	1	1	12
OG0004777	0	9	1	1	1	12
OG0004778	0	12	0	0	0	12
OG0004779	0	8	1	1	2	12
OG0004780	0	2	6	0	4	12
OG0004781	0	12	0	0	0	12
OG0004782	0	1	10	1	0	12
OG0004783	0	0	11	0	1	12
OG0004784	0	0	11	0	1	12
OG0004785	0	0	11	0	1	12
OG0004786	0	0	3	8	1	12
OG0004787	0	0	6	0	6	12
OG0004788	0	0	6	0	6	12
OG0004789	0	0	6	0	6	12
OG0004790	0	0	12	0	0	12
OG0004791	0	0	4	0	8	12
OG0004792	0	0	12	0	0	12
OG0004793	0	0	8	0	4	12
OG0004794	0	0	9	0	3	12
OG0004795	0	0	3	0	9	12
OG0004796	0	0	6	0	6	12
OG0004797	0	0	11	0	1	12
OG0004798	0	0	6	1	5	12
OG0004799	0	0	10	0	2	12
OG0004800	0	0	12	0	0	12
OG0004801	0	0	3	0	9	12
OG0004802	0	0	4	0	8	12
OG0004803	0	0	1	0	11	12
OG0004804	0	0	2	0	10	12
OG0004805	0	0	11	0	1	12
OG0004806	0	0	11	0	1	12
OG0004807	0	0	4	0	8	12
OG0004808	0	0	1	1	10	12
OG0004809	0	0	1	0	11	12
OG0004810	0	0	1	0	11	12
OG0004811	0	0	0	12	0	12
OG0004812	0	0	0	12	0	12
OG0004813	0	0	0	12	0	12
OG0004814	0	0	0	12	0	12
OG0004815	0	0	0	12	0	12
OG0004816	0	0	0	12	0	12
OG0004817	0	0	0	12	0	12
OG0004818	0	0	0	0	12	12
OG0004819	0	0	0	0	12	12
OG0004820	0	0	0	0	12	12
OG0004821	0	0	0	0	12	12
OG0004822	0	0	0	0	12	12
OG0004823	0	0	0	0	12	12
OG0004824	0	0	0	0	12	12
OG0004825	0	0	0	0	12	12
OG0004826	0	0	0	0	12	12
OG0004827	0	0	0	0	12	12
OG0004828	0	0	0	0	12	12
OG0004829	0	0	0	0	12	12
OG0004830	11	0	0	0	0	11
OG0004831	11	0	0	0	0	11
OG0004832	4	2	2	1	2	11
OG0004833	11	0	0	0	0	11
OG0004834	11	0	0	0	0	11
OG0004835	4	4	1	1	1	11
OG0004836	11	0	0	0	0	11
OG0004837	11	0	0	0	0	11
OG0004838	10	0	0	1	0	11
OG0004839	4	3	1	2	1	11
OG0004840	10	1	0	0	0	11
OG0004841	4	3	2	1	1	11
OG0004842	4	2	3	1	1	11
OG0004843	2	4	1	2	2	11
OG0004844	4	2	2	1	2	11
OG0004845	6	2	1	1	1	11
OG0004846	3	4	2	1	1	11
OG0004847	6	2	1	1	1	11
OG0004848	4	3	1	2	1	11
OG0004849	3	6	1	1	0	11
OG0004850	6	2	1	1	1	11
OG0004851	4	4	1	1	1	11
OG0004852	4	2	2	1	2	11
OG0004853	4	1	2	2	2	11
OG0004854	2	4	2	1	2	11
OG0004855	11	0	0	0	0	11
OG0004856	5	3	1	1	1	11
OG0004857	5	2	2	1	1	11
OG0004858	4	2	1	2	2	11
OG0004859	6	2	1	1	1	11
OG0004860	4	3	1	1	2	11
OG0004861	4	2	1	2	2	11
OG0004862	11	0	0	0	0	11
OG0004863	2	6	1	1	1	11
OG0004864	6	2	1	1	1	11
OG0004865	2	2	2	2	3	11
OG0004866	11	0	0	0	0	11
OG0004867	4	4	1	1	1	11
OG0004868	4	3	2	1	1	11
OG0004869	2	5	1	2	1	11
OG0004870	8	0	1	1	1	11
OG0004871	2	5	1	1	2	11
OG0004872	4	4	1	1	1	11
OG0004873	6	2	1	1	1	11
OG0004874	6	2	1	1	1	11
OG0004875	2	3	3	1	2	11
OG0004876	6	0	2	1	2	11
OG0004877	4	2	2	1	2	11
OG0004878	2	5	2	1	1	11
OG0004879	11	0	0	0	0	11
OG0004880	2	9	0	0	0	11
OG0004881	4	2	2	1	2	11
OG0004882	4	4	1	1	1	11
OG0004883	4	4	1	1	1	11
OG0004884	2	4	2	1	2	11
OG0004885	2	6	1	1	1	11
OG0004886	4	4	1	1	1	11
OG0004887	4	3	2	1	1	11
OG0004888	4	2	1	3	1	11
OG0004889	4	4	1	1	1	11
OG0004890	6	0	2	1	2	11
OG0004891	4	1	1	2	3	11
OG0004892	2	6	1	1	1	11
OG0004893	4	3	1	1	2	11
OG0004894	2	2	1	2	4	11
OG0004895	2	4	2	1	2	11
OG0004896	4	4	1	1	1	11
OG0004897	4	4	1	1	1	11
OG0004898	5	4	0	1	1	11
OG0004899	5	2	2	1	1	11
OG0004900	5	3	1	1	1	11
OG0004901	11	0	0	0	0	11
OG0004902	5	3	1	1	1	11
OG0004903	4	2	2	1	2	11
OG0004904	2	6	0	1	2	11
OG0004905	4	2	2	1	2	11
OG0004906	5	4	0	1	1	11
OG0004907	4	4	1	1	1	11
OG0004908	3	4	2	1	1	11
OG0004909	4	4	1	1	1	11
OG0004910	4	2	2	1	2	11
OG0004911	11	0	0	0	0	11
OG0004912	11	0	0	0	0	11
OG0004913	4	1	2	2	2	11
OG0004914	2	0	3	3	3	11
OG0004915	2	2	2	2	3	11
OG0004916	4	3	1	2	1	11
OG0004917	6	2	0	2	1	11
OG0004918	5	2	1	2	1	11
OG0004919	4	4	1	1	1	11
OG0004920	4	2	2	1	2	11
OG0004921	2	5	2	1	1	11
OG0004922	2	1	3	2	3	11
OG0004923	4	4	1	1	1	11
OG0004924	2	4	2	1	2	11
OG0004925	4	2	2	1	2	11
OG0004926	11	0	0	0	0	11
OG0004927	4	4	1	1	1	11
OG0004928	2	4	2	1	2	11
OG0004929	4	4	1	1	1	11
OG0004930	4	3	0	1	3	11
OG0004931	2	4	2	1	2	11
OG0004932	4	2	2	1	2	11
OG0004933	2	6	1	1	1	11
OG0004934	4	4	1	1	1	11
OG0004935	4	2	1	3	1	11
OG0004936	4	2	2	1	2	11
OG0004937	4	4	1	1	1	11
OG0004938	8	0	1	1	1	11
OG0004939	3	2	2	1	3	11
OG0004940	7	0	1	2	1	11
OG0004941	3	4	1	1	2	11
OG0004942	4	1	2	2	2	11
OG0004943	2	3	1	4	1	11
OG0004944	4	4	1	1	1	11
OG0004945	3	4	2	1	1	11
OG0004946	9	0	2	0	0	11
OG0004947	5	2	3	1	0	11
OG0004948	7	0	2	0	2	11
OG0004949	1	2	6	0	2	11
OG0004950	4	2	3	0	2	11
OG0004951	11	0	0	0	0	11
OG0004952	2	5	2	1	1	11
OG0004953	3	4	1	1	2	11
OG0004954	5	4	0	1	1	11
OG0004955	2	6	1	1	1	11
OG0004956	4	3	1	1	2	11
OG0004957	3	2	2	2	2	11
OG0004958	2	6	1	1	1	11
OG0004959	2	5	1	1	2	11
OG0004960	2	3	2	2	2	11
OG0004961	2	4	2	1	2	11
OG0004962	1	4	2	1	3	11
OG0004963	3	4	1	2	1	11
OG0004964	4	4	1	1	1	11
OG0004965	3	5	1	1	1	11
OG0004966	4	2	1	2	2	11
OG0004967	2	6	1	1	1	11
OG0004968	2	4	1	3	1	11
OG0004969	2	4	2	1	2	11
OG0004970	10	0	0	1	0	11
OG0004971	4	4	1	1	1	11
OG0004972	2	6	1	1	1	11
OG0004973	1	5	1	1	3	11
OG0004974	4	1	2	2	2	11
OG0004975	2	6	1	1	1	11
OG0004976	6	1	2	1	1	11
OG0004977	11	0	0	0	0	11
OG0004978	2	0	6	2	1	11
OG0004979	4	1	3	1	2	11
OG0004980	4	1	2	2	2	11
OG0004981	2	6	1	1	1	11
OG0004982	1	8	1	0	1	11
OG0004983	3	5	1	1	1	11
OG0004984	8	1	1	1	0	11
OG0004985	2	3	1	2	3	11
OG0004986	7	0	1	1	2	11
OG0004987	4	4	1	1	1	11
OG0004988	8	2	0	1	0	11
OG0004989	4	2	2	1	2	11
OG0004990	2	5	2	1	1	11
OG0004991	10	1	0	0	0	11
OG0004992	3	5	1	1	1	11
OG0004993	4	2	1	2	2	11
OG0004994	4	4	1	1	1	11
OG0004995	2	4	2	1	2	11
OG0004996	4	4	1	1	1	11
OG0004997	2	5	1	1	2	11
OG0004998	6	2	1	1	1	11
OG0004999	3	5	1	1	1	11
OG0005000	2	2	2	2	3	11
OG0005001	4	2	2	1	2	11
OG0005002	3	5	1	1	1	11
OG0005003	11	0	0	0	0	11
OG0005004	4	4	0	1	2	11
OG0005005	2	4	2	2	1	11
OG0005006	4	4	1	1	1	11
OG0005007	3	4	1	1	2	11
OG0005008	2	6	1	1	1	11
OG0005009	4	4	1	1	1	11
OG0005010	2	4	2	1	2	11
OG0005011	4	4	1	1	1	11
OG0005012	4	4	1	1	1	11
OG0005013	11	0	0	0	0	11
OG0005014	2	4	1	3	1	11
OG0005015	2	6	1	1	1	11
OG0005016	2	6	1	1	1	11
OG0005017	4	3	1	2	1	11
OG0005018	2	5	2	1	1	11
OG0005019	11	0	0	0	0	11
OG0005020	2	6	1	1	1	11
OG0005021	2	6	1	1	1	11
OG0005022	2	0	1	8	0	11
OG0005023	3	5	1	1	1	11
OG0005024	3	7	0	1	0	11
OG0005025	2	4	2	1	2	11
OG0005026	2	1	3	2	3	11
OG0005027	2	4	2	2	1	11
OG0005028	5	2	1	2	1	11
OG0005029	2	3	2	2	2	11
OG0005030	4	3	2	1	1	11
OG0005031	4	2	1	2	2	11
OG0005032	2	4	3	1	1	11
OG0005033	2	4	2	1	2	11
OG0005034	3	1	2	3	2	11
OG0005035	2	4	3	1	1	11
OG0005036	8	1	0	1	1	11
OG0005037	2	4	1	2	2	11
OG0005038	4	4	1	1	1	11
OG0005039	6	0	2	1	2	11
OG0005040	3	3	3	1	1	11
OG0005041	4	3	1	1	2	11
OG0005042	3	4	1	2	1	11
OG0005043	11	0	0	0	0	11
OG0005044	3	5	1	1	1	11
OG0005045	4	4	1	1	1	11
OG0005046	2	4	2	2	1	11
OG0005047	4	2	3	1	1	11
OG0005048	2	5	1	2	1	11
OG0005049	2	7	0	1	1	11
OG0005050	4	3	1	2	1	11
OG0005051	2	5	2	1	1	11
OG0005052	4	2	2	1	2	11
OG0005053	4	4	1	1	1	11
OG0005054	4	3	1	2	1	11
OG0005055	2	5	1	1	2	11
OG0005056	2	4	2	2	1	11
OG0005057	11	0	0	0	0	11
OG0005058	4	2	2	1	2	11
OG0005059	2	2	1	4	2	11
OG0005060	2	4	2	1	2	11
OG0005061	4	4	1	1	1	11
OG0005062	6	1	1	2	1	11
OG0005063	2	6	1	1	1	11
OG0005064	1	6	1	1	2	11
OG0005065	2	6	0	2	1	11
OG0005066	4	4	1	1	1	11
OG0005067	4	4	1	1	1	11
OG0005068	2	6	1	1	1	11
OG0005069	2	8	0	1	0	11
OG0005070	11	0	0	0	0	11
OG0005071	2	6	1	1	1	11
OG0005072	2	5	1	2	1	11
OG0005073	4	1	2	1	3	11
OG0005074	4	2	2	1	2	11
OG0005075	5	0	2	2	2	11
OG0005076	2	4	2	1	2	11
OG0005077	4	4	1	1	1	11
OG0005078	4	0	1	2	4	11
OG0005079	1	1	0	8	1	11
OG0005080	2	4	2	1	2	11
OG0005081	3	1	2	3	2	11
OG0005082	2	6	1	1	1	11
OG0005083	2	5	2	1	1	11
OG0005084	4	2	2	1	2	11
OG0005085	2	7	1	1	0	11
OG0005086	3	3	3	1	1	11
OG0005087	4	3	1	2	1	11
OG0005088	6	2	1	1	1	11
OG0005089	8	0	1	1	1	11
OG0005090	4	5	1	1	0	11
OG0005091	2	5	1	2	1	11
OG0005092	4	4	1	1	1	11
OG0005093	2	6	2	0	1	11
OG0005094	4	4	1	1	1	11
OG0005095	5	2	2	1	1	11
OG0005096	2	6	1	1	1	11
OG0005097	4	3	2	1	1	11
OG0005098	4	2	2	1	2	11
OG0005099	4	4	1	1	1	11
OG0005100	2	6	1	1	1	11
OG0005101	4	4	1	1	1	11
OG0005102	2	6	1	1	1	11
OG0005103	2	5	1	1	2	11
OG0005104	4	1	3	1	2	11
OG0005105	11	0	0	0	0	11
OG0005106	4	4	1	1	1	11
OG0005107	2	6	1	1	1	11
OG0005108	3	2	2	1	3	11
OG0005109	2	5	2	1	1	11
OG0005110	3	6	0	1	1	11
OG0005111	2	6	1	1	1	11
OG0005112	2	6	1	1	1	11
OG0005113	6	0	1	1	3	11
OG0005114	4	0	2	3	2	11
OG0005115	5	2	1	2	1	11
OG0005116	2	8	0	1	0	11
OG0005117	6	2	0	2	1	11
OG0005118	2	6	1	1	1	11
OG0005119	4	2	2	1	2	11
OG0005120	2	3	2	2	2	11
OG0005121	4	3	2	1	1	11
OG0005122	4	2	1	2	2	11
OG0005123	4	4	1	1	1	11
OG0005124	2	6	1	1	1	11
OG0005125	2	4	2	1	2	11
OG0005126	4	2	3	1	1	11
OG0005127	2	3	2	2	2	11
OG0005128	11	0	0	0	0	11
OG0005129	4	4	1	1	1	11
OG0005130	4	3	1	2	1	11
OG0005131	2	3	4	1	1	11
OG0005132	4	4	1	1	1	11
OG0005133	1	6	1	1	2	11
OG0005134	4	4	1	1	1	11
OG0005135	5	2	1	1	2	11
OG0005136	4	2	2	1	2	11
OG0005137	4	4	1	1	1	11
OG0005138	3	5	1	1	1	11
OG0005139	3	5	1	1	1	11
OG0005140	6	2	1	1	1	11
OG0005141	3	5	1	1	1	11
OG0005142	6	2	0	1	2	11
OG0005143	4	4	1	1	1	11
OG0005144	5	3	1	1	1	11
OG0005145	2	6	1	1	1	11
OG0005146	2	2	3	2	2	11
OG0005147	2	3	2	1	3	11
OG0005148	4	2	1	2	2	11
OG0005149	3	4	1	2	1	11
OG0005150	4	2	2	1	2	11
OG0005151	2	3	2	1	3	11
OG0005152	4	4	1	1	1	11
OG0005153	11	0	0	0	0	11
OG0005154	7	2	0	1	1	11
OG0005155	4	5	1	1	0	11
OG0005156	5	0	2	2	2	11
OG0005157	2	4	1	1	3	11
OG0005158	4	4	1	1	1	11
OG0005159	4	3	1	1	2	11
OG0005160	6	2	1	1	1	11
OG0005161	2	6	1	1	1	11
OG0005162	3	4	0	2	2	11
OG0005163	3	3	1	2	2	11
OG0005164	2	6	1	1	1	11
OG0005165	6	2	1	1	1	11
OG0005166	6	2	1	1	1	11
OG0005167	3	2	2	2	2	11
OG0005168	3	3	4	0	1	11
OG0005169	2	6	1	1	1	11
OG0005170	2	5	1	1	2	11
OG0005171	5	3	1	1	1	11
OG0005172	4	4	1	1	1	11
OG0005173	4	0	2	1	4	11
OG0005174	4	4	1	1	1	11
OG0005175	2	5	1	1	2	11
OG0005176	2	7	0	1	1	11
OG0005177	4	4	1	1	1	11
OG0005178	10	0	0	0	1	11
OG0005179	3	4	2	1	1	11
OG0005180	7	0	2	1	1	11
OG0005181	4	2	2	1	2	11
OG0005182	4	2	2	1	2	11
OG0005183	2	6	1	1	1	11
OG0005184	2	4	1	1	3	11
OG0005185	4	4	0	2	1	11
OG0005186	2	6	1	1	1	11
OG0005187	7	0	1	2	1	11
OG0005188	4	4	1	1	1	11
OG0005189	6	1	1	2	1	11
OG0005190	2	5	2	1	1	11
OG0005191	5	3	1	1	1	11
OG0005192	4	4	1	1	1	11
OG0005193	3	2	2	2	2	11
OG0005194	2	2	1	3	3	11
OG0005195	2	4	2	1	2	11
OG0005196	4	1	2	1	3	11
OG0005197	4	3	1	2	1	11
OG0005198	2	4	2	1	2	11
OG0005199	4	4	1	1	1	11
OG0005200	2	5	1	0	3	11
OG0005201	2	6	1	1	1	11
OG0005202	2	4	2	1	2	11
OG0005203	2	2	3	1	3	11
OG0005204	1	4	2	2	2	11
OG0005205	2	5	1	1	2	11
OG0005206	2	4	1	2	2	11
OG0005207	4	4	1	1	1	11
OG0005208	7	1	1	1	1	11
OG0005209	3	5	1	1	1	11
OG0005210	4	4	1	1	1	11
OG0005211	2	4	1	2	2	11
OG0005212	2	5	2	1	1	11
OG0005213	2	6	1	1	1	11
OG0005214	2	2	2	2	3	11
OG0005215	4	4	1	1	1	11
OG0005216	4	2	2	1	2	11
OG0005217	2	7	0	1	1	11
OG0005218	4	3	2	1	1	11
OG0005219	2	5	1	1	2	11
OG0005220	4	4	1	1	1	11
OG0005221	2	6	1	1	1	11
OG0005222	3	4	1	2	1	11
OG0005223	7	0	1	2	1	11
OG0005224	2	6	1	1	1	11
OG0005225	2	5	2	1	1	11
OG0005226	4	1	3	1	2	11
OG0005227	5	2	1	1	2	11
OG0005228	2	4	3	1	1	11
OG0005229	2	4	2	1	2	11
OG0005230	6	2	1	1	1	11
OG0005231	5	3	1	1	1	11
OG0005232	2	4	1	2	2	11
OG0005233	2	6	1	1	1	11
OG0005234	3	4	2	1	1	11
OG0005235	3	5	1	1	1	11
OG0005236	4	4	1	1	1	11
OG0005237	3	5	1	1	1	11
OG0005238	4	1	1	2	3	11
OG0005239	2	6	1	1	1	11
OG0005240	2	6	1	1	1	11
OG0005241	4	4	1	1	1	11
OG0005242	4	5	0	1	1	11
OG0005243	2	6	1	1	1	11
OG0005244	4	4	1	1	1	11
OG0005245	4	3	1	1	2	11
OG0005246	3	3	2	1	2	11
OG0005247	4	4	1	1	1	11
OG0005248	2	4	2	1	2	11
OG0005249	3	4	0	1	3	11
OG0005250	3	3	2	1	2	11
OG0005251	4	4	1	1	1	11
OG0005252	2	6	1	1	1	11
OG0005253	7	2	1	1	0	11
OG0005254	4	4	1	1	1	11
OG0005255	2	0	2	5	2	11
OG0005256	4	2	1	1	3	11
OG0005257	2	2	2	3	2	11
OG0005258	2	6	1	2	0	11
OG0005259	4	4	1	1	1	11
OG0005260	2	4	2	1	2	11
OG0005261	1	2	3	2	3	11
OG0005262	4	2	2	2	1	11
OG0005263	2	4	1	2	2	11
OG0005264	4	4	1	1	1	11
OG0005265	4	3	1	2	1	11
OG0005266	2	6	1	1	1	11
OG0005267	4	3	2	1	1	11
OG0005268	2	6	1	1	1	11
OG0005269	4	4	1	1	1	11
OG0005270	6	3	1	1	0	11
OG0005271	2	3	2	2	2	11
OG0005272	2	6	1	1	1	11
OG0005273	4	4	1	1	1	11
OG0005274	4	4	1	1	1	11
OG0005275	1	6	1	1	2	11
OG0005276	5	2	1	2	1	11
OG0005277	3	4	1	1	2	11
OG0005278	2	4	3	1	1	11
OG0005279	4	2	1	2	2	11
OG0005280	4	2	2	1	2	11
OG0005281	4	2	1	3	1	11
OG0005282	4	4	1	1	1	11
OG0005283	2	5	1	2	1	11
OG0005284	2	6	1	1	1	11
OG0005285	2	6	1	1	1	11
OG0005286	2	6	1	1	1	11
OG0005287	2	6	1	1	1	11
OG0005288	3	5	1	1	1	11
OG0005289	4	4	1	1	1	11
OG0005290	2	4	1	2	2	11
OG0005291	4	4	1	1	1	11
OG0005292	2	6	1	1	1	11
OG0005293	4	2	3	1	1	11
OG0005294	4	4	1	1	1	11
OG0005295	3	4	2	1	1	11
OG0005296	2	4	2	1	2	11
OG0005297	2	6	1	1	1	11
OG0005298	4	4	1	1	1	11
OG0005299	2	6	1	1	1	11
OG0005300	2	6	1	1	1	11
OG0005301	2	6	1	1	1	11
OG0005302	3	4	2	1	1	11
OG0005303	2	5	1	2	1	11
OG0005304	11	0	0	0	0	11
OG0005305	2	1	2	3	3	11
OG0005306	4	6	0	1	0	11
OG0005307	2	4	2	1	2	11
OG0005308	4	2	2	2	1	11
OG0005309	2	4	1	2	2	11
OG0005310	3	4	2	1	1	11
OG0005311	2	4	2	1	2	11
OG0005312	2	4	2	1	2	11
OG0005313	2	5	2	1	1	11
OG0005314	5	2	1	2	1	11
OG0005315	4	4	1	1	1	11
OG0005316	2	6	1	1	1	11
OG0005317	2	4	2	1	2	11
OG0005318	4	4	1	1	1	11
OG0005319	5	1	3	1	1	11
OG0005320	4	3	2	1	1	11
OG0005321	4	4	1	1	1	11
OG0005322	2	5	1	2	1	11
OG0005323	4	4	1	1	1	11
OG0005324	2	3	2	1	3	11
OG0005325	4	1	2	2	2	11
OG0005326	4	2	2	2	1	11
OG0005327	4	0	2	2	3	11
OG0005328	2	4	2	1	2	11
OG0005329	5	2	1	2	1	11
OG0005330	4	4	1	1	1	11
OG0005331	2	4	2	1	2	11
OG0005332	2	6	1	1	1	11
OG0005333	3	2	2	2	2	11
OG0005334	4	4	1	1	1	11
OG0005335	2	6	1	1	1	11
OG0005336	4	5	1	1	0	11
OG0005337	2	4	1	3	1	11
OG0005338	5	2	2	1	1	11
OG0005339	2	3	1	1	4	11
OG0005340	11	0	0	0	0	11
OG0005341	2	6	1	1	1	11
OG0005342	5	2	2	0	2	11
OG0005343	2	5	2	1	1	11
OG0005344	2	5	1	2	1	11
OG0005345	2	6	1	1	1	11
OG0005346	2	6	0	2	1	11
OG0005347	4	4	1	1	1	11
OG0005348	2	4	1	2	2	11
OG0005349	3	1	4	1	2	11
OG0005350	4	4	1	1	1	11
OG0005351	2	7	0	1	1	11
OG0005352	2	4	3	1	1	11
OG0005353	2	5	1	2	1	11
OG0005354	2	2	2	2	3	11
OG0005355	3	2	2	2	2	11
OG0005356	2	1	3	3	2	11
OG0005357	2	4	2	1	2	11
OG0005358	2	6	1	1	1	11
OG0005359	5	4	0	1	1	11
OG0005360	4	3	1	2	1	11
OG0005361	4	0	2	3	2	11
OG0005362	4	1	2	2	2	11
OG0005363	4	1	1	4	1	11
OG0005364	4	4	1	1	1	11
OG0005365	4	2	1	3	1	11
OG0005366	4	4	1	1	1	11
OG0005367	2	4	2	1	2	11
OG0005368	4	4	1	1	1	11
OG0005369	3	3	2	1	2	11
OG0005370	4	0	3	1	3	11
OG0005371	2	5	2	1	1	11
OG0005372	3	6	1	0	1	11
OG0005373	3	0	3	3	2	11
OG0005374	4	4	1	1	1	11
OG0005375	4	2	2	1	2	11
OG0005376	2	4	1	1	3	11
OG0005377	2	4	2	1	2	11
OG0005378	4	4	1	1	1	11
OG0005379	2	5	2	1	1	11
OG0005380	4	4	1	1	1	11
OG0005381	2	2	5	1	1	11
OG0005382	2	6	1	1	1	11
OG0005383	2	5	1	2	1	11
OG0005384	3	5	1	1	1	11
OG0005385	2	4	2	1	2	11
OG0005386	3	4	1	2	1	11
OG0005387	5	2	2	1	1	11
OG0005388	2	6	1	1	1	11
OG0005389	2	6	1	1	1	11
OG0005390	2	3	3	1	2	11
OG0005391	2	2	1	2	4	11
OG0005392	4	2	2	1	2	11
OG0005393	5	4	0	1	1	11
OG0005394	4	4	1	1	1	11
OG0005395	2	6	1	1	1	11
OG0005396	2	4	3	1	1	11
OG0005397	4	1	2	3	1	11
OG0005398	2	4	2	1	2	11
OG0005399	4	2	2	2	1	11
OG0005400	4	4	1	1	1	11
OG0005401	4	4	1	1	1	11
OG0005402	4	3	2	1	1	11
OG0005403	11	0	0	0	0	11
OG0005404	5	0	2	2	2	11
OG0005405	2	6	1	1	1	11
OG0005406	11	0	0	0	0	11
OG0005407	2	2	4	1	2	11
OG0005408	2	6	1	1	1	11
OG0005409	2	3	3	1	2	11
OG0005410	3	3	2	1	2	11
OG0005411	2	6	1	1	1	11
OG0005412	2	4	2	2	1	11
OG0005413	2	4	2	1	2	11
OG0005414	4	4	1	1	1	11
OG0005415	4	3	2	1	1	11
OG0005416	2	6	1	1	1	11
OG0005417	2	2	4	1	2	11
OG0005418	2	5	2	1	1	11
OG0005419	11	0	0	0	0	11
OG0005420	4	4	1	1	1	11
OG0005421	2	1	3	3	2	11
OG0005422	7	0	1	3	0	11
OG0005423	3	1	3	1	3	11
OG0005424	5	4	0	1	1	11
OG0005425	2	4	2	1	2	11
OG0005426	2	4	2	1	2	11
OG0005427	6	0	2	1	2	11
OG0005428	2	4	2	1	2	11
OG0005429	2	4	1	2	2	11
OG0005430	2	3	2	2	2	11
OG0005431	2	5	2	1	1	11
OG0005432	4	4	1	1	1	11
OG0005433	4	1	1	4	1	11
OG0005434	4	3	1	1	2	11
OG0005435	5	3	1	1	1	11
OG0005436	2	6	1	1	1	11
OG0005437	2	4	2	1	2	11
OG0005438	2	5	2	1	1	11
OG0005439	2	3	2	1	3	11
OG0005440	2	4	2	1	2	11
OG0005441	3	2	3	1	2	11
OG0005442	4	4	1	1	1	11
OG0005443	3	5	1	1	1	11
OG0005444	6	3	0	1	1	11
OG0005445	2	4	2	1	2	11
OG0005446	2	4	1	2	2	11
OG0005447	3	3	2	1	2	11
OG0005448	4	4	1	1	1	11
OG0005449	2	2	1	4	2	11
OG0005450	2	6	1	1	1	11
OG0005451	3	1	2	3	2	11
OG0005452	2	7	1	1	0	11
OG0005453	2	4	2	1	2	11
OG0005454	2	4	2	1	2	11
OG0005455	4	2	1	2	2	11
OG0005456	4	5	1	1	0	11
OG0005457	2	6	1	1	1	11
OG0005458	4	2	1	2	2	11
OG0005459	4	2	2	1	2	11
OG0005460	2	5	1	1	2	11
OG0005461	4	4	1	1	1	11
OG0005462	3	5	1	1	1	11
OG0005463	2	4	2	1	2	11
OG0005464	4	2	2	2	1	11
OG0005465	2	5	2	1	1	11
OG0005466	2	6	1	1	1	11
OG0005467	2	5	2	1	1	11
OG0005468	2	4	2	1	2	11
OG0005469	2	6	1	1	1	11
OG0005470	3	4	1	2	1	11
OG0005471	1	2	3	2	3	11
OG0005472	4	4	1	1	1	11
OG0005473	4	3	1	1	2	11
OG0005474	2	3	3	1	2	11
OG0005475	4	4	1	1	1	11
OG0005476	3	1	2	2	3	11
OG0005477	2	4	2	1	2	11
OG0005478	2	2	0	6	1	11
OG0005479	2	4	1	1	3	11
OG0005480	2	6	1	1	1	11
OG0005481	4	4	1	1	1	11
OG0005482	4	4	1	1	1	11
OG0005483	1	7	1	1	1	11
OG0005484	2	3	2	2	2	11
OG0005485	5	0	3	1	2	11
OG0005486	2	6	1	1	1	11
OG0005487	2	7	0	1	1	11
OG0005488	3	4	1	1	2	11
OG0005489	2	5	1	2	1	11
OG0005490	4	2	3	1	1	11
OG0005491	1	0	3	4	3	11
OG0005492	2	4	3	2	0	11
OG0005493	4	4	1	1	1	11
OG0005494	2	6	1	1	1	11
OG0005495	2	4	1	2	2	11
OG0005496	6	4	0	1	0	11
OG0005497	2	5	2	1	1	11
OG0005498	2	6	1	1	1	11
OG0005499	2	2	2	1	4	11
OG0005500	2	8	0	1	0	11
OG0005501	3	4	2	1	1	11
OG0005502	4	4	1	1	1	11
OG0005503	4	4	1	1	1	11
OG0005504	4	2	2	1	2	11
OG0005505	1	6	1	2	1	11
OG0005506	2	6	1	1	1	11
OG0005507	2	5	1	1	2	11
OG0005508	2	6	1	1	1	11
OG0005509	2	6	1	1	1	11
OG0005510	4	4	1	1	1	11
OG0005511	2	4	2	1	2	11
OG0005512	1	3	3	2	2	11
OG0005513	4	4	1	1	1	11
OG0005514	2	4	1	2	2	11
OG0005515	2	4	2	1	2	11
OG0005516	4	4	1	1	1	11
OG0005517	2	2	3	2	2	11
OG0005518	3	3	2	2	1	11
OG0005519	4	2	2	1	2	11
OG0005520	2	4	1	3	1	11
OG0005521	4	5	0	1	1	11
OG0005522	2	7	0	1	1	11
OG0005523	2	4	2	2	1	11
OG0005524	5	3	1	1	1	11
OG0005525	2	6	1	1	1	11
OG0005526	2	4	2	1	2	11
OG0005527	4	2	2	1	2	11
OG0005528	3	2	2	3	1	11
OG0005529	2	6	1	1	1	11
OG0005530	2	2	1	5	1	11
OG0005531	3	4	1	1	2	11
OG0005532	2	5	2	1	1	11
OG0005533	2	5	1	1	2	11
OG0005534	2	5	1	1	2	11
OG0005535	4	2	2	1	2	11
OG0005536	4	4	2	1	0	11
OG0005537	11	0	0	0	0	11
OG0005538	2	3	0	4	2	11
OG0005539	2	6	1	1	1	11
OG0005540	4	3	1	1	2	11
OG0005541	2	5	1	1	2	11
OG0005542	4	4	1	1	1	11
OG0005543	4	4	1	1	1	11
OG0005544	3	5	1	1	1	11
OG0005545	4	3	1	1	2	11
OG0005546	2	4	2	1	2	11
OG0005547	4	4	1	1	1	11
OG0005548	2	6	1	1	1	11
OG0005549	5	2	1	1	2	11
OG0005550	4	5	1	1	0	11
OG0005551	2	5	1	1	2	11
OG0005552	3	4	1	1	2	11
OG0005553	2	5	2	1	1	11
OG0005554	4	3	1	1	2	11
OG0005555	2	6	1	1	1	11
OG0005556	4	4	1	1	1	11
OG0005557	2	5	1	2	1	11
OG0005558	4	4	1	1	1	11
OG0005559	2	2	1	1	5	11
OG0005560	3	1	1	4	2	11
OG0005561	4	4	0	2	1	11
OG0005562	2	6	1	1	1	11
OG0005563	2	5	1	2	1	11
OG0005564	2	4	2	1	2	11
OG0005565	1	5	2	1	2	11
OG0005566	4	3	1	1	2	11
OG0005567	4	4	1	1	1	11
OG0005568	2	6	1	1	1	11
OG0005569	3	3	2	1	2	11
OG0005570	3	5	1	1	1	11
OG0005571	4	2	2	1	2	11
OG0005572	1	3	2	2	3	11
OG0005573	2	6	1	1	1	11
OG0005574	2	5	2	1	1	11
OG0005575	2	6	1	1	1	11
OG0005576	4	4	1	1	1	11
OG0005577	2	2	3	1	3	11
OG0005578	4	3	2	2	0	11
OG0005579	2	5	2	1	1	11
OG0005580	4	0	3	2	2	11
OG0005581	2	2	3	2	2	11
OG0005582	2	5	2	1	1	11
OG0005583	2	6	1	1	1	11
OG0005584	3	2	2	2	2	11
OG0005585	2	4	3	1	1	11
OG0005586	2	6	1	1	1	11
OG0005587	4	2	2	1	2	11
OG0005588	2	4	1	2	2	11
OG0005589	3	5	1	1	1	11
OG0005590	2	6	1	1	1	11
OG0005591	4	5	1	1	0	11
OG0005592	4	3	1	1	2	11
OG0005593	2	4	2	1	2	11
OG0005594	3	3	2	1	2	11
OG0005595	4	3	1	1	2	11
OG0005596	1	6	2	1	1	11
OG0005597	6	1	2	1	1	11
OG0005598	2	4	2	1	2	11
OG0005599	2	4	2	1	2	11
OG0005600	4	5	1	1	0	11
OG0005601	2	4	1	3	1	11
OG0005602	2	6	1	1	1	11
OG0005603	2	2	2	3	2	11
OG0005604	2	3	2	2	2	11
OG0005605	5	2	2	1	1	11
OG0005606	6	4	1	0	0	11
OG0005607	1	7	1	1	1	11
OG0005608	1	0	9	0	1	11
OG0005609	1	5	1	3	1	11
OG0005610	1	3	3	2	2	11
OG0005611	5	0	2	2	2	11
OG0005612	4	4	1	1	1	11
OG0005613	4	2	2	1	2	11
OG0005614	2	4	2	1	2	11
OG0005615	2	2	3	1	3	11
OG0005616	2	6	1	1	1	11
OG0005617	2	6	1	1	1	11
OG0005618	2	4	2	1	2	11
OG0005619	2	5	2	1	1	11
OG0005620	2	7	1	1	0	11
OG0005621	2	7	0	1	1	11
OG0005622	2	5	1	1	2	11
OG0005623	2	4	2	1	2	11
OG0005624	2	7	0	1	1	11
OG0005625	2	5	2	1	1	11
OG0005626	2	6	1	1	1	11
OG0005627	4	4	1	1	1	11
OG0005628	2	4	2	1	2	11
OG0005629	2	2	3	2	2	11
OG0005630	4	4	1	1	1	11
OG0005631	2	5	2	1	1	11
OG0005632	2	5	1	1	2	11
OG0005633	2	6	0	2	1	11
OG0005634	2	6	1	2	0	11
OG0005635	2	6	1	1	1	11
OG0005636	2	6	1	1	1	11
OG0005637	2	6	1	1	1	11
OG0005638	2	4	2	1	2	11
OG0005639	2	4	1	3	1	11
OG0005640	1	4	2	3	1	11
OG0005641	11	0	0	0	0	11
OG0005642	2	2	1	6	0	11
OG0005643	5	3	1	1	1	11
OG0005644	2	4	2	2	1	11
OG0005645	2	4	2	1	2	11
OG0005646	2	2	2	2	3	11
OG0005647	2	2	4	1	2	11
OG0005648	2	6	1	1	1	11
OG0005649	2	6	1	1	1	11
OG0005650	3	1	3	1	3	11
OG0005651	2	6	1	1	1	11
OG0005652	1	4	3	1	2	11
OG0005653	2	6	1	1	1	11
OG0005654	2	5	1	2	1	11
OG0005655	3	3	2	1	2	11
OG0005656	2	6	1	1	1	11
OG0005657	2	4	2	1	2	11
OG0005658	1	4	3	1	2	11
OG0005659	4	4	1	1	1	11
OG0005660	2	6	1	1	1	11
OG0005661	2	5	2	1	1	11
OG0005662	2	7	0	1	1	11
OG0005663	2	6	1	1	1	11
OG0005664	2	2	3	3	1	11
OG0005665	2	6	0	1	2	11
OG0005666	2	4	2	1	2	11
OG0005667	2	6	1	1	1	11
OG0005668	4	2	2	1	2	11
OG0005669	2	4	2	1	2	11
OG0005670	2	6	1	1	1	11
OG0005671	2	5	1	1	2	11
OG0005672	2	6	1	1	1	11
OG0005673	2	4	2	1	2	11
OG0005674	2	3	1	3	2	11
OG0005675	2	1	2	1	5	11
OG0005676	1	0	8	1	1	11
OG0005677	1	5	2	1	2	11
OG0005678	1	6	1	1	2	11
OG0005679	5	2	1	1	2	11
OG0005680	4	4	1	1	1	11
OG0005681	1	2	2	1	5	11
OG0005682	3	5	1	1	1	11
OG0005683	1	3	0	7	0	11
OG0005684	2	3	3	1	2	11
OG0005685	4	3	1	2	1	11
OG0005686	4	4	1	1	1	11
OG0005687	3	4	2	1	1	11
OG0005688	2	5	2	1	1	11
OG0005689	2	4	2	1	2	11
OG0005690	4	2	2	1	2	11
OG0005691	2	4	2	1	2	11
OG0005692	2	4	3	1	1	11
OG0005693	2	4	1	2	2	11
OG0005694	2	5	2	1	1	11
OG0005695	2	6	1	1	1	11
OG0005696	2	6	1	1	1	11
OG0005697	2	6	1	1	1	11
OG0005698	2	4	2	1	2	11
OG0005699	1	6	2	1	1	11
OG0005700	2	4	1	2	2	11
OG0005701	7	2	0	1	1	11
OG0005702	2	6	1	1	1	11
OG0005703	2	4	3	1	1	11
OG0005704	2	8	0	1	0	11
OG0005705	3	4	1	1	2	11
OG0005706	2	4	1	2	2	11
OG0005707	5	2	1	2	1	11
OG0005708	2	4	1	2	2	11
OG0005709	2	4	3	1	1	11
OG0005710	4	2	1	3	1	11
OG0005711	2	6	1	1	1	11
OG0005712	2	7	0	1	1	11
OG0005713	2	4	2	1	2	11
OG0005714	2	6	1	1	1	11
OG0005715	6	3	0	1	1	11
OG0005716	6	2	1	1	1	11
OG0005717	2	3	2	2	2	11
OG0005718	2	3	2	2	2	11
OG0005719	4	4	1	1	1	11
OG0005720	2	3	2	2	2	11
OG0005721	7	1	1	1	1	11
OG0005722	3	5	1	1	1	11
OG0005723	1	0	8	0	2	11
OG0005724	2	4	2	3	0	11
OG0005725	1	7	1	1	1	11
OG0005726	1	7	1	1	1	11
OG0005727	1	6	1	1	2	11
OG0005728	2	6	1	1	1	11
OG0005729	2	6	1	1	1	11
OG0005730	6	2	1	1	1	11
OG0005731	10	0	1	0	0	11
OG0005732	2	4	2	1	2	11
OG0005733	2	6	1	1	1	11
OG0005734	4	0	3	2	2	11
OG0005735	3	4	2	1	1	11
OG0005736	11	0	0	0	0	11
OG0005737	2	4	2	1	2	11
OG0005738	2	5	1	2	1	11
OG0005739	2	6	1	1	1	11
OG0005740	3	5	1	1	1	11
OG0005741	2	6	1	1	1	11
OG0005742	2	5	1	1	2	11
OG0005743	2	5	1	2	1	11
OG0005744	2	4	2	1	2	11
OG0005745	2	6	1	1	1	11
OG0005746	2	5	1	2	1	11
OG0005747	2	2	2	2	3	11
OG0005748	2	6	1	1	1	11
OG0005749	2	6	1	1	1	11
OG0005750	2	4	2	1	2	11
OG0005751	2	4	3	1	1	11
OG0005752	2	4	1	3	1	11
OG0005753	2	5	2	1	1	11
OG0005754	2	0	2	5	2	11
OG0005755	2	7	0	1	1	11
OG0005756	2	4	2	1	2	11
OG0005757	2	4	3	1	1	11
OG0005758	2	5	1	2	1	11
OG0005759	2	2	2	2	3	11
OG0005760	2	6	1	1	1	11
OG0005761	2	5	1	2	1	11
OG0005762	2	6	1	1	1	11
OG0005763	2	4	2	1	2	11
OG0005764	2	6	1	1	1	11
OG0005765	4	2	2	2	1	11
OG0005766	2	3	3	1	2	11
OG0005767	2	5	2	1	1	11
OG0005768	2	6	1	1	1	11
OG0005769	2	4	2	1	2	11
OG0005770	2	3	2	3	1	11
OG0005771	2	5	1	1	2	11
OG0005772	2	6	1	1	1	11
OG0005773	3	3	1	2	2	11
OG0005774	2	6	1	1	1	11
OG0005775	2	6	1	1	1	11
OG0005776	2	4	2	1	2	11
OG0005777	2	4	2	1	2	11
OG0005778	2	2	2	4	1	11
OG0005779	2	6	1	1	1	11
OG0005780	2	6	1	1	1	11
OG0005781	2	6	1	1	1	11
OG0005782	6	2	1	1	1	11
OG0005783	2	4	2	1	2	11
OG0005784	2	6	1	1	1	11
OG0005785	2	6	1	1	1	11
OG0005786	2	6	1	1	1	11
OG0005787	1	0	5	0	5	11
OG0005788	2	4	2	1	2	11
OG0005789	1	1	7	0	2	11
OG0005790	2	2	1	1	5	11
OG0005791	1	7	1	1	1	11
OG0005792	1	4	3	1	2	11
OG0005793	1	0	9	0	1	11
OG0005794	1	4	2	2	2	11
OG0005795	1	4	2	2	2	11
OG0005796	1	6	1	1	2	11
OG0005797	1	7	1	1	1	11
OG0005798	2	6	1	1	1	11
OG0005799	1	0	4	3	3	11
OG0005800	1	7	2	1	0	11
OG0005801	1	7	1	1	1	11
OG0005802	1	4	2	1	3	11
OG0005803	1	2	4	2	2	11
OG0005804	1	0	8	0	2	11
OG0005805	0	4	6	0	1	11
OG0005806	0	11	0	0	0	11
OG0005807	0	11	0	0	0	11
OG0005808	0	7	0	1	3	11
OG0005809	0	11	0	0	0	11
OG0005810	0	8	1	1	1	11
OG0005811	0	11	0	0	0	11
OG0005812	0	11	0	0	0	11
OG0005813	0	11	0	0	0	11
OG0005814	0	6	2	1	2	11
OG0005815	0	11	0	0	0	11
OG0005816	0	11	0	0	0	11
OG0005817	0	11	0	0	0	11
OG0005818	0	7	1	2	1	11
OG0005819	0	11	0	0	0	11
OG0005820	0	11	0	0	0	11
OG0005821	0	11	0	0	0	11
OG0005822	0	4	3	2	2	11
OG0005823	0	11	0	0	0	11
OG0005824	0	11	0	0	0	11
OG0005825	0	6	2	1	2	11
OG0005826	0	11	0	0	0	11
OG0005827	0	11	0	0	0	11
OG0005828	0	11	0	0	0	11
OG0005829	0	11	0	0	0	11
OG0005830	0	11	0	0	0	11
OG0005831	0	8	1	1	1	11
OG0005832	0	4	3	3	1	11
OG0005833	0	11	0	0	0	11
OG0005834	0	6	2	1	2	11
OG0005835	0	11	0	0	0	11
OG0005836	0	11	0	0	0	11
OG0005837	0	11	0	0	0	11
OG0005838	0	4	1	5	1	11
OG0005839	0	11	0	0	0	11
OG0005840	0	11	0	0	0	11
OG0005841	0	6	2	1	2	11
OG0005842	0	11	0	0	0	11
OG0005843	0	11	0	0	0	11
OG0005844	0	10	0	1	0	11
OG0005845	0	6	2	1	2	11
OG0005846	0	11	0	0	0	11
OG0005847	0	11	0	0	0	11
OG0005848	0	4	2	2	3	11
OG0005849	0	11	0	0	0	11
OG0005850	0	7	1	2	1	11
OG0005851	0	4	3	1	3	11
OG0005852	0	11	0	0	0	11
OG0005853	0	3	1	1	6	11
OG0005854	0	11	0	0	0	11
OG0005855	0	8	1	1	1	11
OG0005856	0	11	0	0	0	11
OG0005857	0	9	0	1	1	11
OG0005858	0	11	0	0	0	11
OG0005859	0	11	0	0	0	11
OG0005860	0	9	0	1	1	11
OG0005861	0	11	0	0	0	11
OG0005862	0	4	4	2	1	11
OG0005863	0	4	3	1	3	11
OG0005864	0	9	0	0	2	11
OG0005865	0	11	0	0	0	11
OG0005866	0	11	0	0	0	11
OG0005867	0	10	0	1	0	11
OG0005868	0	11	0	0	0	11
OG0005869	0	11	0	0	0	11
OG0005870	0	6	1	3	1	11
OG0005871	0	11	0	0	0	11
OG0005872	0	2	1	7	1	11
OG0005873	0	11	0	0	0	11
OG0005874	0	11	0	0	0	11
OG0005875	0	8	1	1	1	11
OG0005876	0	9	1	0	1	11
OG0005877	0	10	0	1	0	11
OG0005878	0	11	0	0	0	11
OG0005879	0	11	0	0	0	11
OG0005880	0	11	0	0	0	11
OG0005881	0	11	0	0	0	11
OG0005882	0	5	2	2	2	11
OG0005883	0	4	3	2	2	11
OG0005884	0	11	0	0	0	11
OG0005885	0	10	0	1	0	11
OG0005886	0	11	0	0	0	11
OG0005887	0	11	0	0	0	11
OG0005888	0	9	0	1	1	11
OG0005889	0	11	0	0	0	11
OG0005890	0	10	1	0	0	11
OG0005891	0	8	1	1	1	11
OG0005892	0	7	1	1	2	11
OG0005893	0	11	0	0	0	11
OG0005894	0	11	0	0	0	11
OG0005895	0	6	2	2	1	11
OG0005896	0	11	0	0	0	11
OG0005897	0	6	2	1	2	11
OG0005898	0	11	0	0	0	11
OG0005899	0	11	0	0	0	11
OG0005900	0	11	0	0	0	11
OG0005901	0	11	0	0	0	11
OG0005902	0	11	0	0	0	11
OG0005903	0	11	0	0	0	11
OG0005904	0	6	2	1	2	11
OG0005905	0	11	0	0	0	11
OG0005906	0	11	0	0	0	11
OG0005907	0	10	0	1	0	11
OG0005908	0	6	2	1	2	11
OG0005909	0	11	0	0	0	11
OG0005910	0	11	0	0	0	11
OG0005911	0	11	0	0	0	11
OG0005912	0	11	0	0	0	11
OG0005913	0	11	0	0	0	11
OG0005914	0	7	1	1	2	11
OG0005915	0	9	2	0	0	11
OG0005916	0	11	0	0	0	11
OG0005917	0	4	4	1	2	11
OG0005918	0	11	0	0	0	11
OG0005919	0	11	0	0	0	11
OG0005920	0	11	0	0	0	11
OG0005921	0	9	1	1	0	11
OG0005922	0	8	1	1	1	11
OG0005923	0	5	1	1	4	11
OG0005924	0	11	0	0	0	11
OG0005925	0	11	0	0	0	11
OG0005926	0	11	0	0	0	11
OG0005927	0	10	1	0	0	11
OG0005928	0	1	6	0	4	11
OG0005929	0	11	0	0	0	11
OG0005930	0	11	0	0	0	11
OG0005931	0	11	0	0	0	11
OG0005932	0	7	1	1	2	11
OG0005933	0	2	3	4	2	11
OG0005934	0	4	2	2	3	11
OG0005935	0	11	0	0	0	11
OG0005936	0	11	0	0	0	11
OG0005937	0	2	5	2	2	11
OG0005938	0	11	0	0	0	11
OG0005939	0	3	1	6	1	11
OG0005940	0	4	2	3	2	11
OG0005941	0	2	1	3	5	11
OG0005942	0	4	1	1	5	11
OG0005943	0	11	0	0	0	11
OG0005944	0	1	8	0	2	11
OG0005945	0	0	5	4	2	11
OG0005946	0	0	6	0	5	11
OG0005947	0	0	11	0	0	11
OG0005948	0	0	11	0	0	11
OG0005949	0	0	10	0	1	11
OG0005950	0	0	8	0	3	11
OG0005951	0	0	10	0	1	11
OG0005952	0	0	7	0	4	11
OG0005953	0	0	7	3	1	11
OG0005954	0	0	9	1	1	11
OG0005955	0	0	11	0	0	11
OG0005956	0	0	8	0	3	11
OG0005957	0	0	1	0	10	11
OG0005958	0	0	11	0	0	11
OG0005959	0	0	7	2	2	11
OG0005960	0	0	10	0	1	11
OG0005961	0	0	5	4	2	11
OG0005962	0	0	11	0	0	11
OG0005963	0	0	1	0	10	11
OG0005964	0	0	11	0	0	11
OG0005965	0	0	7	0	4	11
OG0005966	0	0	8	0	3	11
OG0005967	0	0	4	5	2	11
OG0005968	0	0	10	0	1	11
OG0005969	0	0	1	0	10	11
OG0005970	0	0	2	0	9	11
OG0005971	0	0	1	0	10	11
OG0005972	0	0	2	0	9	11
OG0005973	0	0	4	0	7	11
OG0005974	0	0	10	0	1	11
OG0005975	0	0	3	2	6	11
OG0005976	0	0	7	0	4	11
OG0005977	0	0	1	0	10	11
OG0005978	0	0	0	11	0	11
OG0005979	0	0	0	11	0	11
OG0005980	0	0	0	9	2	11
OG0005981	0	0	0	11	0	11
OG0005982	0	0	0	10	1	11
OG0005983	0	0	0	11	0	11
OG0005984	0	0	0	0	11	11
OG0005985	0	0	0	0	11	11
OG0005986	0	0	0	0	11	11
OG0005987	0	0	0	0	11	11
OG0005988	0	0	0	0	11	11
OG0005989	0	0	0	0	11	11
OG0005990	0	0	0	0	11	11
OG0005991	0	0	0	0	11	11
OG0005992	0	0	0	0	11	11
OG0005993	0	0	0	0	11	11
OG0005994	0	0	0	0	11	11
OG0005995	0	0	0	0	11	11
OG0005996	0	0	0	0	11	11
OG0005997	0	0	0	0	11	11
OG0005998	0	0	0	0	11	11
OG0005999	5	3	1	1	0	10
OG0006000	4	1	1	2	2	10
OG0006001	5	2	1	1	1	10
OG0006002	10	0	0	0	0	10
OG0006003	2	4	2	1	1	10
OG0006004	4	2	1	1	2	10
OG0006005	2	1	5	1	1	10
OG0006006	10	0	0	0	0	10
OG0006007	2	2	2	2	2	10
OG0006008	5	2	1	1	1	10
OG0006009	2	2	2	2	2	10
OG0006010	7	0	1	1	1	10
OG0006011	5	2	1	1	1	10
OG0006012	4	2	2	1	1	10
OG0006013	5	2	1	1	1	10
OG0006014	3	2	1	3	1	10
OG0006015	2	7	0	1	0	10
OG0006016	3	4	0	2	1	10
OG0006017	10	0	0	0	0	10
OG0006018	8	0	1	0	1	10
OG0006019	10	0	0	0	0	10
OG0006020	3	2	2	2	1	10
OG0006021	9	0	0	1	0	10
OG0006022	3	2	3	1	1	10
OG0006023	10	0	0	0	0	10
OG0006024	3	4	1	1	1	10
OG0006025	9	0	1	0	0	10
OG0006026	2	5	1	1	1	10
OG0006027	3	4	1	1	1	10
OG0006028	2	2	2	2	2	10
OG0006029	5	2	1	1	1	10
OG0006030	4	0	2	2	2	10
OG0006031	4	3	1	1	1	10
OG0006032	10	0	0	0	0	10
OG0006033	10	0	0	0	0	10
OG0006034	8	0	0	1	1	10
OG0006035	2	5	1	1	1	10
OG0006036	3	2	2	1	2	10
OG0006037	10	0	0	0	0	10
OG0006038	2	5	1	1	1	10
OG0006039	3	2	3	1	1	10
OG0006040	4	2	0	2	2	10
OG0006041	2	5	1	1	1	10
OG0006042	5	2	1	1	1	10
OG0006043	2	5	1	1	1	10
OG0006044	4	2	1	2	1	10
OG0006045	4	3	1	1	1	10
OG0006046	2	3	2	1	2	10
OG0006047	2	3	2	1	2	10
OG0006048	4	3	1	1	1	10
OG0006049	10	0	0	0	0	10
OG0006050	5	3	0	1	1	10
OG0006051	2	4	2	1	1	10
OG0006052	2	5	1	1	1	10
OG0006053	3	2	1	1	3	10
OG0006054	10	0	0	0	0	10
OG0006055	3	4	1	1	1	10
OG0006056	3	4	1	1	1	10
OG0006057	9	0	0	1	0	10
OG0006058	4	2	1	2	1	10
OG0006059	2	4	1	2	1	10
OG0006060	2	6	1	1	0	10
OG0006061	4	4	1	0	1	10
OG0006062	2	5	1	1	1	10
OG0006063	2	2	2	2	2	10
OG0006064	4	2	1	2	1	10
OG0006065	2	3	4	0	1	10
OG0006066	2	4	1	1	2	10
OG0006067	5	0	2	1	2	10
OG0006068	10	0	0	0	0	10
OG0006069	3	4	1	1	1	10
OG0006070	4	1	1	2	2	10
OG0006071	4	2	2	1	1	10
OG0006072	4	3	1	1	1	10
OG0006073	2	5	1	1	1	10
OG0006074	3	4	1	1	1	10
OG0006075	2	4	1	1	2	10
OG0006076	2	4	2	1	1	10
OG0006077	2	4	1	1	2	10
OG0006078	3	2	2	1	2	10
OG0006079	2	6	0	1	1	10
OG0006080	2	3	1	1	3	10
OG0006081	2	2	2	2	2	10
OG0006082	2	5	1	1	1	10
OG0006083	2	4	2	1	1	10
OG0006084	2	3	3	1	1	10
OG0006085	2	2	2	1	3	10
OG0006086	3	5	0	1	1	10
OG0006087	2	4	1	1	2	10
OG0006088	2	6	0	1	1	10
OG0006089	3	1	2	3	1	10
OG0006090	3	4	1	2	0	10
OG0006091	10	0	0	0	0	10
OG0006092	4	3	1	1	1	10
OG0006093	2	2	1	3	2	10
OG0006094	3	1	2	1	3	10
OG0006095	4	3	1	1	1	10
OG0006096	3	1	2	2	2	10
OG0006097	10	0	0	0	0	10
OG0006098	5	2	1	1	1	10
OG0006099	2	4	1	1	2	10
OG0006100	2	6	0	1	1	10
OG0006101	2	5	1	1	1	10
OG0006102	5	2	1	1	1	10
OG0006103	2	3	2	1	2	10
OG0006104	2	4	2	1	1	10
OG0006105	2	5	1	1	1	10
OG0006106	4	2	1	2	1	10
OG0006107	2	5	1	1	1	10
OG0006108	4	1	2	1	2	10
OG0006109	2	4	0	1	3	10
OG0006110	2	3	2	1	2	10
OG0006111	5	2	1	1	1	10
OG0006112	10	0	0	0	0	10
OG0006113	10	0	0	0	0	10
OG0006114	10	0	0	0	0	10
OG0006115	5	0	3	0	2	10
OG0006116	4	6	0	0	0	10
OG0006117	10	0	0	0	0	10
OG0006118	6	2	0	1	1	10
OG0006119	10	0	0	0	0	10
OG0006120	10	0	0	0	0	10
OG0006121	2	4	1	1	2	10
OG0006122	5	2	1	1	1	10
OG0006123	3	4	1	1	1	10
OG0006124	2	1	4	1	2	10
OG0006125	4	3	1	1	1	10
OG0006126	2	5	1	1	1	10
OG0006127	2	4	1	2	1	10
OG0006128	1	2	6	0	1	10
OG0006129	2	4	1	1	2	10
OG0006130	2	5	1	1	1	10
OG0006131	4	2	1	2	1	10
OG0006132	3	4	1	1	1	10
OG0006133	2	5	1	1	1	10
OG0006134	5	2	1	1	1	10
OG0006135	5	1	1	2	1	10
OG0006136	3	1	1	2	3	10
OG0006137	2	4	1	1	2	10
OG0006138	4	2	1	2	1	10
OG0006139	3	2	1	2	2	10
OG0006140	3	0	2	2	3	10
OG0006141	8	1	1	0	0	10
OG0006142	2	4	2	1	1	10
OG0006143	2	3	1	2	2	10
OG0006144	2	5	1	1	1	10
OG0006145	2	5	1	1	1	10
OG0006146	3	4	1	2	0	10
OG0006147	3	4	1	1	1	10
OG0006148	5	2	2	1	0	10
OG0006149	2	2	2	1	3	10
OG0006150	2	5	1	1	1	10
OG0006151	2	5	1	1	1	10
OG0006152	2	6	0	1	1	10
OG0006153	2	3	2	1	2	10
OG0006154	4	2	1	2	1	10
OG0006155	2	5	1	1	1	10
OG0006156	2	4	1	1	2	10
OG0006157	4	0	2	1	3	10
OG0006158	3	4	1	1	1	10
OG0006159	3	4	1	1	1	10
OG0006160	2	4	2	2	0	10
OG0006161	2	2	2	1	3	10
OG0006162	4	3	1	1	1	10
OG0006163	6	2	0	0	2	10
OG0006164	2	2	3	1	2	10
OG0006165	3	2	1	2	2	10
OG0006166	2	4	2	1	1	10
OG0006167	2	4	1	2	1	10
OG0006168	4	3	1	1	1	10
OG0006169	3	4	1	1	1	10
OG0006170	2	5	1	1	1	10
OG0006171	4	2	1	1	2	10
OG0006172	4	4	0	1	1	10
OG0006173	3	4	1	1	1	10
OG0006174	2	4	1	1	2	10
OG0006175	4	1	1	2	2	10
OG0006176	10	0	0	0	0	10
OG0006177	2	3	2	1	2	10
OG0006178	2	5	1	1	1	10
OG0006179	2	4	1	1	2	10
OG0006180	10	0	0	0	0	10
OG0006181	2	2	3	1	2	10
OG0006182	1	4	2	1	2	10
OG0006183	10	0	0	0	0	10
OG0006184	7	2	0	1	0	10
OG0006185	2	6	0	1	1	10
OG0006186	2	4	1	1	2	10
OG0006187	2	5	0	1	2	10
OG0006188	4	0	1	4	1	10
OG0006189	4	3	1	1	1	10
OG0006190	2	4	1	2	1	10
OG0006191	4	3	1	1	1	10
OG0006192	2	3	2	2	1	10
OG0006193	4	1	1	2	2	10
OG0006194	2	4	2	1	1	10
OG0006195	3	4	1	1	1	10
OG0006196	2	4	1	1	2	10
OG0006197	2	5	2	1	0	10
OG0006198	3	5	0	1	1	10
OG0006199	2	4	1	2	1	10
OG0006200	2	2	3	1	2	10
OG0006201	6	2	1	1	0	10
OG0006202	10	0	0	0	0	10
OG0006203	3	2	2	1	2	10
OG0006204	2	4	1	1	2	10
OG0006205	3	4	1	1	1	10
OG0006206	2	4	2	1	1	10
OG0006207	2	2	3	1	2	10
OG0006208	2	4	1	2	1	10
OG0006209	4	3	1	1	1	10
OG0006210	4	3	1	1	1	10
OG0006211	2	5	1	1	1	10
OG0006212	3	0	2	2	3	10
OG0006213	4	2	2	1	1	10
OG0006214	4	0	2	1	3	10
OG0006215	2	5	1	1	1	10
OG0006216	9	1	0	0	0	10
OG0006217	2	4	1	1	2	10
OG0006218	2	4	2	1	1	10
OG0006219	2	1	2	3	2	10
OG0006220	2	2	1	1	4	10
OG0006221	2	5	1	1	1	10
OG0006222	2	4	1	1	2	10
OG0006223	5	0	2	1	2	10
OG0006224	10	0	0	0	0	10
OG0006225	2	2	2	1	3	10
OG0006226	2	4	0	3	1	10
OG0006227	3	4	1	1	1	10
OG0006228	2	5	1	1	1	10
OG0006229	2	2	3	1	2	10
OG0006230	2	5	1	1	1	10
OG0006231	4	1	1	1	3	10
OG0006232	2	5	1	1	1	10
OG0006233	2	4	2	1	1	10
OG0006234	2	5	1	1	1	10
OG0006235	2	3	2	1	2	10
OG0006236	2	4	1	1	2	10
OG0006237	3	4	1	1	1	10
OG0006238	2	5	1	1	1	10
OG0006239	4	2	1	1	2	10
OG0006240	2	5	1	1	1	10
OG0006241	3	4	1	1	1	10
OG0006242	2	2	2	2	2	10
OG0006243	4	0	2	2	2	10
OG0006244	2	5	1	1	1	10
OG0006245	2	1	4	1	2	10
OG0006246	2	3	2	1	2	10
OG0006247	10	0	0	0	0	10
OG0006248	2	2	3	2	1	10
OG0006249	2	3	2	1	2	10
OG0006250	2	1	2	3	2	10
OG0006251	4	3	1	1	1	10
OG0006252	4	4	0	1	1	10
OG0006253	2	1	3	2	2	10
OG0006254	2	3	1	2	2	10
OG0006255	4	3	1	1	1	10
OG0006256	3	0	2	2	3	10
OG0006257	3	4	1	1	1	10
OG0006258	5	2	1	1	1	10
OG0006259	6	3	0	1	0	10
OG0006260	3	4	1	1	1	10
OG0006261	2	4	1	2	1	10
OG0006262	4	0	2	2	2	10
OG0006263	5	2	1	1	1	10
OG0006264	3	1	3	1	2	10
OG0006265	9	1	0	0	0	10
OG0006266	4	3	1	1	1	10
OG0006267	3	4	1	1	1	10
OG0006268	2	3	1	2	2	10
OG0006269	3	1	3	1	2	10
OG0006270	3	4	1	1	1	10
OG0006271	1	5	2	1	1	10
OG0006272	4	0	2	2	2	10
OG0006273	3	0	1	6	0	10
OG0006274	3	4	1	1	1	10
OG0006275	3	4	1	1	1	10
OG0006276	2	2	1	1	4	10
OG0006277	5	2	1	1	1	10
OG0006278	2	7	0	1	0	10
OG0006279	3	4	1	1	1	10
OG0006280	10	0	0	0	0	10
OG0006281	5	2	1	1	1	10
OG0006282	4	2	1	1	2	10
OG0006283	2	4	1	1	2	10
OG0006284	10	0	0	0	0	10
OG0006285	2	4	2	1	1	10
OG0006286	4	2	1	1	2	10
OG0006287	3	4	1	1	1	10
OG0006288	3	4	1	1	1	10
OG0006289	2	5	1	1	1	10
OG0006290	4	0	3	1	2	10
OG0006291	5	2	0	2	1	10
OG0006292	3	0	4	1	2	10
OG0006293	3	4	1	1	1	10
OG0006294	2	2	4	1	1	10
OG0006295	2	5	1	1	1	10
OG0006296	2	5	1	1	1	10
OG0006297	2	4	2	1	1	10
OG0006298	4	2	2	1	1	10
OG0006299	4	2	1	2	1	10
OG0006300	3	3	1	1	2	10
OG0006301	4	4	0	1	1	10
OG0006302	2	4	2	1	1	10
OG0006303	2	5	1	1	1	10
OG0006304	10	0	0	0	0	10
OG0006305	6	1	3	0	0	10
OG0006306	4	2	2	1	1	10
OG0006307	3	4	1	1	1	10
OG0006308	4	0	2	1	3	10
OG0006309	3	4	1	1	1	10
OG0006310	2	5	1	1	1	10
OG0006311	2	4	1	2	1	10
OG0006312	1	4	1	1	3	10
OG0006313	2	5	1	1	1	10
OG0006314	4	3	1	1	1	10
OG0006315	3	4	1	1	1	10
OG0006316	4	2	1	1	2	10
OG0006317	3	2	2	2	1	10
OG0006318	2	4	2	1	1	10
OG0006319	2	3	2	1	2	10
OG0006320	4	3	1	1	1	10
OG0006321	2	4	1	2	1	10
OG0006322	5	2	1	1	1	10
OG0006323	2	3	2	1	2	10
OG0006324	4	1	1	2	2	10
OG0006325	2	4	2	1	1	10
OG0006326	3	2	1	3	1	10
OG0006327	5	2	0	2	1	10
OG0006328	2	5	1	1	1	10
OG0006329	5	2	1	1	1	10
OG0006330	4	1	2	1	2	10
OG0006331	4	1	2	1	2	10
OG0006332	1	2	2	3	2	10
OG0006333	6	2	1	0	1	10
OG0006334	2	5	1	1	1	10
OG0006335	2	4	2	1	1	10
OG0006336	5	2	1	1	1	10
OG0006337	4	2	2	1	1	10
OG0006338	10	0	0	0	0	10
OG0006339	1	4	2	1	2	10
OG0006340	4	5	0	1	0	10
OG0006341	2	4	1	2	1	10
OG0006342	3	0	2	2	3	10
OG0006343	5	2	1	1	1	10
OG0006344	3	4	1	2	0	10
OG0006345	4	3	1	1	1	10
OG0006346	2	4	2	1	1	10
OG0006347	4	2	1	1	2	10
OG0006348	2	2	1	4	1	10
OG0006349	3	4	1	1	1	10
OG0006350	3	0	2	3	2	10
OG0006351	2	3	1	1	3	10
OG0006352	2	3	1	2	2	10
OG0006353	2	2	2	3	1	10
OG0006354	4	2	1	1	2	10
OG0006355	1	6	1	1	1	10
OG0006356	1	3	1	4	1	10
OG0006357	2	4	2	1	1	10
OG0006358	4	2	1	2	1	10
OG0006359	5	2	1	1	1	10
OG0006360	2	5	1	1	1	10
OG0006361	2	4	1	1	2	10
OG0006362	2	4	1	1	2	10
OG0006363	2	4	2	1	1	10
OG0006364	2	4	1	1	2	10
OG0006365	2	5	1	1	1	10
OG0006366	2	5	1	1	1	10
OG0006367	2	2	3	2	1	10
OG0006368	2	4	1	2	1	10
OG0006369	2	2	3	1	2	10
OG0006370	2	3	2	1	2	10
OG0006371	2	4	1	2	1	10
OG0006372	3	2	1	2	2	10
OG0006373	1	6	1	2	0	10
OG0006374	4	3	1	1	1	10
OG0006375	3	4	1	1	1	10
OG0006376	2	4	1	2	1	10
OG0006377	4	3	1	1	1	10
OG0006378	2	3	1	2	2	10
OG0006379	2	2	1	4	1	10
OG0006380	10	0	0	0	0	10
OG0006381	2	3	2	1	2	10
OG0006382	2	4	2	1	1	10
OG0006383	2	2	2	2	2	10
OG0006384	2	3	3	1	1	10
OG0006385	2	4	1	1	2	10
OG0006386	2	4	1	2	1	10
OG0006387	3	3	1	1	2	10
OG0006388	2	5	1	1	1	10
OG0006389	2	2	2	1	3	10
OG0006390	2	5	1	1	1	10
OG0006391	2	5	1	1	1	10
OG0006392	6	2	1	1	0	10
OG0006393	4	4	0	1	1	10
OG0006394	5	2	1	1	1	10
OG0006395	2	5	1	1	1	10
OG0006396	2	4	1	1	2	10
OG0006397	3	2	1	2	2	10
OG0006398	2	5	0	2	1	10
OG0006399	2	3	3	1	1	10
OG0006400	2	4	1	1	2	10
OG0006401	2	4	1	2	1	10
OG0006402	5	0	2	1	2	10
OG0006403	2	4	2	1	1	10
OG0006404	2	3	5	0	0	10
OG0006405	10	0	0	0	0	10
OG0006406	2	3	1	3	1	10
OG0006407	2	4	1	1	2	10
OG0006408	2	5	1	1	1	10
OG0006409	2	2	1	2	3	10
OG0006410	2	5	1	1	1	10
OG0006411	2	4	2	1	1	10
OG0006412	4	2	2	1	1	10
OG0006413	2	6	0	1	1	10
OG0006414	5	2	1	1	1	10
OG0006415	3	3	1	1	2	10
OG0006416	2	3	1	2	2	10
OG0006417	2	5	1	1	1	10
OG0006418	2	5	1	1	1	10
OG0006419	3	4	1	1	1	10
OG0006420	2	1	3	2	2	10
OG0006421	2	5	1	1	1	10
OG0006422	2	3	2	1	2	10
OG0006423	4	3	0	1	2	10
OG0006424	2	2	1	1	4	10
OG0006425	2	3	1	2	2	10
OG0006426	2	7	0	1	0	10
OG0006427	2	6	0	1	1	10
OG0006428	2	4	1	2	1	10
OG0006429	3	4	1	1	1	10
OG0006430	2	5	0	2	1	10
OG0006431	2	5	1	1	1	10
OG0006432	2	5	1	1	1	10
OG0006433	10	0	0	0	0	10
OG0006434	2	4	0	2	2	10
OG0006435	2	0	3	2	3	10
OG0006436	3	4	1	1	1	10
OG0006437	3	4	1	1	1	10
OG0006438	2	4	0	1	3	10
OG0006439	2	4	1	2	1	10
OG0006440	3	3	1	2	1	10
OG0006441	4	2	2	1	1	10
OG0006442	4	0	3	2	1	10
OG0006443	3	0	1	5	1	10
OG0006444	4	4	0	1	1	10
OG0006445	3	3	1	1	2	10
OG0006446	6	1	1	1	1	10
OG0006447	10	0	0	0	0	10
OG0006448	3	6	0	1	0	10
OG0006449	4	2	1	1	2	10
OG0006450	3	3	0	3	1	10
OG0006451	5	0	0	5	0	10
OG0006452	2	4	1	1	2	10
OG0006453	2	2	2	2	2	10
OG0006454	1	6	1	1	1	10
OG0006455	3	0	2	3	2	10
OG0006456	2	4	1	2	1	10
OG0006457	2	4	1	1	2	10
OG0006458	4	3	1	1	1	10
OG0006459	2	4	2	1	1	10
OG0006460	2	0	4	1	3	10
OG0006461	4	0	2	1	3	10
OG0006462	3	4	1	1	1	10
OG0006463	2	5	1	1	1	10
OG0006464	7	0	1	2	0	10
OG0006465	4	2	1	2	1	10
OG0006466	2	5	1	1	1	10
OG0006467	4	2	1	1	2	10
OG0006468	2	5	1	1	1	10
OG0006469	4	3	1	1	1	10
OG0006470	2	4	2	1	1	10
OG0006471	2	4	1	2	1	10
OG0006472	4	3	1	1	1	10
OG0006473	4	2	1	1	2	10
OG0006474	2	2	0	6	0	10
OG0006475	3	4	1	1	1	10
OG0006476	4	3	1	1	1	10
OG0006477	2	4	1	1	2	10
OG0006478	2	4	1	1	2	10
OG0006479	4	2	2	1	1	10
OG0006480	2	5	1	1	1	10
OG0006481	3	1	2	1	3	10
OG0006482	3	4	1	1	1	10
OG0006483	2	4	2	2	0	10
OG0006484	2	2	1	2	3	10
OG0006485	2	3	3	1	1	10
OG0006486	2	4	1	1	2	10
OG0006487	3	5	0	1	1	10
OG0006488	3	3	1	1	2	10
OG0006489	3	2	2	1	2	10
OG0006490	4	3	1	1	1	10
OG0006491	4	1	2	1	2	10
OG0006492	2	5	1	1	1	10
OG0006493	2	4	1	1	2	10
OG0006494	2	4	2	1	1	10
OG0006495	3	2	3	1	1	10
OG0006496	4	3	1	1	1	10
OG0006497	4	3	1	1	1	10
OG0006498	2	6	0	1	1	10
OG0006499	4	2	1	1	2	10
OG0006500	4	2	2	0	2	10
OG0006501	2	0	3	2	3	10
OG0006502	1	6	1	1	1	10
OG0006503	4	0	2	2	2	10
OG0006504	2	5	1	1	1	10
OG0006505	3	3	1	2	1	10
OG0006506	3	3	2	1	1	10
OG0006507	2	5	1	1	1	10
OG0006508	3	4	1	1	1	10
OG0006509	2	6	0	1	1	10
OG0006510	5	2	2	1	0	10
OG0006511	2	5	0	2	1	10
OG0006512	2	4	2	1	1	10
OG0006513	4	2	1	2	1	10
OG0006514	2	4	2	1	1	10
OG0006515	2	3	1	2	2	10
OG0006516	2	4	1	2	1	10
OG0006517	3	4	1	1	1	10
OG0006518	2	5	1	1	1	10
OG0006519	4	2	0	3	1	10
OG0006520	2	4	2	1	1	10
OG0006521	4	2	1	1	2	10
OG0006522	2	5	1	1	1	10
OG0006523	4	1	2	1	2	10
OG0006524	2	4	1	1	2	10
OG0006525	2	5	1	1	1	10
OG0006526	2	5	1	1	1	10
OG0006527	4	2	2	1	1	10
OG0006528	5	2	1	1	1	10
OG0006529	2	4	1	2	1	10
OG0006530	3	1	3	1	2	10
OG0006531	4	3	1	1	1	10
OG0006532	4	1	2	1	2	10
OG0006533	2	2	2	1	3	10
OG0006534	3	2	3	1	1	10
OG0006535	2	5	1	1	1	10
OG0006536	2	2	3	1	2	10
OG0006537	2	5	1	1	1	10
OG0006538	2	2	2	2	2	10
OG0006539	2	3	2	1	2	10
OG0006540	3	4	1	1	1	10
OG0006541	6	2	0	1	1	10
OG0006542	4	0	3	1	2	10
OG0006543	4	2	2	1	1	10
OG0006544	2	5	1	1	1	10
OG0006545	10	0	0	0	0	10
OG0006546	2	4	0	3	1	10
OG0006547	3	4	1	1	1	10
OG0006548	2	4	2	1	1	10
OG0006549	2	2	2	2	2	10
OG0006550	2	1	2	3	2	10
OG0006551	2	3	2	1	2	10
OG0006552	2	3	2	1	2	10
OG0006553	2	4	1	2	1	10
OG0006554	1	0	3	3	3	10
OG0006555	5	2	1	1	1	10
OG0006556	4	2	2	1	1	10
OG0006557	5	1	2	1	1	10
OG0006558	2	3	2	1	2	10
OG0006559	2	5	0	1	2	10
OG0006560	2	5	1	1	1	10
OG0006561	2	5	1	1	1	10
OG0006562	4	2	2	1	1	10
OG0006563	4	3	1	1	1	10
OG0006564	2	4	2	1	1	10
OG0006565	4	3	1	1	1	10
OG0006566	2	4	1	2	1	10
OG0006567	2	4	1	2	1	10
OG0006568	4	2	0	3	1	10
OG0006569	2	5	1	1	1	10
OG0006570	3	5	1	1	0	10
OG0006571	2	3	2	2	1	10
OG0006572	2	5	1	1	1	10
OG0006573	10	0	0	0	0	10
OG0006574	5	2	1	1	1	10
OG0006575	2	4	1	2	1	10
OG0006576	2	3	2	1	2	10
OG0006577	2	2	1	4	1	10
OG0006578	1	6	2	1	0	10
OG0006579	3	4	1	1	1	10
OG0006580	2	5	1	1	1	10
OG0006581	2	4	1	1	2	10
OG0006582	4	2	2	1	1	10
OG0006583	2	4	1	1	2	10
OG0006584	2	5	1	1	1	10
OG0006585	2	3	1	2	2	10
OG0006586	3	4	1	1	1	10
OG0006587	5	2	1	1	1	10
OG0006588	5	2	1	1	1	10
OG0006589	4	3	1	1	1	10
OG0006590	4	1	1	3	1	10
OG0006591	4	0	1	3	2	10
OG0006592	2	4	1	1	2	10
OG0006593	3	4	0	1	2	10
OG0006594	2	2	3	1	2	10
OG0006595	4	3	1	1	1	10
OG0006596	2	4	1	2	1	10
OG0006597	2	4	1	1	2	10
OG0006598	2	4	2	1	1	10
OG0006599	4	3	1	1	1	10
OG0006600	2	5	1	1	1	10
OG0006601	2	3	3	2	0	10
OG0006602	3	2	1	2	2	10
OG0006603	1	4	2	1	2	10
OG0006604	2	5	1	1	1	10
OG0006605	2	4	1	2	1	10
OG0006606	2	3	2	2	1	10
OG0006607	2	4	1	1	2	10
OG0006608	2	5	0	1	2	10
OG0006609	2	5	1	1	1	10
OG0006610	2	3	2	1	2	10
OG0006611	10	0	0	0	0	10
OG0006612	2	6	0	1	1	10
OG0006613	4	3	1	1	1	10
OG0006614	2	2	3	1	2	10
OG0006615	2	5	1	1	1	10
OG0006616	4	3	1	1	1	10
OG0006617	3	4	1	1	1	10
OG0006618	2	4	1	1	2	10
OG0006619	2	3	2	1	2	10
OG0006620	4	2	1	2	1	10
OG0006621	1	4	1	2	2	10
OG0006622	1	5	2	1	1	10
OG0006623	2	4	1	2	1	10
OG0006624	2	2	2	2	2	10
OG0006625	2	4	2	1	1	10
OG0006626	4	1	3	1	1	10
OG0006627	10	0	0	0	0	10
OG0006628	1	4	1	2	2	10
OG0006629	2	5	1	1	1	10
OG0006630	2	6	0	1	1	10
OG0006631	4	2	1	2	1	10
OG0006632	4	3	1	1	1	10
OG0006633	3	4	1	1	1	10
OG0006634	5	2	1	1	1	10
OG0006635	2	5	1	1	1	10
OG0006636	4	1	2	1	2	10
OG0006637	3	2	3	1	1	10
OG0006638	2	4	1	2	1	10
OG0006639	2	5	1	1	1	10
OG0006640	2	7	0	1	0	10
OG0006641	2	4	1	1	2	10
OG0006642	4	3	1	1	1	10
OG0006643	4	3	1	1	1	10
OG0006644	4	1	2	2	1	10
OG0006645	2	5	1	1	1	10
OG0006646	2	4	1	2	1	10
OG0006647	2	6	0	1	1	10
OG0006648	2	5	1	1	1	10
OG0006649	2	4	1	2	1	10
OG0006650	3	2	2	1	2	10
OG0006651	2	3	2	1	2	10
OG0006652	2	0	4	2	2	10
OG0006653	2	2	3	1	2	10
OG0006654	4	3	1	1	1	10
OG0006655	2	4	0	2	2	10
OG0006656	2	5	1	1	1	10
OG0006657	3	4	0	1	2	10
OG0006658	3	4	1	1	1	10
OG0006659	2	5	1	1	1	10
OG0006660	4	0	2	2	2	10
OG0006661	2	3	3	1	1	10
OG0006662	2	6	0	1	1	10
OG0006663	2	2	0	5	1	10
OG0006664	4	4	1	1	0	10
OG0006665	4	1	2	1	2	10
OG0006666	10	0	0	0	0	10
OG0006667	3	4	1	1	1	10
OG0006668	4	2	2	1	1	10
OG0006669	3	4	1	1	1	10
OG0006670	2	5	1	1	1	10
OG0006671	2	2	3	1	2	10
OG0006672	2	5	1	1	1	10
OG0006673	2	3	2	2	1	10
OG0006674	2	5	1	1	1	10
OG0006675	2	6	0	1	1	10
OG0006676	10	0	0	0	0	10
OG0006677	2	4	1	2	1	10
OG0006678	4	2	2	1	1	10
OG0006679	2	4	1	1	2	10
OG0006680	2	6	0	2	0	10
OG0006681	4	2	1	1	2	10
OG0006682	3	2	3	1	1	10
OG0006683	2	3	2	1	2	10
OG0006684	2	5	1	1	1	10
OG0006685	2	5	1	1	1	10
OG0006686	7	0	0	2	1	10
OG0006687	4	4	0	1	1	10
OG0006688	2	4	2	1	1	10
OG0006689	4	2	1	1	2	10
OG0006690	3	3	2	1	1	10
OG0006691	4	0	2	1	3	10
OG0006692	2	5	1	1	1	10
OG0006693	2	4	2	1	1	10
OG0006694	2	3	3	1	1	10
OG0006695	3	4	1	1	1	10
OG0006696	2	4	1	2	1	10
OG0006697	2	3	2	1	2	10
OG0006698	3	2	2	1	2	10
OG0006699	3	4	1	1	1	10
OG0006700	2	6	0	1	1	10
OG0006701	2	5	1	1	1	10
OG0006702	2	5	1	1	1	10
OG0006703	2	5	1	1	1	10
OG0006704	4	0	3	1	2	10
OG0006705	2	1	7	0	0	10
OG0006706	2	5	1	2	0	10
OG0006707	1	6	1	1	1	10
OG0006708	2	3	1	3	1	10
OG0006709	4	2	1	1	2	10
OG0006710	3	0	4	1	2	10
OG0006711	4	3	1	1	1	10
OG0006712	4	4	1	1	0	10
OG0006713	4	3	1	1	1	10
OG0006714	3	4	1	1	1	10
OG0006715	2	2	2	2	2	10
OG0006716	3	2	1	2	2	10
OG0006717	2	5	1	1	1	10
OG0006718	3	3	1	1	2	10
OG0006719	2	3	2	1	2	10
OG0006720	3	2	2	1	2	10
OG0006721	2	2	2	2	2	10
OG0006722	2	2	2	2	2	10
OG0006723	4	0	2	1	3	10
OG0006724	2	4	1	1	2	10
OG0006725	1	7	0	1	1	10
OG0006726	2	2	2	2	2	10
OG0006727	2	4	2	1	1	10
OG0006728	2	4	2	1	1	10
OG0006729	2	5	1	1	1	10
OG0006730	2	6	0	1	1	10
OG0006731	2	3	2	1	2	10
OG0006732	2	4	2	1	1	10
OG0006733	2	2	2	2	2	10
OG0006734	1	2	1	2	4	10
OG0006735	2	3	2	1	2	10
OG0006736	4	2	2	1	1	10
OG0006737	2	5	1	1	1	10
OG0006738	2	4	1	1	2	10
OG0006739	2	3	2	1	2	10
OG0006740	3	2	3	1	1	10
OG0006741	4	2	1	1	2	10
OG0006742	2	2	2	2	2	10
OG0006743	2	2	2	2	2	10
OG0006744	2	3	2	1	2	10
OG0006745	4	3	0	2	1	10
OG0006746	2	5	1	1	1	10
OG0006747	2	4	0	2	2	10
OG0006748	3	3	1	1	2	10
OG0006749	4	3	1	1	1	10
OG0006750	3	4	1	0	2	10
OG0006751	2	4	1	1	2	10
OG0006752	4	1	2	1	2	10
OG0006753	4	4	0	1	1	10
OG0006754	3	2	2	2	1	10
OG0006755	2	3	1	1	3	10
OG0006756	2	2	3	1	2	10
OG0006757	3	3	2	1	1	10
OG0006758	2	4	1	1	2	10
OG0006759	3	2	2	1	2	10
OG0006760	2	5	1	1	1	10
OG0006761	5	2	1	1	1	10
OG0006762	5	2	1	1	1	10
OG0006763	2	3	2	1	2	10
OG0006764	2	5	1	1	1	10
OG0006765	2	4	1	2	1	10
OG0006766	3	3	2	1	1	10
OG0006767	2	5	1	1	1	10
OG0006768	3	2	3	1	1	10
OG0006769	2	5	1	1	1	10
OG0006770	4	2	1	2	1	10
OG0006771	2	4	1	1	2	10
OG0006772	3	2	2	1	2	10
OG0006773	2	4	1	2	1	10
OG0006774	2	5	1	1	1	10
OG0006775	2	4	1	2	1	10
OG0006776	2	3	3	1	1	10
OG0006777	3	4	1	1	1	10
OG0006778	2	2	1	4	1	10
OG0006779	3	2	3	1	1	10
OG0006780	2	2	2	1	3	10
OG0006781	3	2	1	2	2	10
OG0006782	2	2	2	2	2	10
OG0006783	2	5	1	1	1	10
OG0006784	5	2	1	1	1	10
OG0006785	5	2	1	1	1	10
OG0006786	3	2	2	1	2	10
OG0006787	2	3	2	1	2	10
OG0006788	2	5	1	1	1	10
OG0006789	2	2	2	2	2	10
OG0006790	6	0	2	1	1	10
OG0006791	2	2	2	2	2	10
OG0006792	2	5	1	1	1	10
OG0006793	4	3	1	1	1	10
OG0006794	1	1	2	1	5	10
OG0006795	3	3	1	1	2	10
OG0006796	2	5	1	1	1	10
OG0006797	2	5	1	1	1	10
OG0006798	2	4	1	2	1	10
OG0006799	2	4	1	2	1	10
OG0006800	2	5	1	1	1	10
OG0006801	2	5	1	1	1	10
OG0006802	3	4	1	1	1	10
OG0006803	2	5	1	1	1	10
OG0006804	1	4	1	1	3	10
OG0006805	2	5	1	1	1	10
OG0006806	2	5	1	1	1	10
OG0006807	2	6	1	1	0	10
OG0006808	2	3	2	1	2	10
OG0006809	2	4	2	1	1	10
OG0006810	1	2	3	2	2	10
OG0006811	3	4	1	1	1	10
OG0006812	1	5	1	1	2	10
OG0006813	4	3	1	1	1	10
OG0006814	1	3	3	1	2	10
OG0006815	2	5	1	1	1	10
OG0006816	1	6	1	1	1	10
OG0006817	5	2	1	1	1	10
OG0006818	2	5	1	1	1	10
OG0006819	2	6	1	1	0	10
OG0006820	1	4	2	1	2	10
OG0006821	2	4	2	1	1	10
OG0006822	2	2	1	4	1	10
OG0006823	4	2	2	1	1	10
OG0006824	5	2	1	1	1	10
OG0006825	2	5	1	1	1	10
OG0006826	2	5	0	2	1	10
OG0006827	4	0	2	2	2	10
OG0006828	2	4	1	1	2	10
OG0006829	2	3	0	3	2	10
OG0006830	2	2	2	2	2	10
OG0006831	5	2	1	1	1	10
OG0006832	2	4	2	1	1	10
OG0006833	2	4	1	2	1	10
OG0006834	2	3	2	1	2	10
OG0006835	2	2	2	2	2	10
OG0006836	2	3	1	3	1	10
OG0006837	4	2	1	1	2	10
OG0006838	2	5	1	1	1	10
OG0006839	3	4	1	1	1	10
OG0006840	2	4	1	2	1	10
OG0006841	2	4	1	2	1	10
OG0006842	3	4	1	1	1	10
OG0006843	2	4	1	1	2	10
OG0006844	2	3	2	1	2	10
OG0006845	2	5	1	1	1	10
OG0006846	2	5	1	1	1	10
OG0006847	3	4	1	1	1	10
OG0006848	3	4	1	1	1	10
OG0006849	1	4	2	2	1	10
OG0006850	2	5	1	1	1	10
OG0006851	2	5	1	1	1	10
OG0006852	2	2	2	1	3	10
OG0006853	2	5	1	1	1	10
OG0006854	4	4	1	1	0	10
OG0006855	2	1	3	1	3	10
OG0006856	2	5	1	1	1	10
OG0006857	2	4	2	1	1	10
OG0006858	2	4	1	2	1	10
OG0006859	5	2	1	1	1	10
OG0006860	2	4	1	2	1	10
OG0006861	2	4	1	1	2	10
OG0006862	3	4	1	1	1	10
OG0006863	2	3	2	1	2	10
OG0006864	2	4	2	1	1	10
OG0006865	2	5	1	1	1	10
OG0006866	2	4	2	1	1	10
OG0006867	2	3	1	2	2	10
OG0006868	2	5	1	1	1	10
OG0006869	2	3	2	1	2	10
OG0006870	2	4	2	1	1	10
OG0006871	2	5	1	1	1	10
OG0006872	2	3	2	1	2	10
OG0006873	2	5	1	1	1	10
OG0006874	2	5	1	1	1	10
OG0006875	2	5	1	1	1	10
OG0006876	2	7	0	1	0	10
OG0006877	4	2	2	1	1	10
OG0006878	2	0	4	1	3	10
OG0006879	2	4	1	1	2	10
OG0006880	2	4	2	1	1	10
OG0006881	2	4	1	1	2	10
OG0006882	2	2	2	2	2	10
OG0006883	2	2	3	2	1	10
OG0006884	3	4	1	1	1	10
OG0006885	2	5	1	1	1	10
OG0006886	4	2	2	1	1	10
OG0006887	2	7	0	1	0	10
OG0006888	2	2	1	2	3	10
OG0006889	2	4	1	1	2	10
OG0006890	2	3	1	3	1	10
OG0006891	2	3	1	2	2	10
OG0006892	4	3	1	1	1	10
OG0006893	2	5	1	1	1	10
OG0006894	8	0	0	2	0	10
OG0006895	1	4	2	2	1	10
OG0006896	2	5	1	1	1	10
OG0006897	4	3	1	1	1	10
OG0006898	2	3	2	1	2	10
OG0006899	2	4	2	1	1	10
OG0006900	2	0	3	2	3	10
OG0006901	2	5	1	1	1	10
OG0006902	2	4	1	3	0	10
OG0006903	4	1	2	1	2	10
OG0006904	3	4	1	1	1	10
OG0006905	2	5	1	1	1	10
OG0006906	2	5	1	1	1	10
OG0006907	2	5	1	1	1	10
OG0006908	2	3	1	1	3	10
OG0006909	4	3	1	1	1	10
OG0006910	1	3	2	2	2	10
OG0006911	2	4	2	1	1	10
OG0006912	1	0	0	9	0	10
OG0006913	2	4	2	1	1	10
OG0006914	2	6	0	1	1	10
OG0006915	1	7	0	1	1	10
OG0006916	2	4	1	1	2	10
OG0006917	3	2	2	1	2	10
OG0006918	2	2	2	2	2	10
OG0006919	1	2	5	1	1	10
OG0006920	1	3	3	1	2	10
OG0006921	4	3	1	1	1	10
OG0006922	1	3	2	2	2	10
OG0006923	3	1	3	1	2	10
OG0006924	1	5	1	2	1	10
OG0006925	5	2	1	1	1	10
OG0006926	3	3	2	1	1	10
OG0006927	1	5	1	1	2	10
OG0006928	1	8	1	0	0	10
OG0006929	1	4	2	1	2	10
OG0006930	2	3	3	1	1	10
OG0006931	2	4	2	1	1	10
OG0006932	4	2	2	1	1	10
OG0006933	2	4	1	2	1	10
OG0006934	2	5	1	1	1	10
OG0006935	2	4	1	2	1	10
OG0006936	2	4	1	1	2	10
OG0006937	2	1	3	1	3	10
OG0006938	5	2	1	1	1	10
OG0006939	2	1	2	3	2	10
OG0006940	2	3	2	1	2	10
OG0006941	1	4	1	2	2	10
OG0006942	1	4	2	2	1	10
OG0006943	2	5	1	1	1	10
OG0006944	2	4	1	2	1	10
OG0006945	10	0	0	0	0	10
OG0006946	2	4	1	1	2	10
OG0006947	10	0	0	0	0	10
OG0006948	2	5	1	1	1	10
OG0006949	4	2	1	1	2	10
OG0006950	2	4	1	2	1	10
OG0006951	2	0	3	4	1	10
OG0006952	2	2	2	2	2	10
OG0006953	1	0	3	3	3	10
OG0006954	2	2	2	2	2	10
OG0006955	2	4	1	2	1	10
OG0006956	2	5	1	1	1	10
OG0006957	1	3	3	1	2	10
OG0006958	2	4	1	2	1	10
OG0006959	2	3	2	1	2	10
OG0006960	2	2	2	1	3	10
OG0006961	2	5	1	1	1	10
OG0006962	3	2	2	1	2	10
OG0006963	4	4	0	1	1	10
OG0006964	2	5	1	1	1	10
OG0006965	3	0	2	2	3	10
OG0006966	3	3	1	1	2	10
OG0006967	2	4	1	1	2	10
OG0006968	4	2	1	2	1	10
OG0006969	2	5	1	1	1	10
OG0006970	2	4	1	1	2	10
OG0006971	2	4	1	1	2	10
OG0006972	2	4	2	1	1	10
OG0006973	3	4	0	2	1	10
OG0006974	3	4	1	1	1	10
OG0006975	2	5	1	1	1	10
OG0006976	2	3	2	1	2	10
OG0006977	2	4	1	1	2	10
OG0006978	2	5	1	1	1	10
OG0006979	2	5	1	1	1	10
OG0006980	2	4	1	2	1	10
OG0006981	2	5	1	1	1	10
OG0006982	2	4	1	2	1	10
OG0006983	2	4	1	2	1	10
OG0006984	2	2	2	1	3	10
OG0006985	2	4	1	2	1	10
OG0006986	2	4	2	1	1	10
OG0006987	2	4	1	1	2	10
OG0006988	2	2	2	2	2	10
OG0006989	2	2	2	2	2	10
OG0006990	1	7	0	1	1	10
OG0006991	2	2	3	1	2	10
OG0006992	2	5	1	1	1	10
OG0006993	2	3	1	3	1	10
OG0006994	2	5	1	1	1	10
OG0006995	2	5	1	1	1	10
OG0006996	2	5	1	1	1	10
OG0006997	4	3	1	1	1	10
OG0006998	2	3	2	1	2	10
OG0006999	2	2	1	4	1	10
OG0007000	2	5	1	1	1	10
OG0007001	2	2	2	2	2	10
OG0007002	2	4	2	1	1	10
OG0007003	2	5	1	1	1	10
OG0007004	2	5	1	1	1	10
OG0007005	2	2	1	4	1	10
OG0007006	2	5	1	1	1	10
OG0007007	4	0	2	2	2	10
OG0007008	3	4	1	1	1	10
OG0007009	3	4	1	1	1	10
OG0007010	2	5	1	1	1	10
OG0007011	2	3	2	1	2	10
OG0007012	1	6	1	1	1	10
OG0007013	1	5	1	2	1	10
OG0007014	1	6	0	2	1	10
OG0007015	1	4	1	3	1	10
OG0007016	3	4	1	1	1	10
OG0007017	4	2	2	1	1	10
OG0007018	3	3	2	1	1	10
OG0007019	1	5	1	2	1	10
OG0007020	2	2	3	2	1	10
OG0007021	2	0	2	5	1	10
OG0007022	2	5	1	1	1	10
OG0007023	2	4	1	2	1	10
OG0007024	3	0	7	0	0	10
OG0007025	2	5	1	1	1	10
OG0007026	5	1	1	1	2	10
OG0007027	2	2	2	1	3	10
OG0007028	2	5	1	1	1	10
OG0007029	4	3	1	1	1	10
OG0007030	2	2	2	2	2	10
OG0007031	6	0	1	3	0	10
OG0007032	2	4	1	2	1	10
OG0007033	3	1	2	2	2	10
OG0007034	3	4	1	1	1	10
OG0007035	2	2	2	2	2	10
OG0007036	4	2	2	1	1	10
OG0007037	3	3	1	2	1	10
OG0007038	2	4	1	2	1	10
OG0007039	2	3	2	1	2	10
OG0007040	2	4	1	2	1	10
OG0007041	2	4	2	1	1	10
OG0007042	2	3	2	1	2	10
OG0007043	2	2	1	4	1	10
OG0007044	2	5	1	1	1	10
OG0007045	2	3	2	1	2	10
OG0007046	2	4	2	1	1	10
OG0007047	2	3	2	1	2	10
OG0007048	2	4	1	1	2	10
OG0007049	2	4	2	1	1	10
OG0007050	3	4	1	1	1	10
OG0007051	2	4	2	1	1	10
OG0007052	2	2	3	1	2	10
OG0007053	1	3	1	4	1	10
OG0007054	8	0	2	0	0	10
OG0007055	1	2	3	2	2	10
OG0007056	2	4	2	1	1	10
OG0007057	2	5	1	1	1	10
OG0007058	4	3	1	1	1	10
OG0007059	1	6	2	0	1	10
OG0007060	2	4	2	1	1	10
OG0007061	1	5	1	1	2	10
OG0007062	3	4	1	1	1	10
OG0007063	1	0	8	0	1	10
OG0007064	1	6	1	1	1	10
OG0007065	1	4	2	1	2	10
OG0007066	1	0	8	0	1	10
OG0007067	1	1	4	2	2	10
OG0007068	1	6	1	1	1	10
OG0007069	2	5	1	1	1	10
OG0007070	2	4	1	2	1	10
OG0007071	1	6	1	1	1	10
OG0007072	2	2	4	1	1	10
OG0007073	10	0	0	0	0	10
OG0007074	10	0	0	0	0	10
OG0007075	2	5	1	1	1	10
OG0007076	2	1	1	1	5	10
OG0007077	3	4	1	1	1	10
OG0007078	2	6	0	1	1	10
OG0007079	10	0	0	0	0	10
OG0007080	2	5	1	1	1	10
OG0007081	2	4	1	2	1	10
OG0007082	2	3	2	1	2	10
OG0007083	4	3	1	1	1	10
OG0007084	2	5	1	1	1	10
OG0007085	10	0	0	0	0	10
OG0007086	2	5	1	1	1	10
OG0007087	3	4	1	1	1	10
OG0007088	2	4	1	1	2	10
OG0007089	2	6	1	1	0	10
OG0007090	3	3	2	1	1	10
OG0007091	2	4	1	1	2	10
OG0007092	2	5	1	1	1	10
OG0007093	2	2	2	1	3	10
OG0007094	1	4	2	1	2	10
OG0007095	2	5	1	1	1	10
OG0007096	3	3	1	1	2	10
OG0007097	2	4	1	2	1	10
OG0007098	2	5	1	1	1	10
OG0007099	2	2	2	2	2	10
OG0007100	3	2	2	1	2	10
OG0007101	2	5	1	1	1	10
OG0007102	2	7	0	1	0	10
OG0007103	2	5	1	1	1	10
OG0007104	2	1	2	2	3	10
OG0007105	2	2	2	2	2	10
OG0007106	2	6	1	1	0	10
OG0007107	2	3	1	1	3	10
OG0007108	2	5	1	1	1	10
OG0007109	2	5	1	2	0	10
OG0007110	2	5	1	1	1	10
OG0007111	10	0	0	0	0	10
OG0007112	4	3	0	2	1	10
OG0007113	2	5	1	1	1	10
OG0007114	1	6	1	1	1	10
OG0007115	2	6	0	1	1	10
OG0007116	2	5	1	1	1	10
OG0007117	3	4	1	1	1	10
OG0007118	2	5	1	1	1	10
OG0007119	2	4	1	2	1	10
OG0007120	2	5	1	1	1	10
OG0007121	2	4	1	1	2	10
OG0007122	2	5	1	1	1	10
OG0007123	2	4	2	1	1	10
OG0007124	2	3	2	1	2	10
OG0007125	2	5	1	1	1	10
OG0007126	3	4	1	1	1	10
OG0007127	2	5	1	1	1	10
OG0007128	3	4	1	1	1	10
OG0007129	2	4	2	1	1	10
OG0007130	2	4	2	1	1	10
OG0007131	2	4	1	1	2	10
OG0007132	3	4	1	1	1	10
OG0007133	2	5	1	1	1	10
OG0007134	1	4	2	1	2	10
OG0007135	1	9	0	0	0	10
OG0007136	1	0	9	0	0	10
OG0007137	1	3	3	1	2	10
OG0007138	1	4	2	1	2	10
OG0007139	1	6	1	1	1	10
OG0007140	1	4	2	1	2	10
OG0007141	1	6	1	1	1	10
OG0007142	1	0	8	0	1	10
OG0007143	1	4	2	1	2	10
OG0007144	1	4	1	3	1	10
OG0007145	1	4	2	1	2	10
OG0007146	1	5	1	2	1	10
OG0007147	1	6	1	1	1	10
OG0007148	1	2	4	0	3	10
OG0007149	1	5	1	2	1	10
OG0007150	1	4	1	2	2	10
OG0007151	2	5	0	2	1	10
OG0007152	2	5	1	1	1	10
OG0007153	2	4	2	1	1	10
OG0007154	1	0	5	2	2	10
OG0007155	1	4	2	1	2	10
OG0007156	1	4	1	2	2	10
OG0007157	1	0	1	6	2	10
OG0007158	1	3	1	1	4	10
OG0007159	1	6	1	1	1	10
OG0007160	1	5	1	2	1	10
OG0007161	2	5	1	1	1	10
OG0007162	1	0	0	9	0	10
OG0007163	1	0	8	0	1	10
OG0007164	1	0	7	0	2	10
OG0007165	1	6	1	1	1	10
OG0007166	1	7	1	0	1	10
OG0007167	0	10	0	0	0	10
OG0007168	0	4	3	2	1	10
OG0007169	0	10	0	0	0	10
OG0007170	0	10	0	0	0	10
OG0007171	0	7	1	1	1	10
OG0007172	0	10	0	0	0	10
OG0007173	0	5	2	1	2	10
OG0007174	0	10	0	0	0	10
OG0007175	0	10	0	0	0	10
OG0007176	0	10	0	0	0	10
OG0007177	0	7	1	1	1	10
OG0007178	0	10	0	0	0	10
OG0007179	0	10	0	0	0	10
OG0007180	0	10	0	0	0	10
OG0007181	0	4	2	2	2	10
OG0007182	0	10	0	0	0	10
OG0007183	0	10	0	0	0	10
OG0007184	0	10	0	0	0	10
OG0007185	0	6	1	3	0	10
OG0007186	0	10	0	0	0	10
OG0007187	0	10	0	0	0	10
OG0007188	0	10	0	0	0	10
OG0007189	0	6	1	1	2	10
OG0007190	0	10	0	0	0	10
OG0007191	0	10	0	0	0	10
OG0007192	0	10	0	0	0	10
OG0007193	0	10	0	0	0	10
OG0007194	0	10	0	0	0	10
OG0007195	0	10	0	0	0	10
OG0007196	0	10	0	0	0	10
OG0007197	0	10	0	0	0	10
OG0007198	0	10	0	0	0	10
OG0007199	0	7	1	1	1	10
OG0007200	0	10	0	0	0	10
OG0007201	0	10	0	0	0	10
OG0007202	0	10	0	0	0	10
OG0007203	0	10	0	0	0	10
OG0007204	0	9	1	0	0	10
OG0007205	0	6	1	1	2	10
OG0007206	0	10	0	0	0	10
OG0007207	0	10	0	0	0	10
OG0007208	0	10	0	0	0	10
OG0007209	0	6	1	1	2	10
OG0007210	0	10	0	0	0	10
OG0007211	0	10	0	0	0	10
OG0007212	0	10	0	0	0	10
OG0007213	0	10	0	0	0	10
OG0007214	0	10	0	0	0	10
OG0007215	0	10	0	0	0	10
OG0007216	0	10	0	0	0	10
OG0007217	0	10	0	0	0	10
OG0007218	0	9	0	1	0	10
OG0007219	0	10	0	0	0	10
OG0007220	0	10	0	0	0	10
OG0007221	0	10	0	0	0	10
OG0007222	0	5	2	1	2	10
OG0007223	0	10	0	0	0	10
OG0007224	0	10	0	0	0	10
OG0007225	0	10	0	0	0	10
OG0007226	0	7	1	1	1	10
OG0007227	0	10	0	0	0	10
OG0007228	0	9	0	1	0	10
OG0007229	0	10	0	0	0	10
OG0007230	0	10	0	0	0	10
OG0007231	0	10	0	0	0	10
OG0007232	0	10	0	0	0	10
OG0007233	0	10	0	0	0	10
OG0007234	0	10	0	0	0	10
OG0007235	0	10	0	0	0	10
OG0007236	0	10	0	0	0	10
OG0007237	0	7	1	1	1	10
OG0007238	0	10	0	0	0	10
OG0007239	0	10	0	0	0	10
OG0007240	0	10	0	0	0	10
OG0007241	0	10	0	0	0	10
OG0007242	0	10	0	0	0	10
OG0007243	0	10	0	0	0	10
OG0007244	0	5	0	4	1	10
OG0007245	0	10	0	0	0	10
OG0007246	0	10	0	0	0	10
OG0007247	0	10	0	0	0	10
OG0007248	0	10	0	0	0	10
OG0007249	0	5	2	1	2	10
OG0007250	0	3	0	0	7	10
OG0007251	0	10	0	0	0	10
OG0007252	0	10	0	0	0	10
OG0007253	0	10	0	0	0	10
OG0007254	0	10	0	0	0	10
OG0007255	0	6	2	1	1	10
OG0007256	0	5	2	2	1	10
OG0007257	0	7	1	1	1	10
OG0007258	0	6	1	1	2	10
OG0007259	0	10	0	0	0	10
OG0007260	0	1	6	2	1	10
OG0007261	0	6	0	3	1	10
OG0007262	0	10	0	0	0	10
OG0007263	0	10	0	0	0	10
OG0007264	0	10	0	0	0	10
OG0007265	0	10	0	0	0	10
OG0007266	0	10	0	0	0	10
OG0007267	0	10	0	0	0	10
OG0007268	0	9	0	1	0	10
OG0007269	0	10	0	0	0	10
OG0007270	0	10	0	0	0	10
OG0007271	0	10	0	0	0	10
OG0007272	0	10	0	0	0	10
OG0007273	0	8	1	0	1	10
OG0007274	0	4	2	2	2	10
OG0007275	0	10	0	0	0	10
OG0007276	0	10	0	0	0	10
OG0007277	0	7	1	1	1	10
OG0007278	0	6	1	1	2	10
OG0007279	0	6	1	1	2	10
OG0007280	0	10	0	0	0	10
OG0007281	0	10	0	0	0	10
OG0007282	0	9	0	1	0	10
OG0007283	0	10	0	0	0	10
OG0007284	0	10	0	0	0	10
OG0007285	0	10	0	0	0	10
OG0007286	0	10	0	0	0	10
OG0007287	0	10	0	0	0	10
OG0007288	0	8	0	1	1	10
OG0007289	0	9	0	1	0	10
OG0007290	0	4	1	4	1	10
OG0007291	0	10	0	0	0	10
OG0007292	0	10	0	0	0	10
OG0007293	0	6	1	2	1	10
OG0007294	0	10	0	0	0	10
OG0007295	0	7	1	1	1	10
OG0007296	0	4	2	2	2	10
OG0007297	0	6	1	1	2	10
OG0007298	0	5	2	1	2	10
OG0007299	0	10	0	0	0	10
OG0007300	0	10	0	0	0	10
OG0007301	0	6	1	1	2	10
OG0007302	0	9	0	1	0	10
OG0007303	0	10	0	0	0	10
OG0007304	0	3	2	3	2	10
OG0007305	0	5	1	2	2	10
OG0007306	0	4	2	2	2	10
OG0007307	0	10	0	0	0	10
OG0007308	0	10	0	0	0	10
OG0007309	0	6	1	1	2	10
OG0007310	0	10	0	0	0	10
OG0007311	0	10	0	0	0	10
OG0007312	0	6	1	1	2	10
OG0007313	0	10	0	0	0	10
OG0007314	0	10	0	0	0	10
OG0007315	0	10	0	0	0	10
OG0007316	0	10	0	0	0	10
OG0007317	0	10	0	0	0	10
OG0007318	0	10	0	0	0	10
OG0007319	0	4	3	1	2	10
OG0007320	0	5	2	1	2	10
OG0007321	0	10	0	0	0	10
OG0007322	0	10	0	0	0	10
OG0007323	0	10	0	0	0	10
OG0007324	0	10	0	0	0	10
OG0007325	0	10	0	0	0	10
OG0007326	0	4	3	2	1	10
OG0007327	0	5	2	0	3	10
OG0007328	0	6	1	2	1	10
OG0007329	0	10	0	0	0	10
OG0007330	0	10	0	0	0	10
OG0007331	0	5	0	2	3	10
OG0007332	0	4	2	1	3	10
OG0007333	0	6	1	0	3	10
OG0007334	0	10	0	0	0	10
OG0007335	0	10	0	0	0	10
OG0007336	0	10	0	0	0	10
OG0007337	0	10	0	0	0	10
OG0007338	0	5	1	3	1	10
OG0007339	0	6	1	1	2	10
OG0007340	0	10	0	0	0	10
OG0007341	0	4	1	2	3	10
OG0007342	0	4	2	1	3	10
OG0007343	0	7	0	1	2	10
OG0007344	0	10	0	0	0	10
OG0007345	0	10	0	0	0	10
OG0007346	0	10	0	0	0	10
OG0007347	0	7	0	3	0	10
OG0007348	0	10	0	0	0	10
OG0007349	0	7	1	2	0	10
OG0007350	0	10	0	0	0	10
OG0007351	0	10	0	0	0	10
OG0007352	0	9	1	0	0	10
OG0007353	0	9	1	0	0	10
OG0007354	0	2	3	2	3	10
OG0007355	0	2	7	0	1	10
OG0007356	0	1	0	1	8	10
OG0007357	0	10	0	0	0	10
OG0007358	0	2	5	2	1	10
OG0007359	0	0	10	0	0	10
OG0007360	0	0	6	0	4	10
OG0007361	0	0	8	2	0	10
OG0007362	0	0	2	0	8	10
OG0007363	0	0	10	0	0	10
OG0007364	0	0	10	0	0	10
OG0007365	0	0	7	0	3	10
OG0007366	0	0	8	0	2	10
OG0007367	0	0	4	0	6	10
OG0007368	0	0	10	0	0	10
OG0007369	0	0	3	5	2	10
OG0007370	0	0	10	0	0	10
OG0007371	0	0	10	0	0	10
OG0007372	0	0	2	0	8	10
OG0007373	0	0	1	6	3	10
OG0007374	0	0	5	0	5	10
OG0007375	0	0	8	0	2	10
OG0007376	0	0	5	2	3	10
OG0007377	0	0	3	0	7	10
OG0007378	0	0	9	0	1	10
OG0007379	0	0	6	0	4	10
OG0007380	0	0	10	0	0	10
OG0007381	0	0	7	0	3	10
OG0007382	0	0	1	8	1	10
OG0007383	0	0	1	0	9	10
OG0007384	0	0	8	0	2	10
OG0007385	0	0	3	0	7	10
OG0007386	0	0	6	2	2	10
OG0007387	0	0	1	2	7	10
OG0007388	0	0	5	0	5	10
OG0007389	0	0	1	0	9	10
OG0007390	0	0	1	0	9	10
OG0007391	0	0	1	1	8	10
OG0007392	0	0	0	9	1	10
OG0007393	0	0	0	8	2	10
OG0007394	0	0	0	10	0	10
OG0007395	0	0	0	10	0	10
OG0007396	0	0	0	10	0	10
OG0007397	0	0	0	10	0	10
OG0007398	0	0	0	10	0	10
OG0007399	0	0	0	0	10	10
OG0007400	0	0	0	0	10	10
OG0007401	0	0	0	0	10	10
OG0007402	0	0	0	0	10	10
OG0007403	0	0	0	0	10	10
OG0007404	0	0	0	0	10	10
OG0007405	0	0	0	0	10	10
OG0007406	0	0	0	0	10	10
OG0007407	0	0	0	0	10	10
OG0007408	0	0	0	0	10	10
OG0007409	0	0	0	0	10	10
OG0007410	0	0	0	0	10	10
OG0007411	0	0	0	0	10	10
OG0007412	0	0	0	0	10	10
OG0007413	0	0	0	0	10	10
OG0007414	0	0	0	0	10	10
OG0007415	2	4	1	1	1	9
OG0007416	3	2	1	1	2	9
OG0007417	2	4	1	1	1	9
OG0007418	2	3	2	1	1	9
OG0007419	4	2	1	1	1	9
OG0007420	9	0	0	0	0	9
OG0007421	3	2	1	3	0	9
OG0007422	9	0	0	0	0	9
OG0007423	4	2	1	1	1	9
OG0007424	2	0	7	0	0	9
OG0007425	9	0	0	0	0	9
OG0007426	2	2	2	1	2	9
OG0007427	4	2	0	1	2	9
OG0007428	2	3	2	1	1	9
OG0007429	9	0	0	0	0	9
OG0007430	4	2	1	1	1	9
OG0007431	9	0	0	0	0	9
OG0007432	5	1	1	1	1	9
OG0007433	4	2	1	1	1	9
OG0007434	9	0	0	0	0	9
OG0007435	8	1	0	0	0	9
OG0007436	2	2	2	1	2	9
OG0007437	2	3	2	1	1	9
OG0007438	2	3	1	1	2	9
OG0007439	2	3	1	2	1	9
OG0007440	4	2	1	1	1	9
OG0007441	3	3	1	1	1	9
OG0007442	2	4	1	1	1	9
OG0007443	4	2	1	1	1	9
OG0007444	1	6	0	1	1	9
OG0007445	5	1	1	1	1	9
OG0007446	4	2	1	1	1	9
OG0007447	4	0	2	1	2	9
OG0007448	4	2	1	1	1	9
OG0007449	2	3	1	2	1	9
OG0007450	9	0	0	0	0	9
OG0007451	3	2	1	2	1	9
OG0007452	4	0	2	1	2	9
OG0007453	4	2	1	1	1	9
OG0007454	2	2	2	1	2	9
OG0007455	2	4	1	1	1	9
OG0007456	2	4	1	1	1	9
OG0007457	3	2	1	2	1	9
OG0007458	9	0	0	0	0	9
OG0007459	2	4	1	1	1	9
OG0007460	2	3	1	1	2	9
OG0007461	4	2	1	1	1	9
OG0007462	4	2	1	1	1	9
OG0007463	9	0	0	0	0	9
OG0007464	2	4	1	1	1	9
OG0007465	4	2	1	1	1	9
OG0007466	9	0	0	0	0	9
OG0007467	2	4	1	1	1	9
OG0007468	4	2	1	1	1	9
OG0007469	2	4	1	1	1	9
OG0007470	4	2	1	1	1	9
OG0007471	4	2	1	1	1	9
OG0007472	9	0	0	0	0	9
OG0007473	4	2	1	1	1	9
OG0007474	2	4	0	1	2	9
OG0007475	2	4	1	1	1	9
OG0007476	4	1	2	1	1	9
OG0007477	4	2	1	1	1	9
OG0007478	5	2	1	1	0	9
OG0007479	4	2	1	1	1	9
OG0007480	4	2	1	1	1	9
OG0007481	4	2	1	1	1	9
OG0007482	2	4	1	1	1	9
OG0007483	2	0	4	1	2	9
OG0007484	2	4	1	1	1	9
OG0007485	4	2	1	1	1	9
OG0007486	4	2	1	1	1	9
OG0007487	2	3	2	1	1	9
OG0007488	2	3	1	2	1	9
OG0007489	2	4	1	1	1	9
OG0007490	9	0	0	0	0	9
OG0007491	4	2	1	1	1	9
OG0007492	5	2	0	1	1	9
OG0007493	2	3	2	1	1	9
OG0007494	2	4	1	1	1	9
OG0007495	2	4	1	1	1	9
OG0007496	2	4	1	1	1	9
OG0007497	2	1	3	1	2	9
OG0007498	2	2	1	3	1	9
OG0007499	3	3	1	1	1	9
OG0007500	3	1	2	2	1	9
OG0007501	2	4	1	1	1	9
OG0007502	9	0	0	0	0	9
OG0007503	2	4	0	1	2	9
OG0007504	2	4	1	1	1	9
OG0007505	4	2	1	1	1	9
OG0007506	4	2	1	1	1	9
OG0007507	4	2	1	1	1	9
OG0007508	2	2	3	1	1	9
OG0007509	2	4	1	1	1	9
OG0007510	2	2	1	3	1	9
OG0007511	3	3	1	1	1	9
OG0007512	2	4	1	1	1	9
OG0007513	4	2	1	1	1	9
OG0007514	4	2	1	1	1	9
OG0007515	4	2	1	1	1	9
OG0007516	4	0	2	1	2	9
OG0007517	4	2	1	1	1	9
OG0007518	2	1	1	4	1	9
OG0007519	3	0	0	6	0	9
OG0007520	9	0	0	0	0	9
OG0007521	4	0	2	2	1	9
OG0007522	2	3	1	1	2	9
OG0007523	2	2	2	1	2	9
OG0007524	9	0	0	0	0	9
OG0007525	4	2	1	1	1	9
OG0007526	4	0	1	3	1	9
OG0007527	2	4	1	1	1	9
OG0007528	4	2	1	1	1	9
OG0007529	2	4	1	1	1	9
OG0007530	2	3	1	2	1	9
OG0007531	9	0	0	0	0	9
OG0007532	3	3	1	1	1	9
OG0007533	2	1	2	2	2	9
OG0007534	2	4	1	1	1	9
OG0007535	2	3	1	2	1	9
OG0007536	3	3	1	1	1	9
OG0007537	8	1	0	0	0	9
OG0007538	2	2	2	1	2	9
OG0007539	4	2	1	1	1	9
OG0007540	4	2	1	1	1	9
OG0007541	2	1	2	2	2	9
OG0007542	4	2	1	1	1	9
OG0007543	2	3	1	2	1	9
OG0007544	3	2	2	1	1	9
OG0007545	2	4	1	1	1	9
OG0007546	2	4	1	1	1	9
OG0007547	9	0	0	0	0	9
OG0007548	2	2	1	4	0	9
OG0007549	9	0	0	0	0	9
OG0007550	2	2	2	2	1	9
OG0007551	2	4	1	1	1	9
OG0007552	4	2	1	1	1	9
OG0007553	2	4	1	1	1	9
OG0007554	3	2	1	2	1	9
OG0007555	2	4	1	1	1	9
OG0007556	9	0	0	0	0	9
OG0007557	2	4	1	1	1	9
OG0007558	9	0	0	0	0	9
OG0007559	2	3	1	1	2	9
OG0007560	3	3	1	1	1	9
OG0007561	4	2	1	1	1	9
OG0007562	2	3	1	1	2	9
OG0007563	9	0	0	0	0	9
OG0007564	1	0	1	0	7	9
OG0007565	2	4	1	1	1	9
OG0007566	4	1	1	1	2	9
OG0007567	4	2	1	1	1	9
OG0007568	2	4	1	1	1	9
OG0007569	3	4	0	2	0	9
OG0007570	9	0	0	0	0	9
OG0007571	2	2	3	1	1	9
OG0007572	4	2	1	1	1	9
OG0007573	5	2	0	1	1	9
OG0007574	4	2	1	1	1	9
OG0007575	2	0	3	1	3	9
OG0007576	4	2	1	1	1	9
OG0007577	9	0	0	0	0	9
OG0007578	4	2	1	1	1	9
OG0007579	5	2	0	1	1	9
OG0007580	1	4	1	2	1	9
OG0007581	2	3	1	1	2	9
OG0007582	2	4	0	2	1	9
OG0007583	9	0	0	0	0	9
OG0007584	3	3	1	1	1	9
OG0007585	3	0	4	0	2	9
OG0007586	2	2	1	0	4	9
OG0007587	4	2	1	0	2	9
OG0007588	2	4	1	1	1	9
OG0007589	2	4	1	1	1	9
OG0007590	2	4	1	1	1	9
OG0007591	9	0	0	0	0	9
OG0007592	4	2	1	1	1	9
OG0007593	2	3	1	1	2	9
OG0007594	9	0	0	0	0	9
OG0007595	4	2	1	1	1	9
OG0007596	4	2	1	1	1	9
OG0007597	9	0	0	0	0	9
OG0007598	4	2	1	1	1	9
OG0007599	2	1	2	2	2	9
OG0007600	9	0	0	0	0	9
OG0007601	5	1	1	1	1	9
OG0007602	2	4	1	1	1	9
OG0007603	2	2	1	1	3	9
OG0007604	2	4	1	1	1	9
OG0007605	2	0	4	0	3	9
OG0007606	2	4	1	1	1	9
OG0007607	3	3	1	1	1	9
OG0007608	2	3	1	2	1	9
OG0007609	3	2	2	1	1	9
OG0007610	3	2	1	1	2	9
OG0007611	9	0	0	0	0	9
OG0007612	5	0	1	2	1	9
OG0007613	2	4	1	1	1	9
OG0007614	2	2	2	1	2	9
OG0007615	2	4	1	1	1	9
OG0007616	2	0	3	1	3	9
OG0007617	9	0	0	0	0	9
OG0007618	5	1	1	1	1	9
OG0007619	2	4	1	1	1	9
OG0007620	4	4	0	1	0	9
OG0007621	2	4	1	1	1	9
OG0007622	2	3	2	1	1	9
OG0007623	5	3	1	0	0	9
OG0007624	3	2	2	1	1	9
OG0007625	2	4	1	1	1	9
OG0007626	9	0	0	0	0	9
OG0007627	2	4	1	1	1	9
OG0007628	4	2	1	1	1	9
OG0007629	2	4	1	1	1	9
OG0007630	2	0	2	2	3	9
OG0007631	3	4	0	1	1	9
OG0007632	2	4	1	1	1	9
OG0007633	2	4	1	1	1	9
OG0007634	3	2	2	1	1	9
OG0007635	2	4	1	1	1	9
OG0007636	2	4	1	1	1	9
OG0007637	3	2	1	2	1	9
OG0007638	4	2	1	1	1	9
OG0007639	2	2	2	1	2	9
OG0007640	9	0	0	0	0	9
OG0007641	4	0	2	1	2	9
OG0007642	4	2	0	2	1	9
OG0007643	1	3	2	1	2	9
OG0007644	2	4	1	1	1	9
OG0007645	4	2	1	1	1	9
OG0007646	2	5	0	1	1	9
OG0007647	4	2	1	1	1	9
OG0007648	1	5	1	1	1	9
OG0007649	2	4	1	1	1	9
OG0007650	2	2	2	1	2	9
OG0007651	4	2	1	1	1	9
OG0007652	2	4	1	1	1	9
OG0007653	3	4	0	1	1	9
OG0007654	2	2	2	1	2	9
OG0007655	2	4	1	1	1	9
OG0007656	2	4	1	1	1	9
OG0007657	3	4	0	1	1	9
OG0007658	1	4	1	2	1	9
OG0007659	5	3	0	1	0	9
OG0007660	2	4	1	1	1	9
OG0007661	2	2	2	1	2	9
OG0007662	2	4	1	1	1	9
OG0007663	2	4	1	1	1	9
OG0007664	2	4	0	2	1	9
OG0007665	3	0	2	2	2	9
OG0007666	3	3	1	1	1	9
OG0007667	9	0	0	0	0	9
OG0007668	2	4	1	1	1	9
OG0007669	2	4	1	1	1	9
OG0007670	9	0	0	0	0	9
OG0007671	2	4	1	1	1	9
OG0007672	2	4	2	1	0	9
OG0007673	4	2	1	1	1	9
OG0007674	2	2	2	1	2	9
OG0007675	3	3	1	1	1	9
OG0007676	2	2	3	1	1	9
OG0007677	5	0	1	2	1	9
OG0007678	2	4	1	1	1	9
OG0007679	8	0	1	0	0	9
OG0007680	1	5	1	1	1	9
OG0007681	2	4	1	1	1	9
OG0007682	1	0	1	0	7	9
OG0007683	2	2	2	1	2	9
OG0007684	4	2	1	1	1	9
OG0007685	7	1	0	0	1	9
OG0007686	4	2	1	1	1	9
OG0007687	2	4	1	1	1	9
OG0007688	8	0	0	0	1	9
OG0007689	2	4	1	1	1	9
OG0007690	2	4	1	1	1	9
OG0007691	4	2	1	1	1	9
OG0007692	2	2	2	1	2	9
OG0007693	2	2	2	3	0	9
OG0007694	7	0	1	1	0	9
OG0007695	2	2	2	1	2	9
OG0007696	2	3	1	1	2	9
OG0007697	9	0	0	0	0	9
OG0007698	9	0	0	0	0	9
OG0007699	4	2	1	1	1	9
OG0007700	2	4	1	1	1	9
OG0007701	4	1	1	2	1	9
OG0007702	5	2	0	1	1	9
OG0007703	9	0	0	0	0	9
OG0007704	2	4	1	1	1	9
OG0007705	9	0	0	0	0	9
OG0007706	2	4	1	1	1	9
OG0007707	9	0	0	0	0	9
OG0007708	3	2	1	1	2	9
OG0007709	2	4	1	1	1	9
OG0007710	4	2	1	1	1	9
OG0007711	9	0	0	0	0	9
OG0007712	2	4	1	1	1	9
OG0007713	2	3	2	1	1	9
OG0007714	4	1	1	2	1	9
OG0007715	2	4	1	1	1	9
OG0007716	2	4	1	1	1	9
OG0007717	2	4	1	1	1	9
OG0007718	3	3	1	1	1	9
OG0007719	9	0	0	0	0	9
OG0007720	2	2	2	2	1	9
OG0007721	2	4	1	1	1	9
OG0007722	3	2	1	1	2	9
OG0007723	4	2	1	1	1	9
OG0007724	2	4	1	1	1	9
OG0007725	1	2	4	0	2	9
OG0007726	4	2	1	1	1	9
OG0007727	3	4	0	1	1	9
OG0007728	9	0	0	0	0	9
OG0007729	2	4	1	1	1	9
OG0007730	2	4	1	1	1	9
OG0007731	2	3	1	1	2	9
OG0007732	2	3	2	1	1	9
OG0007733	2	4	1	1	1	9
OG0007734	2	4	0	2	1	9
OG0007735	4	2	1	1	1	9
OG0007736	5	0	2	1	1	9
OG0007737	4	2	0	1	2	9
OG0007738	2	4	1	1	1	9
OG0007739	4	2	1	1	1	9
OG0007740	4	2	1	1	1	9
OG0007741	9	0	0	0	0	9
OG0007742	2	4	1	1	1	9
OG0007743	2	4	1	1	1	9
OG0007744	3	2	1	2	1	9
OG0007745	2	1	1	4	1	9
OG0007746	2	4	1	1	1	9
OG0007747	1	3	2	1	2	9
OG0007748	2	1	2	2	2	9
OG0007749	2	4	1	1	1	9
OG0007750	4	2	1	1	1	9
OG0007751	2	4	1	1	1	9
OG0007752	3	2	1	2	1	9
OG0007753	2	3	2	1	1	9
OG0007754	2	4	1	1	1	9
OG0007755	3	3	1	1	1	9
OG0007756	2	4	1	1	1	9
OG0007757	2	4	1	1	1	9
OG0007758	3	2	1	2	1	9
OG0007759	5	0	1	0	3	9
OG0007760	2	2	2	1	2	9
OG0007761	3	3	1	1	1	9
OG0007762	3	3	1	1	1	9
OG0007763	2	2	2	1	2	9
OG0007764	2	1	3	2	1	9
OG0007765	2	4	0	2	1	9
OG0007766	2	4	1	1	1	9
OG0007767	2	2	2	1	2	9
OG0007768	2	4	1	1	1	9
OG0007769	2	2	2	1	2	9
OG0007770	2	1	5	0	1	9
OG0007771	4	2	1	1	1	9
OG0007772	2	5	0	1	1	9
OG0007773	2	0	2	3	2	9
OG0007774	2	4	1	1	1	9
OG0007775	2	4	1	1	1	9
OG0007776	3	2	1	1	2	9
OG0007777	2	3	2	1	1	9
OG0007778	2	4	1	1	1	9
OG0007779	3	2	2	1	1	9
OG0007780	2	2	2	1	2	9
OG0007781	6	0	0	3	0	9
OG0007782	3	3	1	1	1	9
OG0007783	2	2	2	1	2	9
OG0007784	4	2	1	1	1	9
OG0007785	4	2	1	1	1	9
OG0007786	3	2	1	1	2	9
OG0007787	4	2	1	1	1	9
OG0007788	4	2	1	1	1	9
OG0007789	2	2	2	1	2	9
OG0007790	1	2	2	2	2	9
OG0007791	4	2	1	1	1	9
OG0007792	3	3	1	1	1	9
OG0007793	3	2	2	1	1	9
OG0007794	2	4	1	1	1	9
OG0007795	2	1	2	2	2	9
OG0007796	2	4	1	1	1	9
OG0007797	2	4	0	2	1	9
OG0007798	2	4	1	1	1	9
OG0007799	2	4	1	1	1	9
OG0007800	1	6	1	1	0	9
OG0007801	9	0	0	0	0	9
OG0007802	2	2	2	1	2	9
OG0007803	2	2	2	2	1	9
OG0007804	4	2	1	1	1	9
OG0007805	3	3	1	1	1	9
OG0007806	2	5	1	1	0	9
OG0007807	5	2	0	1	1	9
OG0007808	6	1	0	1	1	9
OG0007809	2	4	1	1	1	9
OG0007810	4	2	1	1	1	9
OG0007811	3	4	0	1	1	9
OG0007812	2	4	1	1	1	9
OG0007813	3	2	1	2	1	9
OG0007814	2	0	4	1	2	9
OG0007815	2	2	3	1	1	9
OG0007816	4	2	1	1	1	9
OG0007817	3	1	1	2	2	9
OG0007818	2	4	1	1	1	9
OG0007819	1	1	3	2	2	9
OG0007820	4	2	1	1	1	9
OG0007821	2	6	0	1	0	9
OG0007822	2	3	2	1	1	9
OG0007823	2	4	1	1	1	9
OG0007824	2	4	1	1	1	9
OG0007825	2	2	2	1	2	9
OG0007826	2	3	2	1	1	9
OG0007827	3	2	2	1	1	9
OG0007828	9	0	0	0	0	9
OG0007829	4	2	0	2	1	9
OG0007830	2	4	1	1	1	9
OG0007831	9	0	0	0	0	9
OG0007832	2	3	2	1	1	9
OG0007833	2	4	0	2	1	9
OG0007834	2	2	2	1	2	9
OG0007835	9	0	0	0	0	9
OG0007836	2	4	1	1	1	9
OG0007837	2	4	1	1	1	9
OG0007838	4	2	1	1	1	9
OG0007839	2	2	1	3	1	9
OG0007840	1	0	8	0	0	9
OG0007841	2	2	1	2	2	9
OG0007842	2	4	1	1	1	9
OG0007843	9	0	0	0	0	9
OG0007844	4	3	0	1	1	9
OG0007845	2	4	1	1	1	9
OG0007846	2	2	2	1	2	9
OG0007847	2	4	1	1	1	9
OG0007848	2	1	2	1	3	9
OG0007849	2	3	1	2	1	9
OG0007850	4	3	0	1	1	9
OG0007851	2	3	1	2	1	9
OG0007852	2	4	1	1	1	9
OG0007853	2	4	1	1	1	9
OG0007854	6	0	1	1	1	9
OG0007855	9	0	0	0	0	9
OG0007856	2	5	0	1	1	9
OG0007857	2	2	1	1	3	9
OG0007858	4	2	1	1	1	9
OG0007859	4	2	1	1	1	9
OG0007860	2	4	1	1	1	9
OG0007861	3	3	1	1	1	9
OG0007862	3	2	2	1	1	9
OG0007863	3	2	0	2	2	9
OG0007864	2	4	1	1	1	9
OG0007865	2	2	2	1	2	9
OG0007866	2	2	1	1	3	9
OG0007867	2	5	0	1	1	9
OG0007868	2	3	2	1	1	9
OG0007869	2	4	1	1	1	9
OG0007870	2	4	1	1	1	9
OG0007871	2	4	1	1	1	9
OG0007872	2	5	0	1	1	9
OG0007873	3	4	0	1	1	9
OG0007874	9	0	0	0	0	9
OG0007875	2	4	1	1	1	9
OG0007876	2	4	1	1	1	9
OG0007877	2	3	2	1	1	9
OG0007878	2	4	1	1	1	9
OG0007879	1	4	1	1	2	9
OG0007880	2	3	2	1	1	9
OG0007881	2	4	1	1	1	9
OG0007882	3	3	1	1	1	9
OG0007883	2	4	1	1	1	9
OG0007884	2	4	1	1	1	9
OG0007885	3	1	2	1	2	9
OG0007886	7	2	0	0	0	9
OG0007887	2	4	1	1	1	9
OG0007888	2	4	1	1	1	9
OG0007889	1	2	2	1	3	9
OG0007890	2	4	1	1	1	9
OG0007891	2	2	2	1	2	9
OG0007892	4	2	1	1	1	9
OG0007893	2	3	1	2	1	9
OG0007894	2	4	1	1	1	9
OG0007895	2	5	0	1	1	9
OG0007896	2	4	1	1	1	9
OG0007897	2	4	1	1	1	9
OG0007898	2	4	1	1	1	9
OG0007899	4	2	1	1	1	9
OG0007900	2	4	1	1	1	9
OG0007901	4	2	1	1	1	9
OG0007902	2	4	1	1	1	9
OG0007903	3	1	1	2	2	9
OG0007904	4	2	1	1	1	9
OG0007905	4	2	1	1	1	9
OG0007906	2	4	1	1	1	9
OG0007907	9	0	0	0	0	9
OG0007908	1	4	1	1	2	9
OG0007909	2	4	1	1	1	9
OG0007910	2	4	1	1	1	9
OG0007911	2	4	1	1	1	9
OG0007912	2	3	2	1	1	9
OG0007913	4	2	1	1	1	9
OG0007914	3	2	2	1	1	9
OG0007915	2	4	1	1	1	9
OG0007916	2	4	1	1	1	9
OG0007917	2	5	0	1	1	9
OG0007918	2	5	0	1	1	9
OG0007919	9	0	0	0	0	9
OG0007920	2	4	1	1	1	9
OG0007921	2	4	1	1	1	9
OG0007922	2	2	1	3	1	9
OG0007923	2	4	1	1	1	9
OG0007924	2	3	1	1	2	9
OG0007925	4	2	1	1	1	9
OG0007926	2	3	1	3	0	9
OG0007927	2	3	1	2	1	9
OG0007928	2	3	1	2	1	9
OG0007929	2	2	2	1	2	9
OG0007930	2	4	1	1	1	9
OG0007931	4	0	2	1	2	9
OG0007932	2	4	1	1	1	9
OG0007933	3	5	0	1	0	9
OG0007934	4	2	1	1	1	9
OG0007935	4	2	1	1	1	9
OG0007936	2	2	2	1	2	9
OG0007937	2	3	2	1	1	9
OG0007938	2	4	1	1	1	9
OG0007939	2	4	1	1	1	9
OG0007940	2	4	1	1	1	9
OG0007941	2	2	2	1	2	9
OG0007942	4	1	1	1	2	9
OG0007943	2	2	1	1	3	9
OG0007944	2	3	2	1	1	9
OG0007945	4	2	1	1	1	9
OG0007946	2	4	1	1	1	9
OG0007947	2	2	2	1	2	9
OG0007948	2	3	2	1	1	9
OG0007949	2	4	1	1	1	9
OG0007950	2	4	1	1	1	9
OG0007951	2	3	1	1	2	9
OG0007952	2	3	1	1	2	9
OG0007953	2	2	2	1	2	9
OG0007954	3	3	1	1	1	9
OG0007955	2	4	1	1	1	9
OG0007956	9	0	0	0	0	9
OG0007957	2	4	1	1	1	9
OG0007958	2	2	1	2	2	9
OG0007959	2	4	1	1	1	9
OG0007960	2	2	2	1	2	9
OG0007961	1	0	4	3	1	9
OG0007962	2	4	1	1	1	9
OG0007963	4	2	1	1	1	9
OG0007964	2	1	2	2	2	9
OG0007965	2	4	1	1	1	9
OG0007966	4	3	1	1	0	9
OG0007967	2	2	1	3	1	9
OG0007968	2	4	1	1	1	9
OG0007969	4	3	0	1	1	9
OG0007970	4	1	2	1	1	9
OG0007971	2	4	1	1	1	9
OG0007972	2	2	0	3	2	9
OG0007973	2	4	1	1	1	9
OG0007974	2	4	1	1	1	9
OG0007975	4	3	0	1	1	9
OG0007976	2	4	1	1	1	9
OG0007977	3	2	1	2	1	9
OG0007978	5	0	1	1	2	9
OG0007979	2	3	1	1	2	9
OG0007980	4	1	1	1	2	9
OG0007981	4	1	2	1	1	9
OG0007982	1	4	1	1	2	9
OG0007983	2	3	1	2	1	9
OG0007984	4	2	1	1	1	9
OG0007985	2	4	1	1	1	9
OG0007986	2	4	1	1	1	9
OG0007987	2	4	2	1	0	9
OG0007988	2	4	1	1	1	9
OG0007989	3	0	2	4	0	9
OG0007990	2	4	1	1	1	9
OG0007991	9	0	0	0	0	9
OG0007992	2	4	1	1	1	9
OG0007993	5	1	1	1	1	9
OG0007994	2	4	1	1	1	9
OG0007995	4	0	1	1	3	9
OG0007996	2	4	1	1	1	9
OG0007997	4	2	1	1	1	9
OG0007998	2	4	1	1	1	9
OG0007999	3	1	2	1	2	9
OG0008000	4	2	1	1	1	9
OG0008001	2	2	2	1	2	9
OG0008002	4	2	1	0	2	9
OG0008003	1	4	2	1	1	9
OG0008004	4	2	1	1	1	9
OG0008005	2	1	4	1	1	9
OG0008006	4	2	1	1	1	9
OG0008007	2	4	1	1	1	9
OG0008008	2	0	4	1	2	9
OG0008009	2	2	2	1	2	9
OG0008010	2	3	2	1	1	9
OG0008011	2	2	2	1	2	9
OG0008012	2	4	1	1	1	9
OG0008013	2	2	3	1	1	9
OG0008014	5	2	0	1	1	9
OG0008015	2	2	2	1	2	9
OG0008016	4	2	1	1	1	9
OG0008017	3	2	0	3	1	9
OG0008018	2	4	1	1	1	9
OG0008019	2	4	1	1	1	9
OG0008020	2	2	4	1	0	9
OG0008021	2	4	1	1	1	9
OG0008022	2	3	1	2	1	9
OG0008023	4	2	1	2	0	9
OG0008024	1	3	2	2	1	9
OG0008025	3	4	0	1	1	9
OG0008026	2	2	1	3	1	9
OG0008027	2	4	1	1	1	9
OG0008028	2	2	2	1	2	9
OG0008029	2	4	1	1	1	9
OG0008030	2	2	2	2	1	9
OG0008031	2	4	1	1	1	9
OG0008032	2	3	1	2	1	9
OG0008033	2	0	2	4	1	9
OG0008034	4	2	1	1	1	9
OG0008035	4	2	1	1	1	9
OG0008036	4	2	1	1	1	9
OG0008037	2	4	1	1	1	9
OG0008038	5	2	1	1	0	9
OG0008039	2	3	1	2	1	9
OG0008040	2	4	1	1	1	9
OG0008041	2	0	3	2	2	9
OG0008042	2	3	2	1	1	9
OG0008043	2	2	2	1	2	9
OG0008044	4	2	1	1	1	9
OG0008045	2	3	2	1	1	9
OG0008046	2	4	1	1	1	9
OG0008047	1	2	5	1	0	9
OG0008048	3	2	1	2	1	9
OG0008049	3	1	1	2	2	9
OG0008050	4	0	2	1	2	9
OG0008051	2	4	1	1	1	9
OG0008052	2	4	1	1	1	9
OG0008053	2	2	2	1	2	9
OG0008054	4	2	1	1	1	9
OG0008055	2	2	2	1	2	9
OG0008056	2	4	1	1	1	9
OG0008057	4	2	1	1	1	9
OG0008058	2	4	1	1	1	9
OG0008059	2	4	1	1	1	9
OG0008060	3	3	1	1	1	9
OG0008061	2	4	1	1	1	9
OG0008062	2	4	1	1	1	9
OG0008063	2	2	1	2	2	9
OG0008064	2	4	1	1	1	9
OG0008065	2	4	1	1	1	9
OG0008066	2	4	1	1	1	9
OG0008067	2	2	1	3	1	9
OG0008068	2	4	1	1	1	9
OG0008069	4	2	1	1	1	9
OG0008070	2	2	1	1	3	9
OG0008071	2	3	2	1	1	9
OG0008072	2	2	2	1	2	9
OG0008073	2	4	1	1	1	9
OG0008074	2	4	1	1	1	9
OG0008075	2	3	1	2	1	9
OG0008076	4	2	1	1	1	9
OG0008077	2	0	3	1	3	9
OG0008078	2	2	2	1	2	9
OG0008079	2	4	1	1	1	9
OG0008080	2	4	1	1	1	9
OG0008081	2	4	1	1	1	9
OG0008082	4	2	1	1	1	9
OG0008083	2	4	1	1	1	9
OG0008084	3	3	1	1	1	9
OG0008085	2	2	2	1	2	9
OG0008086	2	2	1	3	1	9
OG0008087	2	2	2	1	2	9
OG0008088	3	1	3	1	1	9
OG0008089	3	1	1	1	3	9
OG0008090	2	4	1	1	1	9
OG0008091	2	2	1	2	2	9
OG0008092	4	2	1	1	1	9
OG0008093	4	2	1	1	1	9
OG0008094	2	2	1	3	1	9
OG0008095	2	4	1	1	1	9
OG0008096	2	5	1	1	0	9
OG0008097	2	4	1	1	1	9
OG0008098	9	0	0	0	0	9
OG0008099	2	4	1	1	1	9
OG0008100	2	3	1	2	1	9
OG0008101	2	4	1	1	1	9
OG0008102	2	4	1	1	1	9
OG0008103	2	3	1	1	2	9
OG0008104	2	4	1	1	1	9
OG0008105	2	5	0	1	1	9
OG0008106	2	4	1	1	1	9
OG0008107	2	4	1	1	1	9
OG0008108	3	0	3	1	2	9
OG0008109	2	4	1	1	1	9
OG0008110	3	2	1	1	2	9
OG0008111	4	2	1	1	1	9
OG0008112	1	4	1	1	2	9
OG0008113	2	2	2	2	1	9
OG0008114	2	2	2	1	2	9
OG0008115	3	1	2	1	2	9
OG0008116	9	0	0	0	0	9
OG0008117	2	2	2	1	2	9
OG0008118	2	2	2	1	2	9
OG0008119	9	0	0	0	0	9
OG0008120	4	2	1	1	1	9
OG0008121	4	2	1	1	1	9
OG0008122	3	2	1	2	1	9
OG0008123	2	4	1	1	1	9
OG0008124	2	4	1	1	1	9
OG0008125	2	4	1	1	1	9
OG0008126	2	2	2	1	2	9
OG0008127	4	2	1	1	1	9
OG0008128	2	4	1	1	1	9
OG0008129	2	4	1	1	1	9
OG0008130	3	3	1	1	1	9
OG0008131	2	4	1	1	1	9
OG0008132	2	4	1	1	1	9
OG0008133	2	2	3	1	1	9
OG0008134	2	3	1	2	1	9
OG0008135	2	4	1	1	1	9
OG0008136	2	3	1	2	1	9
OG0008137	2	2	1	1	3	9
OG0008138	4	3	1	0	1	9
OG0008139	4	1	1	1	2	9
OG0008140	2	2	2	1	2	9
OG0008141	2	4	1	1	1	9
OG0008142	2	4	1	1	1	9
OG0008143	4	3	1	1	0	9
OG0008144	3	1	2	1	2	9
OG0008145	3	5	0	1	0	9
OG0008146	2	4	1	1	1	9
OG0008147	2	4	1	1	1	9
OG0008148	2	4	1	1	1	9
OG0008149	2	5	0	1	1	9
OG0008150	3	3	1	1	1	9
OG0008151	2	4	1	1	1	9
OG0008152	2	5	0	1	1	9
OG0008153	2	4	1	1	1	9
OG0008154	3	2	1	1	2	9
OG0008155	2	2	2	1	2	9
OG0008156	2	2	3	1	1	9
OG0008157	2	4	1	1	1	9
OG0008158	4	0	1	2	2	9
OG0008159	2	4	1	1	1	9
OG0008160	2	4	1	1	1	9
OG0008161	2	4	1	1	1	9
OG0008162	3	4	0	1	1	9
OG0008163	2	5	0	1	1	9
OG0008164	3	2	1	2	1	9
OG0008165	4	0	1	4	0	9
OG0008166	2	4	1	1	1	9
OG0008167	2	4	1	1	1	9
OG0008168	2	3	2	1	1	9
OG0008169	2	4	1	1	1	9
OG0008170	4	0	3	1	1	9
OG0008171	3	3	1	1	1	9
OG0008172	2	4	1	1	1	9
OG0008173	2	2	2	1	2	9
OG0008174	2	4	1	1	1	9
OG0008175	2	2	1	2	2	9
OG0008176	2	3	1	1	2	9
OG0008177	2	0	4	2	1	9
OG0008178	3	2	1	2	1	9
OG0008179	1	5	1	1	1	9
OG0008180	3	2	1	2	1	9
OG0008181	2	4	1	1	1	9
OG0008182	2	4	1	1	1	9
OG0008183	3	2	2	1	1	9
OG0008184	2	2	3	1	1	9
OG0008185	2	4	1	1	1	9
OG0008186	2	4	1	1	1	9
OG0008187	3	3	1	1	1	9
OG0008188	4	2	1	1	1	9
OG0008189	9	0	0	0	0	9
OG0008190	2	4	1	1	1	9
OG0008191	2	4	1	1	1	9
OG0008192	4	2	1	1	1	9
OG0008193	2	4	1	1	1	9
OG0008194	2	2	2	1	2	9
OG0008195	2	3	2	1	1	9
OG0008196	3	1	2	1	2	9
OG0008197	3	3	1	1	1	9
OG0008198	2	4	1	1	1	9
OG0008199	2	4	1	1	1	9
OG0008200	4	2	1	1	1	9
OG0008201	2	5	0	1	1	9
OG0008202	2	2	1	1	3	9
OG0008203	4	2	1	1	1	9
OG0008204	2	4	1	1	1	9
OG0008205	2	4	1	1	1	9
OG0008206	2	3	1	1	2	9
OG0008207	1	5	1	1	1	9
OG0008208	2	4	1	1	1	9
OG0008209	2	4	1	1	1	9
OG0008210	2	3	1	1	2	9
OG0008211	5	2	0	1	1	9
OG0008212	4	2	1	1	1	9
OG0008213	4	2	1	1	1	9
OG0008214	2	4	1	1	1	9
OG0008215	4	2	1	1	1	9
OG0008216	2	4	1	1	1	9
OG0008217	4	2	1	1	1	9
OG0008218	2	6	0	1	0	9
OG0008219	3	2	1	2	1	9
OG0008220	2	3	1	2	1	9
OG0008221	2	4	1	1	1	9
OG0008222	2	4	0	1	2	9
OG0008223	2	4	1	1	1	9
OG0008224	2	4	1	1	1	9
OG0008225	2	4	1	1	1	9
OG0008226	5	2	0	1	1	9
OG0008227	4	0	2	1	2	9
OG0008228	2	0	3	2	2	9
OG0008229	3	2	2	1	1	9
OG0008230	2	4	1	1	1	9
OG0008231	2	1	1	2	3	9
OG0008232	2	2	2	1	2	9
OG0008233	2	4	1	1	1	9
OG0008234	4	2	1	1	1	9
OG0008235	2	2	2	1	2	9
OG0008236	2	3	1	1	2	9
OG0008237	2	3	1	1	2	9
OG0008238	1	5	1	1	1	9
OG0008239	2	4	1	1	1	9
OG0008240	2	4	1	1	1	9
OG0008241	2	4	1	1	1	9
OG0008242	2	2	2	2	1	9
OG0008243	2	2	2	0	3	9
OG0008244	2	3	1	1	2	9
OG0008245	2	4	1	1	1	9
OG0008246	2	4	1	1	1	9
OG0008247	3	2	2	1	1	9
OG0008248	3	4	0	1	1	9
OG0008249	2	1	1	2	3	9
OG0008250	4	2	1	1	1	9
OG0008251	5	1	0	2	1	9
OG0008252	2	4	1	1	1	9
OG0008253	2	4	1	1	1	9
OG0008254	3	2	1	2	1	9
OG0008255	2	4	1	1	1	9
OG0008256	2	4	1	1	1	9
OG0008257	2	4	1	1	1	9
OG0008258	9	0	0	0	0	9
OG0008259	2	4	1	1	1	9
OG0008260	5	2	0	1	1	9
OG0008261	2	2	1	2	2	9
OG0008262	5	0	3	1	0	9
OG0008263	2	4	1	1	1	9
OG0008264	2	4	1	1	1	9
OG0008265	9	0	0	0	0	9
OG0008266	2	4	1	1	1	9
OG0008267	2	4	1	1	1	9
OG0008268	4	3	1	1	0	9
OG0008269	4	0	2	1	2	9
OG0008270	2	4	1	1	1	9
OG0008271	4	2	1	1	1	9
OG0008272	2	3	2	1	1	9
OG0008273	2	4	1	1	1	9
OG0008274	4	2	1	1	1	9
OG0008275	2	4	1	1	1	9
OG0008276	4	2	1	1	1	9
OG0008277	2	3	1	2	1	9
OG0008278	2	2	2	1	2	9
OG0008279	2	4	1	1	1	9
OG0008280	2	4	1	1	1	9
OG0008281	2	5	0	1	1	9
OG0008282	2	3	1	2	1	9
OG0008283	3	2	2	1	1	9
OG0008284	4	2	1	1	1	9
OG0008285	2	4	1	1	1	9
OG0008286	2	2	2	1	2	9
OG0008287	2	3	2	1	1	9
OG0008288	7	0	1	0	1	9
OG0008289	2	4	1	1	1	9
OG0008290	4	0	3	1	1	9
OG0008291	2	1	2	3	1	9
OG0008292	3	3	1	1	1	9
OG0008293	2	2	3	1	1	9
OG0008294	4	0	1	1	3	9
OG0008295	1	6	0	1	1	9
OG0008296	3	2	2	1	1	9
OG0008297	3	3	1	1	1	9
OG0008298	1	2	2	3	1	9
OG0008299	2	4	1	1	1	9
OG0008300	2	4	1	1	1	9
OG0008301	2	2	2	1	2	9
OG0008302	2	4	2	1	0	9
OG0008303	2	4	1	1	1	9
OG0008304	3	2	2	1	1	9
OG0008305	4	2	1	1	1	9
OG0008306	4	2	1	1	1	9
OG0008307	2	4	1	1	1	9
OG0008308	3	2	1	1	2	9
OG0008309	3	3	1	1	1	9
OG0008310	2	4	0	2	1	9
OG0008311	2	2	0	0	5	9
OG0008312	2	4	1	1	1	9
OG0008313	2	4	1	1	1	9
OG0008314	2	4	1	1	1	9
OG0008315	2	4	1	1	1	9
OG0008316	2	4	1	1	1	9
OG0008317	3	3	1	1	1	9
OG0008318	2	0	4	0	3	9
OG0008319	2	4	1	1	1	9
OG0008320	7	0	0	2	0	9
OG0008321	4	2	1	2	0	9
OG0008322	2	4	1	1	1	9
OG0008323	2	5	1	0	1	9
OG0008324	3	2	1	1	2	9
OG0008325	2	7	0	0	0	9
OG0008326	3	2	1	2	1	9
OG0008327	2	3	1	2	1	9
OG0008328	2	4	1	1	1	9
OG0008329	3	3	1	1	1	9
OG0008330	3	3	1	1	1	9
OG0008331	2	2	3	1	1	9
OG0008332	2	3	1	1	2	9
OG0008333	9	0	0	0	0	9
OG0008334	2	4	1	1	1	9
OG0008335	2	4	1	1	1	9
OG0008336	2	4	1	1	1	9
OG0008337	2	3	1	1	2	9
OG0008338	2	2	3	1	1	9
OG0008339	3	3	1	1	1	9
OG0008340	2	2	2	1	2	9
OG0008341	2	4	1	1	1	9
OG0008342	3	2	2	1	1	9
OG0008343	2	4	1	1	1	9
OG0008344	5	0	4	0	0	9
OG0008345	2	1	2	2	2	9
OG0008346	2	4	1	1	1	9
OG0008347	2	2	2	1	2	9
OG0008348	2	3	2	1	1	9
OG0008349	2	4	1	1	1	9
OG0008350	2	0	1	5	1	9
OG0008351	3	2	3	0	1	9
OG0008352	2	5	0	1	1	9
OG0008353	4	2	1	1	1	9
OG0008354	8	0	0	1	0	9
OG0008355	2	2	2	1	2	9
OG0008356	2	0	2	2	3	9
OG0008357	3	3	1	1	1	9
OG0008358	2	4	1	1	1	9
OG0008359	4	2	1	1	1	9
OG0008360	2	4	1	1	1	9
OG0008361	2	3	2	1	1	9
OG0008362	4	0	2	1	2	9
OG0008363	4	0	2	1	2	9
OG0008364	2	2	2	2	1	9
OG0008365	2	2	2	2	1	9
OG0008366	2	3	1	1	2	9
OG0008367	1	3	2	0	3	9
OG0008368	2	2	2	2	1	9
OG0008369	4	0	1	3	1	9
OG0008370	2	4	1	1	1	9
OG0008371	2	2	2	1	2	9
OG0008372	2	2	2	1	2	9
OG0008373	4	0	2	1	2	9
OG0008374	2	4	1	1	1	9
OG0008375	2	2	3	1	1	9
OG0008376	2	4	1	1	1	9
OG0008377	9	0	0	0	0	9
OG0008378	2	5	1	1	0	9
OG0008379	3	5	0	1	0	9
OG0008380	2	1	1	1	4	9
OG0008381	4	2	1	1	1	9
OG0008382	2	1	2	2	2	9
OG0008383	4	2	1	1	1	9
OG0008384	2	4	1	1	1	9
OG0008385	3	3	1	1	1	9
OG0008386	4	0	2	1	2	9
OG0008387	2	4	1	1	1	9
OG0008388	2	4	1	1	1	9
OG0008389	2	4	1	1	1	9
OG0008390	2	4	1	1	1	9
OG0008391	2	2	2	2	1	9
OG0008392	2	3	2	1	1	9
OG0008393	2	5	0	1	1	9
OG0008394	1	0	3	4	1	9
OG0008395	2	4	1	1	1	9
OG0008396	4	4	0	1	0	9
OG0008397	2	4	1	1	1	9
OG0008398	2	4	1	1	1	9
OG0008399	2	4	1	1	1	9
OG0008400	4	2	1	1	1	9
OG0008401	2	3	2	1	1	9
OG0008402	3	4	0	1	1	9
OG0008403	4	0	1	3	1	9
OG0008404	4	0	2	0	3	9
OG0008405	2	2	1	3	1	9
OG0008406	2	4	1	1	1	9
OG0008407	6	2	0	1	0	9
OG0008408	4	2	1	1	1	9
OG0008409	2	5	0	1	1	9
OG0008410	4	2	1	1	1	9
OG0008411	2	4	1	1	1	9
OG0008412	2	4	1	1	1	9
OG0008413	2	4	1	1	1	9
OG0008414	2	4	1	1	1	9
OG0008415	3	1	2	1	2	9
OG0008416	2	4	0	2	1	9
OG0008417	2	3	2	1	1	9
OG0008418	2	4	1	1	1	9
OG0008419	2	4	1	1	1	9
OG0008420	3	0	3	1	2	9
OG0008421	2	4	1	1	1	9
OG0008422	2	4	1	1	1	9
OG0008423	2	0	3	1	3	9
OG0008424	2	4	1	1	1	9
OG0008425	2	4	1	1	1	9
OG0008426	2	2	2	1	2	9
OG0008427	4	2	1	1	1	9
OG0008428	2	4	1	1	1	9
OG0008429	1	2	2	2	2	9
OG0008430	2	2	2	1	2	9
OG0008431	2	4	1	1	1	9
OG0008432	4	2	1	1	1	9
OG0008433	2	2	3	1	1	9
OG0008434	4	2	1	1	1	9
OG0008435	4	2	1	1	1	9
OG0008436	4	2	1	1	1	9
OG0008437	2	2	2	1	2	9
OG0008438	2	4	1	1	1	9
OG0008439	2	4	1	1	1	9
OG0008440	3	2	2	1	1	9
OG0008441	3	3	1	1	1	9
OG0008442	2	4	1	1	1	9
OG0008443	2	3	2	1	1	9
OG0008444	9	0	0	0	0	9
OG0008445	2	0	3	1	3	9
OG0008446	2	4	1	1	1	9
OG0008447	2	4	1	1	1	9
OG0008448	2	4	1	1	1	9
OG0008449	2	4	1	1	1	9
OG0008450	3	2	1	1	2	9
OG0008451	3	2	1	1	2	9
OG0008452	2	4	1	1	1	9
OG0008453	2	2	2	1	2	9
OG0008454	7	0	0	2	0	9
OG0008455	2	4	1	1	1	9
OG0008456	2	4	1	1	1	9
OG0008457	3	2	1	2	1	9
OG0008458	2	4	1	1	1	9
OG0008459	2	4	1	1	1	9
OG0008460	2	4	1	1	1	9
OG0008461	2	4	1	1	1	9
OG0008462	3	4	0	1	1	9
OG0008463	2	4	1	1	1	9
OG0008464	4	2	1	1	1	9
OG0008465	4	2	1	1	1	9
OG0008466	2	4	1	1	1	9
OG0008467	2	2	1	1	3	9
OG0008468	2	4	1	1	1	9
OG0008469	2	3	2	1	1	9
OG0008470	2	4	1	1	1	9
OG0008471	4	2	1	1	1	9
OG0008472	2	2	2	1	2	9
OG0008473	2	5	1	1	0	9
OG0008474	2	4	1	1	1	9
OG0008475	2	4	1	1	1	9
OG0008476	4	2	1	1	1	9
OG0008477	2	2	2	1	2	9
OG0008478	2	2	2	1	2	9
OG0008479	2	4	1	1	1	9
OG0008480	2	4	1	1	1	9
OG0008481	1	3	2	1	2	9
OG0008482	3	0	2	2	2	9
OG0008483	1	5	1	1	1	9
OG0008484	2	4	1	1	1	9
OG0008485	4	2	1	1	1	9
OG0008486	4	2	1	1	1	9
OG0008487	3	0	2	2	2	9
OG0008488	2	4	1	1	1	9
OG0008489	2	2	2	1	2	9
OG0008490	2	5	0	1	1	9
OG0008491	3	3	1	0	2	9
OG0008492	4	1	1	2	1	9
OG0008493	2	4	1	1	1	9
OG0008494	2	3	2	1	1	9
OG0008495	3	5	0	1	0	9
OG0008496	2	4	1	1	1	9
OG0008497	2	4	1	1	1	9
OG0008498	2	3	3	1	0	9
OG0008499	2	4	1	1	1	9
OG0008500	2	2	3	1	1	9
OG0008501	3	2	2	1	1	9
OG0008502	1	5	1	1	1	9
OG0008503	2	4	1	1	1	9
OG0008504	2	4	1	1	1	9
OG0008505	2	4	1	1	1	9
OG0008506	2	4	1	1	1	9
OG0008507	2	2	1	1	3	9
OG0008508	3	3	1	1	1	9
OG0008509	3	2	1	2	1	9
OG0008510	4	1	2	1	1	9
OG0008511	4	2	1	1	1	9
OG0008512	2	4	1	1	1	9
OG0008513	3	3	1	1	1	9
OG0008514	2	4	1	1	1	9
OG0008515	4	2	1	1	1	9
OG0008516	1	4	1	1	2	9
OG0008517	2	4	1	1	1	9
OG0008518	1	6	1	1	0	9
OG0008519	4	2	1	1	1	9
OG0008520	4	2	1	1	1	9
OG0008521	2	2	2	1	2	9
OG0008522	2	4	1	1	1	9
OG0008523	2	2	1	1	3	9
OG0008524	4	2	1	1	1	9
OG0008525	4	0	2	1	2	9
OG0008526	2	1	6	0	0	9
OG0008527	2	4	1	1	1	9
OG0008528	2	2	2	1	2	9
OG0008529	3	2	1	2	1	9
OG0008530	1	4	2	1	1	9
OG0008531	2	3	2	1	1	9
OG0008532	2	2	1	2	2	9
OG0008533	2	4	1	1	1	9
OG0008534	2	4	1	1	1	9
OG0008535	2	2	1	2	2	9
OG0008536	2	4	1	1	1	9
OG0008537	2	2	2	1	2	9
OG0008538	2	3	2	1	1	9
OG0008539	2	2	2	1	2	9
OG0008540	4	2	1	1	1	9
OG0008541	4	2	1	1	1	9
OG0008542	4	2	1	1	1	9
OG0008543	2	4	1	1	1	9
OG0008544	2	2	2	1	2	9
OG0008545	2	4	1	1	1	9
OG0008546	2	4	1	1	1	9
OG0008547	2	5	0	1	1	9
OG0008548	2	4	1	1	1	9
OG0008549	2	4	1	1	1	9
OG0008550	4	2	1	1	1	9
OG0008551	1	3	1	2	2	9
OG0008552	2	2	2	1	2	9
OG0008553	2	4	1	1	1	9
OG0008554	2	4	1	1	1	9
OG0008555	2	4	1	1	1	9
OG0008556	2	4	1	1	1	9
OG0008557	2	4	1	1	1	9
OG0008558	2	4	1	1	1	9
OG0008559	4	2	1	1	1	9
OG0008560	4	2	1	1	1	9
OG0008561	2	4	1	1	1	9
OG0008562	2	2	3	1	1	9
OG0008563	2	4	1	1	1	9
OG0008564	2	4	1	1	1	9
OG0008565	2	4	1	1	1	9
OG0008566	2	4	1	1	1	9
OG0008567	3	5	0	1	0	9
OG0008568	4	2	1	1	1	9
OG0008569	2	4	1	1	1	9
OG0008570	2	2	1	2	2	9
OG0008571	3	2	1	1	2	9
OG0008572	9	0	0	0	0	9
OG0008573	2	4	1	1	1	9
OG0008574	3	0	2	2	2	9
OG0008575	5	2	0	1	1	9
OG0008576	2	4	1	1	1	9
OG0008577	2	3	0	3	1	9
OG0008578	4	2	1	1	1	9
OG0008579	4	4	0	1	0	9
OG0008580	3	2	1	1	2	9
OG0008581	3	4	0	1	1	9
OG0008582	3	4	0	1	1	9
OG0008583	2	4	1	1	1	9
OG0008584	4	0	1	2	2	9
OG0008585	2	3	2	1	1	9
OG0008586	1	5	1	1	1	9
OG0008587	2	5	1	0	1	9
OG0008588	2	4	1	1	1	9
OG0008589	2	4	1	1	1	9
OG0008590	4	2	1	1	1	9
OG0008591	2	2	2	1	2	9
OG0008592	3	4	0	1	1	9
OG0008593	2	4	1	1	1	9
OG0008594	2	4	1	1	1	9
OG0008595	2	0	3	0	4	9
OG0008596	2	2	2	1	2	9
OG0008597	2	2	2	1	2	9
OG0008598	2	2	2	1	2	9
OG0008599	2	0	2	2	3	9
OG0008600	2	4	1	1	1	9
OG0008601	3	1	2	2	1	9
OG0008602	4	1	1	1	2	9
OG0008603	9	0	0	0	0	9
OG0008604	2	3	2	1	1	9
OG0008605	2	4	1	1	1	9
OG0008606	4	2	1	1	1	9
OG0008607	3	3	1	1	1	9
OG0008608	2	4	1	1	1	9
OG0008609	3	0	1	4	1	9
OG0008610	2	4	1	1	1	9
OG0008611	2	4	1	1	1	9
OG0008612	2	5	0	1	1	9
OG0008613	2	4	1	1	1	9
OG0008614	3	2	1	1	2	9
OG0008615	2	4	1	1	1	9
OG0008616	2	2	1	1	3	9
OG0008617	4	2	1	1	1	9
OG0008618	2	3	1	1	2	9
OG0008619	1	6	0	2	0	9
OG0008620	3	3	1	1	1	9
OG0008621	4	2	1	1	1	9
OG0008622	2	3	2	1	1	9
OG0008623	3	2	1	1	2	9
OG0008624	2	4	1	1	1	9
OG0008625	3	3	1	1	1	9
OG0008626	2	2	1	2	2	9
OG0008627	4	1	1	2	1	9
OG0008628	3	1	1	1	3	9
OG0008629	4	2	1	1	1	9
OG0008630	3	2	2	1	1	9
OG0008631	3	2	1	1	2	9
OG0008632	3	2	1	2	1	9
OG0008633	2	2	2	1	2	9
OG0008634	3	3	1	1	1	9
OG0008635	2	4	1	1	1	9
OG0008636	2	4	1	1	1	9
OG0008637	3	3	1	1	1	9
OG0008638	4	0	2	1	2	9
OG0008639	2	4	1	1	1	9
OG0008640	2	2	2	1	2	9
OG0008641	2	2	2	1	2	9
OG0008642	2	4	1	1	1	9
OG0008643	2	4	1	1	1	9
OG0008644	2	4	1	1	1	9
OG0008645	2	4	1	1	1	9
OG0008646	2	4	1	1	1	9
OG0008647	2	4	1	1	1	9
OG0008648	2	4	1	1	1	9
OG0008649	3	0	3	2	1	9
OG0008650	2	4	1	1	1	9
OG0008651	2	0	3	1	3	9
OG0008652	2	4	1	1	1	9
OG0008653	2	4	1	1	1	9
OG0008654	4	2	1	1	1	9
OG0008655	2	2	2	1	2	9
OG0008656	2	5	1	1	0	9
OG0008657	2	6	0	1	0	9
OG0008658	2	4	1	1	1	9
OG0008659	2	2	1	2	2	9
OG0008660	2	4	1	1	1	9
OG0008661	2	4	1	1	1	9
OG0008662	2	3	2	1	1	9
OG0008663	2	2	2	1	2	9
OG0008664	2	4	1	1	1	9
OG0008665	2	4	1	1	1	9
OG0008666	4	2	1	1	1	9
OG0008667	2	2	2	1	2	9
OG0008668	2	2	3	1	1	9
OG0008669	2	2	2	1	2	9
OG0008670	4	2	1	1	1	9
OG0008671	3	2	1	2	1	9
OG0008672	2	4	1	1	1	9
OG0008673	2	4	1	1	1	9
OG0008674	2	3	1	1	2	9
OG0008675	4	2	1	1	1	9
OG0008676	2	4	1	1	1	9
OG0008677	2	2	2	1	2	9
OG0008678	2	4	1	1	1	9
OG0008679	4	2	1	1	1	9
OG0008680	4	2	1	1	1	9
OG0008681	2	3	2	1	1	9
OG0008682	2	4	1	1	1	9
OG0008683	3	2	1	2	1	9
OG0008684	4	2	1	1	1	9
OG0008685	2	4	1	1	1	9
OG0008686	2	3	1	2	1	9
OG0008687	2	4	1	1	1	9
OG0008688	2	4	1	1	1	9
OG0008689	2	4	1	1	1	9
OG0008690	2	2	2	1	2	9
OG0008691	4	2	1	1	1	9
OG0008692	2	4	1	1	1	9
OG0008693	2	4	1	1	1	9
OG0008694	2	4	1	1	1	9
OG0008695	2	4	1	1	1	9
OG0008696	7	0	0	2	0	9
OG0008697	2	4	1	1	1	9
OG0008698	2	4	1	1	1	9
OG0008699	5	0	2	1	1	9
OG0008700	1	8	0	0	0	9
OG0008701	1	4	1	1	2	9
OG0008702	3	1	2	2	1	9
OG0008703	1	3	2	2	1	9
OG0008704	1	4	2	1	1	9
OG0008705	1	4	1	2	1	9
OG0008706	1	2	3	2	1	9
OG0008707	1	2	3	1	2	9
OG0008708	2	2	2	1	2	9
OG0008709	1	4	2	1	1	9
OG0008710	2	4	1	1	1	9
OG0008711	2	4	1	1	1	9
OG0008712	2	4	1	1	1	9
OG0008713	2	3	2	1	1	9
OG0008714	2	4	1	1	1	9
OG0008715	3	3	1	1	1	9
OG0008716	2	4	1	1	1	9
OG0008717	2	4	1	1	1	9
OG0008718	2	4	2	1	0	9
OG0008719	2	1	2	2	2	9
OG0008720	2	2	2	1	2	9
OG0008721	2	4	1	1	1	9
OG0008722	1	2	0	0	6	9
OG0008723	2	4	1	1	1	9
OG0008724	2	5	0	1	1	9
OG0008725	4	2	1	1	1	9
OG0008726	4	2	2	1	0	9
OG0008727	5	0	2	1	1	9
OG0008728	2	2	3	1	1	9
OG0008729	2	4	1	1	1	9
OG0008730	2	1	2	2	2	9
OG0008731	2	4	1	2	0	9
OG0008732	2	4	1	1	1	9
OG0008733	2	4	1	1	1	9
OG0008734	2	2	2	1	2	9
OG0008735	2	2	1	2	2	9
OG0008736	2	0	5	1	1	9
OG0008737	2	4	1	1	1	9
OG0008738	2	2	2	1	2	9
OG0008739	2	2	2	1	2	9
OG0008740	2	3	1	1	2	9
OG0008741	2	4	1	1	1	9
OG0008742	2	4	1	1	1	9
OG0008743	2	2	1	2	2	9
OG0008744	2	4	1	1	1	9
OG0008745	2	4	1	1	1	9
OG0008746	2	2	1	2	2	9
OG0008747	1	2	2	2	2	9
OG0008748	2	3	1	2	1	9
OG0008749	2	3	2	1	1	9
OG0008750	2	2	2	1	2	9
OG0008751	2	4	1	1	1	9
OG0008752	2	3	1	1	2	9
OG0008753	2	4	1	1	1	9
OG0008754	2	4	1	1	1	9
OG0008755	2	4	1	1	1	9
OG0008756	2	4	1	1	1	9
OG0008757	2	3	1	1	2	9
OG0008758	2	0	5	0	2	9
OG0008759	2	4	1	1	1	9
OG0008760	2	2	2	1	2	9
OG0008761	2	4	1	1	1	9
OG0008762	2	2	2	1	2	9
OG0008763	2	4	1	1	1	9
OG0008764	3	3	1	1	1	9
OG0008765	2	3	2	1	1	9
OG0008766	2	3	1	1	2	9
OG0008767	2	3	2	1	1	9
OG0008768	2	0	4	1	2	9
OG0008769	2	4	1	1	1	9
OG0008770	2	4	1	1	1	9
OG0008771	3	1	2	1	2	9
OG0008772	2	5	0	1	1	9
OG0008773	3	3	1	1	1	9
OG0008774	2	3	1	2	1	9
OG0008775	2	2	1	2	2	9
OG0008776	3	4	1	1	0	9
OG0008777	1	3	2	1	2	9
OG0008778	2	4	1	1	1	9
OG0008779	2	3	1	1	2	9
OG0008780	2	4	1	1	1	9
OG0008781	2	4	1	1	1	9
OG0008782	2	5	1	1	0	9
OG0008783	2	4	1	1	1	9
OG0008784	2	3	2	1	1	9
OG0008785	2	4	1	1	1	9
OG0008786	2	5	1	0	1	9
OG0008787	2	5	1	1	0	9
OG0008788	2	3	1	2	1	9
OG0008789	1	4	2	1	1	9
OG0008790	2	4	0	2	1	9
OG0008791	1	4	1	2	1	9
OG0008792	2	4	1	1	1	9
OG0008793	1	4	1	2	1	9
OG0008794	2	4	1	1	1	9
OG0008795	2	5	0	1	1	9
OG0008796	2	4	0	1	2	9
OG0008797	2	4	1	1	1	9
OG0008798	4	2	1	1	1	9
OG0008799	2	4	1	1	1	9
OG0008800	2	6	0	1	0	9
OG0008801	2	4	1	1	1	9
OG0008802	2	4	1	1	1	9
OG0008803	2	0	3	3	1	9
OG0008804	2	4	1	1	1	9
OG0008805	2	2	2	1	2	9
OG0008806	4	2	1	1	1	9
OG0008807	2	2	2	1	2	9
OG0008808	2	4	1	1	1	9
OG0008809	1	4	1	2	1	9
OG0008810	3	3	1	1	1	9
OG0008811	2	2	2	1	2	9
OG0008812	4	2	1	1	1	9
OG0008813	2	4	1	1	1	9
OG0008814	2	3	1	1	2	9
OG0008815	2	2	2	1	2	9
OG0008816	2	2	2	1	2	9
OG0008817	3	2	1	2	1	9
OG0008818	2	4	1	1	1	9
OG0008819	2	4	1	1	1	9
OG0008820	2	3	2	1	1	9
OG0008821	2	3	1	1	2	9
OG0008822	2	4	1	1	1	9
OG0008823	2	4	1	1	1	9
OG0008824	2	4	1	1	1	9
OG0008825	2	4	1	1	1	9
OG0008826	2	1	1	3	2	9
OG0008827	2	1	2	2	2	9
OG0008828	2	4	1	1	1	9
OG0008829	2	2	1	3	1	9
OG0008830	2	5	0	1	1	9
OG0008831	2	4	1	1	1	9
OG0008832	2	4	1	1	1	9
OG0008833	2	4	1	1	1	9
OG0008834	2	4	1	1	1	9
OG0008835	2	0	5	0	2	9
OG0008836	1	1	4	1	2	9
OG0008837	4	2	1	1	1	9
OG0008838	3	3	1	1	1	9
OG0008839	2	4	0	1	2	9
OG0008840	1	4	2	1	1	9
OG0008841	2	4	1	1	1	9
OG0008842	2	4	0	3	0	9
OG0008843	3	2	2	1	1	9
OG0008844	2	4	1	1	1	9
OG0008845	2	2	2	1	2	9
OG0008846	9	0	0	0	0	9
OG0008847	2	2	2	1	2	9
OG0008848	2	4	1	1	1	9
OG0008849	2	4	1	1	1	9
OG0008850	2	3	1	1	2	9
OG0008851	9	0	0	0	0	9
OG0008852	2	6	0	1	0	9
OG0008853	2	4	1	2	0	9
OG0008854	2	4	1	1	1	9
OG0008855	3	3	1	1	1	9
OG0008856	2	2	1	2	2	9
OG0008857	2	4	1	1	1	9
OG0008858	2	0	4	1	2	9
OG0008859	2	3	1	1	2	9
OG0008860	2	4	1	1	1	9
OG0008861	2	4	1	1	1	9
OG0008862	2	2	1	1	3	9
OG0008863	2	4	1	1	1	9
OG0008864	2	2	2	1	2	9
OG0008865	2	2	2	2	1	9
OG0008866	2	4	1	1	1	9
OG0008867	2	3	1	2	1	9
OG0008868	2	1	1	4	1	9
OG0008869	2	2	1	3	1	9
OG0008870	2	3	2	1	1	9
OG0008871	1	1	2	5	0	9
OG0008872	1	8	0	0	0	9
OG0008873	2	4	1	1	1	9
OG0008874	1	2	2	2	2	9
OG0008875	1	4	1	1	2	9
OG0008876	2	4	1	1	1	9
OG0008877	2	4	1	1	1	9
OG0008878	2	4	1	1	1	9
OG0008879	2	4	1	1	1	9
OG0008880	2	4	1	1	1	9
OG0008881	2	4	1	1	1	9
OG0008882	2	4	1	1	1	9
OG0008883	2	4	1	1	1	9
OG0008884	2	4	1	1	1	9
OG0008885	2	2	2	2	1	9
OG0008886	2	4	1	1	1	9
OG0008887	2	3	2	1	1	9
OG0008888	2	4	1	1	1	9
OG0008889	2	0	3	1	3	9
OG0008890	2	4	1	1	1	9
OG0008891	2	2	2	1	2	9
OG0008892	2	2	2	1	2	9
OG0008893	2	4	1	1	1	9
OG0008894	2	5	0	1	1	9
OG0008895	2	4	0	1	2	9
OG0008896	2	4	1	1	1	9
OG0008897	1	4	1	1	2	9
OG0008898	5	2	1	1	0	9
OG0008899	1	4	1	1	2	9
OG0008900	1	2	3	1	2	9
OG0008901	1	2	2	2	2	9
OG0008902	2	1	2	2	2	9
OG0008903	1	3	2	1	2	9
OG0008904	1	8	0	0	0	9
OG0008905	1	3	2	3	0	9
OG0008906	2	4	1	1	1	9
OG0008907	4	2	1	1	1	9
OG0008908	2	1	2	2	2	9
OG0008909	2	4	1	1	1	9
OG0008910	3	2	2	1	1	9
OG0008911	5	0	1	3	0	9
OG0008912	2	4	1	1	1	9
OG0008913	2	3	2	1	1	9
OG0008914	2	4	1	1	1	9
OG0008915	2	3	1	1	2	9
OG0008916	3	3	1	1	1	9
OG0008917	2	2	2	1	2	9
OG0008918	2	5	0	1	1	9
OG0008919	2	1	3	2	1	9
OG0008920	2	2	1	3	1	9
OG0008921	2	4	1	1	1	9
OG0008922	4	2	1	1	1	9
OG0008923	2	5	0	1	1	9
OG0008924	2	2	2	1	2	9
OG0008925	2	4	1	1	1	9
OG0008926	2	4	1	1	1	9
OG0008927	4	3	0	1	1	9
OG0008928	2	2	2	1	2	9
OG0008929	2	4	1	1	1	9
OG0008930	9	0	0	0	0	9
OG0008931	2	2	3	1	1	9
OG0008932	3	0	2	1	3	9
OG0008933	2	1	1	1	4	9
OG0008934	3	2	1	2	1	9
OG0008935	2	4	1	1	1	9
OG0008936	2	4	1	1	1	9
OG0008937	2	3	1	1	2	9
OG0008938	2	5	1	1	0	9
OG0008939	2	2	2	1	2	9
OG0008940	3	2	2	1	1	9
OG0008941	2	4	1	1	1	9
OG0008942	2	3	1	2	1	9
OG0008943	2	3	1	1	2	9
OG0008944	2	4	1	1	1	9
OG0008945	2	4	1	1	1	9
OG0008946	3	3	1	1	1	9
OG0008947	2	2	3	1	1	9
OG0008948	2	4	1	1	1	9
OG0008949	2	4	1	1	1	9
OG0008950	2	3	2	1	1	9
OG0008951	2	4	1	1	1	9
OG0008952	2	4	1	1	1	9
OG0008953	2	4	1	1	1	9
OG0008954	2	3	1	2	1	9
OG0008955	2	4	1	1	1	9
OG0008956	2	4	1	1	1	9
OG0008957	2	4	1	1	1	9
OG0008958	1	2	3	2	1	9
OG0008959	2	3	2	1	1	9
OG0008960	2	5	1	1	0	9
OG0008961	2	4	1	1	1	9
OG0008962	2	4	1	1	1	9
OG0008963	2	4	1	1	1	9
OG0008964	2	4	1	1	1	9
OG0008965	2	4	1	1	1	9
OG0008966	2	2	2	1	2	9
OG0008967	2	4	1	1	1	9
OG0008968	1	5	1	1	1	9
OG0008969	2	4	1	1	1	9
OG0008970	2	4	1	1	1	9
OG0008971	2	0	1	4	2	9
OG0008972	2	2	1	2	2	9
OG0008973	2	2	2	1	2	9
OG0008974	2	4	1	1	1	9
OG0008975	2	4	1	1	1	9
OG0008976	2	4	1	1	1	9
OG0008977	2	4	1	1	1	9
OG0008978	2	4	1	1	1	9
OG0008979	2	4	1	1	1	9
OG0008980	2	4	1	1	1	9
OG0008981	2	3	1	1	2	9
OG0008982	2	4	1	1	1	9
OG0008983	2	4	1	1	1	9
OG0008984	2	4	1	1	1	9
OG0008985	2	4	1	1	1	9
OG0008986	2	0	3	2	2	9
OG0008987	1	6	0	1	1	9
OG0008988	2	2	2	2	1	9
OG0008989	2	4	1	1	1	9
OG0008990	2	4	1	1	1	9
OG0008991	2	4	1	1	1	9
OG0008992	2	6	0	1	0	9
OG0008993	2	4	1	1	1	9
OG0008994	2	4	1	1	1	9
OG0008995	2	2	1	3	1	9
OG0008996	2	3	2	1	1	9
OG0008997	2	4	2	1	0	9
OG0008998	2	4	1	1	1	9
OG0008999	2	0	2	2	3	9
OG0009000	3	2	2	1	1	9
OG0009001	2	2	2	1	2	9
OG0009002	2	5	0	1	1	9
OG0009003	2	4	1	1	1	9
OG0009004	1	5	1	1	1	9
OG0009005	2	2	2	1	2	9
OG0009006	2	4	1	1	1	9
OG0009007	2	3	1	1	2	9
OG0009008	2	5	1	1	0	9
OG0009009	2	4	1	1	1	9
OG0009010	2	4	1	1	1	9
OG0009011	2	4	0	2	1	9
OG0009012	2	2	1	1	3	9
OG0009013	2	4	1	1	1	9
OG0009014	5	1	1	1	1	9
OG0009015	1	2	4	0	2	9
OG0009016	1	0	8	0	0	9
OG0009017	1	3	2	2	1	9
OG0009018	1	4	1	2	1	9
OG0009019	1	3	2	2	1	9
OG0009020	1	4	1	1	2	9
OG0009021	2	4	1	1	1	9
OG0009022	4	3	0	1	1	9
OG0009023	2	1	3	1	2	9
OG0009024	2	2	2	2	1	9
OG0009025	1	5	1	1	1	9
OG0009026	1	2	0	6	0	9
OG0009027	1	2	3	1	2	9
OG0009028	1	5	1	1	1	9
OG0009029	2	4	1	1	1	9
OG0009030	1	2	2	2	2	9
OG0009031	2	4	1	1	1	9
OG0009032	1	2	1	2	3	9
OG0009033	2	4	1	1	1	9
OG0009034	2	5	0	1	1	9
OG0009035	1	3	2	1	2	9
OG0009036	2	4	1	1	1	9
OG0009037	2	4	1	1	1	9
OG0009038	1	4	1	2	1	9
OG0009039	0	9	0	0	0	9
OG0009040	0	9	0	0	0	9
OG0009041	0	6	1	1	1	9
OG0009042	0	8	0	1	0	9
OG0009043	0	9	0	0	0	9
OG0009044	0	9	0	0	0	9
OG0009045	0	3	2	2	2	9
OG0009046	0	9	0	0	0	9
OG0009047	0	1	1	1	6	9
OG0009048	0	9	0	0	0	9
OG0009049	0	9	0	0	0	9
OG0009050	0	9	0	0	0	9
OG0009051	0	9	0	0	0	9
OG0009052	0	6	1	1	1	9
OG0009053	0	9	0	0	0	9
OG0009054	0	8	0	1	0	9
OG0009055	0	6	1	1	1	9
OG0009056	0	5	2	1	1	9
OG0009057	0	9	0	0	0	9
OG0009058	0	9	0	0	0	9
OG0009059	0	9	0	0	0	9
OG0009060	0	9	0	0	0	9
OG0009061	0	7	0	2	0	9
OG0009062	0	6	1	1	1	9
OG0009063	0	9	0	0	0	9
OG0009064	0	9	0	0	0	9
OG0009065	0	9	0	0	0	9
OG0009066	0	9	0	0	0	9
OG0009067	0	9	0	0	0	9
OG0009068	0	9	0	0	0	9
OG0009069	0	9	0	0	0	9
OG0009070	0	9	0	0	0	9
OG0009071	0	9	0	0	0	9
OG0009072	0	4	1	2	2	9
OG0009073	0	6	1	1	1	9
OG0009074	0	9	0	0	0	9
OG0009075	0	9	0	0	0	9
OG0009076	0	9	0	0	0	9
OG0009077	0	8	0	1	0	9
OG0009078	0	5	2	1	1	9
OG0009079	0	9	0	0	0	9
OG0009080	0	9	0	0	0	9
OG0009081	0	9	0	0	0	9
OG0009082	0	9	0	0	0	9
OG0009083	0	9	0	0	0	9
OG0009084	0	4	2	1	2	9
OG0009085	0	9	0	0	0	9
OG0009086	0	9	0	0	0	9
OG0009087	0	9	0	0	0	9
OG0009088	0	9	0	0	0	9
OG0009089	0	3	2	3	1	9
OG0009090	0	9	0	0	0	9
OG0009091	0	9	0	0	0	9
OG0009092	0	9	0	0	0	9
OG0009093	0	6	1	1	1	9
OG0009094	0	9	0	0	0	9
OG0009095	0	9	0	0	0	9
OG0009096	0	6	1	1	1	9
OG0009097	0	9	0	0	0	9
OG0009098	0	9	0	0	0	9
OG0009099	0	9	0	0	0	9
OG0009100	0	6	1	1	1	9
OG0009101	0	7	1	0	1	9
OG0009102	0	9	0	0	0	9
OG0009103	0	9	0	0	0	9
OG0009104	0	9	0	0	0	9
OG0009105	0	6	1	1	1	9
OG0009106	0	9	0	0	0	9
OG0009107	0	9	0	0	0	9
OG0009108	0	9	0	0	0	9
OG0009109	0	9	0	0	0	9
OG0009110	0	9	0	0	0	9
OG0009111	0	9	0	0	0	9
OG0009112	0	5	4	0	0	9
OG0009113	0	6	1	1	1	9
OG0009114	0	9	0	0	0	9
OG0009115	0	6	2	0	1	9
OG0009116	0	4	2	1	2	9
OG0009117	0	9	0	0	0	9
OG0009118	0	9	0	0	0	9
OG0009119	0	9	0	0	0	9
OG0009120	0	9	0	0	0	9
OG0009121	0	9	0	0	0	9
OG0009122	0	6	1	1	1	9
OG0009123	0	9	0	0	0	9
OG0009124	0	4	2	1	2	9
OG0009125	0	9	0	0	0	9
OG0009126	0	8	0	1	0	9
OG0009127	0	9	0	0	0	9
OG0009128	0	9	0	0	0	9
OG0009129	0	5	1	2	1	9
OG0009130	0	4	3	1	1	9
OG0009131	0	9	0	0	0	9
OG0009132	0	5	1	1	2	9
OG0009133	0	1	7	0	1	9
OG0009134	0	9	0	0	0	9
OG0009135	0	5	2	0	2	9
OG0009136	0	5	2	0	2	9
OG0009137	0	9	0	0	0	9
OG0009138	0	8	0	1	0	9
OG0009139	0	9	0	0	0	9
OG0009140	0	9	0	0	0	9
OG0009141	0	9	0	0	0	9
OG0009142	0	9	0	0	0	9
OG0009143	0	9	0	0	0	9
OG0009144	0	6	1	1	1	9
OG0009145	0	6	1	1	1	9
OG0009146	0	9	0	0	0	9
OG0009147	0	9	0	0	0	9
OG0009148	0	9	0	0	0	9
OG0009149	0	4	2	2	1	9
OG0009150	0	9	0	0	0	9
OG0009151	0	9	0	0	0	9
OG0009152	0	6	1	1	1	9
OG0009153	0	7	0	2	0	9
OG0009154	0	9	0	0	0	9
OG0009155	0	5	0	2	2	9
OG0009156	0	2	5	1	1	9
OG0009157	0	9	0	0	0	9
OG0009158	0	3	2	2	2	9
OG0009159	0	9	0	0	0	9
OG0009160	0	8	1	0	0	9
OG0009161	0	9	0	0	0	9
OG0009162	0	9	0	0	0	9
OG0009163	0	5	1	1	2	9
OG0009164	0	9	0	0	0	9
OG0009165	0	4	2	1	2	9
OG0009166	0	9	0	0	0	9
OG0009167	0	6	1	1	1	9
OG0009168	0	9	0	0	0	9
OG0009169	0	8	0	0	1	9
OG0009170	0	9	0	0	0	9
OG0009171	0	9	0	0	0	9
OG0009172	0	9	0	0	0	9
OG0009173	0	4	2	1	2	9
OG0009174	0	9	0	0	0	9
OG0009175	0	9	0	0	0	9
OG0009176	0	3	1	3	2	9
OG0009177	0	6	1	1	1	9
OG0009178	0	7	0	2	0	9
OG0009179	0	4	2	1	2	9
OG0009180	0	5	2	1	1	9
OG0009181	0	9	0	0	0	9
OG0009182	0	1	8	0	0	9
OG0009183	0	8	0	1	0	9
OG0009184	0	9	0	0	0	9
OG0009185	0	9	0	0	0	9
OG0009186	0	9	0	0	0	9
OG0009187	0	9	0	0	0	9
OG0009188	0	6	1	1	1	9
OG0009189	0	4	2	1	2	9
OG0009190	0	4	2	1	2	9
OG0009191	0	9	0	0	0	9
OG0009192	0	9	0	0	0	9
OG0009193	0	9	0	0	0	9
OG0009194	0	8	1	0	0	9
OG0009195	0	9	0	0	0	9
OG0009196	0	9	0	0	0	9
OG0009197	0	9	0	0	0	9
OG0009198	0	9	0	0	0	9
OG0009199	0	8	0	1	0	9
OG0009200	0	9	0	0	0	9
OG0009201	0	4	2	1	2	9
OG0009202	0	9	0	0	0	9
OG0009203	0	9	0	0	0	9
OG0009204	0	4	2	1	2	9
OG0009205	0	9	0	0	0	9
OG0009206	0	9	0	0	0	9
OG0009207	0	9	0	0	0	9
OG0009208	0	6	1	1	1	9
OG0009209	0	9	0	0	0	9
OG0009210	0	9	0	0	0	9
OG0009211	0	6	1	1	1	9
OG0009212	0	7	0	1	1	9
OG0009213	0	9	0	0	0	9
OG0009214	0	4	2	1	2	9
OG0009215	0	2	5	1	1	9
OG0009216	0	4	2	1	2	9
OG0009217	0	5	1	0	3	9
OG0009218	0	4	1	1	3	9
OG0009219	0	9	0	0	0	9
OG0009220	0	1	3	2	3	9
OG0009221	0	3	2	0	4	9
OG0009222	0	6	1	1	1	9
OG0009223	0	9	0	0	0	9
OG0009224	0	7	1	1	0	9
OG0009225	0	9	0	0	0	9
OG0009226	0	9	0	0	0	9
OG0009227	0	7	0	2	0	9
OG0009228	0	6	1	1	1	9
OG0009229	0	9	0	0	0	9
OG0009230	0	9	0	0	0	9
OG0009231	0	9	0	0	0	9
OG0009232	0	9	0	0	0	9
OG0009233	0	5	2	1	1	9
OG0009234	0	9	0	0	0	9
OG0009235	0	2	3	1	3	9
OG0009236	0	4	2	1	2	9
OG0009237	0	9	0	0	0	9
OG0009238	0	9	0	0	0	9
OG0009239	0	9	0	0	0	9
OG0009240	0	6	1	1	1	9
OG0009241	0	7	1	1	0	9
OG0009242	0	4	3	1	1	9
OG0009243	0	5	1	1	2	9
OG0009244	0	8	1	0	0	9
OG0009245	0	4	2	1	2	9
OG0009246	0	9	0	0	0	9
OG0009247	0	2	6	0	1	9
OG0009248	0	6	1	1	1	9
OG0009249	0	5	0	3	1	9
OG0009250	0	4	2	1	2	9
OG0009251	0	1	2	0	6	9
OG0009252	0	2	2	2	3	9
OG0009253	0	1	0	0	8	9
OG0009254	0	1	5	2	1	9
OG0009255	0	0	7	0	2	9
OG0009256	0	0	9	0	0	9
OG0009257	0	0	8	0	1	9
OG0009258	0	0	1	0	8	9
OG0009259	0	0	4	0	5	9
OG0009260	0	0	5	0	4	9
OG0009261	0	0	8	0	1	9
OG0009262	0	0	9	0	0	9
OG0009263	0	0	8	0	1	9
OG0009264	0	0	4	1	4	9
OG0009265	0	0	2	0	7	9
OG0009266	0	0	9	0	0	9
OG0009267	0	0	9	0	0	9
OG0009268	0	0	8	0	1	9
OG0009269	0	0	6	0	3	9
OG0009270	0	0	6	0	3	9
OG0009271	0	0	4	0	5	9
OG0009272	0	0	5	0	4	9
OG0009273	0	0	1	0	8	9
OG0009274	0	0	8	0	1	9
OG0009275	0	0	9	0	0	9
OG0009276	0	0	7	0	2	9
OG0009277	0	0	1	0	8	9
OG0009278	0	0	3	0	6	9
OG0009279	0	0	1	0	8	9
OG0009280	0	0	8	0	1	9
OG0009281	0	0	9	0	0	9
OG0009282	0	0	4	0	5	9
OG0009283	0	0	1	8	0	9
OG0009284	0	0	8	0	1	9
OG0009285	0	0	4	0	5	9
OG0009286	0	0	4	0	5	9
OG0009287	0	0	5	0	4	9
OG0009288	0	0	7	0	2	9
OG0009289	0	0	3	0	6	9
OG0009290	0	0	1	7	1	9
OG0009291	0	0	8	0	1	9
OG0009292	0	0	7	0	2	9
OG0009293	0	0	3	1	5	9
OG0009294	0	0	2	0	7	9
OG0009295	0	0	1	1	7	9
OG0009296	0	0	1	0	8	9
OG0009297	0	0	1	0	8	9
OG0009298	0	0	1	0	8	9
OG0009299	0	0	1	7	1	9
OG0009300	0	0	0	9	0	9
OG0009301	0	0	0	9	0	9
OG0009302	0	0	0	9	0	9
OG0009303	0	0	0	9	0	9
OG0009304	0	0	0	9	0	9
OG0009305	0	0	0	9	0	9
OG0009306	0	0	0	9	0	9
OG0009307	0	0	0	9	0	9
OG0009308	0	0	0	9	0	9
OG0009309	0	0	0	8	1	9
OG0009310	0	0	0	0	9	9
OG0009311	0	0	0	0	9	9
OG0009312	0	0	0	0	9	9
OG0009313	0	0	0	0	9	9
OG0009314	0	0	0	0	9	9
OG0009315	0	0	0	0	9	9
OG0009316	0	0	0	0	9	9
OG0009317	0	0	0	0	9	9
OG0009318	0	0	0	0	9	9
OG0009319	0	0	0	0	9	9
OG0009320	0	0	0	0	9	9
OG0009321	0	0	0	0	9	9
OG0009322	0	0	0	0	9	9
OG0009323	0	0	0	0	9	9
OG0009324	0	0	0	0	9	9
OG0009325	0	0	0	0	9	9
OG0009326	0	0	0	0	9	9
OG0009327	3	2	1	1	1	8
OG0009328	8	0	0	0	0	8
OG0009329	8	0	0	0	0	8
OG0009330	2	3	1	1	1	8
OG0009331	4	0	1	2	1	8
OG0009332	1	4	1	1	1	8
OG0009333	2	4	0	1	1	8
OG0009334	1	2	3	1	1	8
OG0009335	4	2	1	1	0	8
OG0009336	8	0	0	0	0	8
OG0009337	2	3	1	1	1	8
OG0009338	2	4	0	1	1	8
OG0009339	4	1	1	1	1	8
OG0009340	1	2	3	1	1	8
OG0009341	2	2	1	2	1	8
OG0009342	8	0	0	0	0	8
OG0009343	3	3	0	1	1	8
OG0009344	8	0	0	0	0	8
OG0009345	2	3	1	1	1	8
OG0009346	2	3	1	1	1	8
OG0009347	2	3	1	1	1	8
OG0009348	2	3	1	1	1	8
OG0009349	2	2	1	1	2	8
OG0009350	1	4	1	1	1	8
OG0009351	4	0	1	1	2	8
OG0009352	8	0	0	0	0	8
OG0009353	8	0	0	0	0	8
OG0009354	1	4	1	1	1	8
OG0009355	4	2	1	1	0	8
OG0009356	2	2	2	1	1	8
OG0009357	2	2	1	1	2	8
OG0009358	8	0	0	0	0	8
OG0009359	2	2	1	1	2	8
OG0009360	2	2	1	2	1	8
OG0009361	8	0	0	0	0	8
OG0009362	2	4	0	1	1	8
OG0009363	2	1	2	2	1	8
OG0009364	8	0	0	0	0	8
OG0009365	8	0	0	0	0	8
OG0009366	3	2	1	1	1	8
OG0009367	4	2	0	2	0	8
OG0009368	4	1	1	1	1	8
OG0009369	2	0	1	3	2	8
OG0009370	4	0	2	0	2	8
OG0009371	3	2	0	2	1	8
OG0009372	8	0	0	0	0	8
OG0009373	8	0	0	0	0	8
OG0009374	2	4	0	1	1	8
OG0009375	2	2	1	2	1	8
OG0009376	2	2	2	1	1	8
OG0009377	8	0	0	0	0	8
OG0009378	4	0	1	2	1	8
OG0009379	2	2	2	1	1	8
OG0009380	2	3	1	1	1	8
OG0009381	2	2	2	1	1	8
OG0009382	2	3	1	1	1	8
OG0009383	4	1	1	1	1	8
OG0009384	2	3	1	1	1	8
OG0009385	6	0	1	0	1	8
OG0009386	4	1	1	1	1	8
OG0009387	4	2	0	1	1	8
OG0009388	3	2	1	1	1	8
OG0009389	2	3	1	1	1	8
OG0009390	8	0	0	0	0	8
OG0009391	3	2	1	1	1	8
OG0009392	2	3	1	1	1	8
OG0009393	4	2	0	1	1	8
OG0009394	2	2	1	1	2	8
OG0009395	2	2	2	1	1	8
OG0009396	3	2	1	1	1	8
OG0009397	3	2	1	1	1	8
OG0009398	3	2	1	1	1	8
OG0009399	3	2	1	1	1	8
OG0009400	3	2	1	1	1	8
OG0009401	4	2	1	1	0	8
OG0009402	3	2	1	1	1	8
OG0009403	3	2	1	1	1	8
OG0009404	2	4	0	1	1	8
OG0009405	3	2	1	2	0	8
OG0009406	2	4	1	0	1	8
OG0009407	8	0	0	0	0	8
OG0009408	5	0	2	1	0	8
OG0009409	2	1	2	1	2	8
OG0009410	3	2	1	1	1	8
OG0009411	3	1	1	1	2	8
OG0009412	3	2	1	1	1	8
OG0009413	2	2	2	1	1	8
OG0009414	4	2	0	1	1	8
OG0009415	1	5	1	1	0	8
OG0009416	2	2	1	2	1	8
OG0009417	1	3	1	2	1	8
OG0009418	3	2	1	1	1	8
OG0009419	3	3	0	1	1	8
OG0009420	2	3	1	1	1	8
OG0009421	4	1	1	1	1	8
OG0009422	3	2	1	1	1	8
OG0009423	2	2	1	1	2	8
OG0009424	2	2	1	2	1	8
OG0009425	2	0	2	1	3	8
OG0009426	2	3	1	1	1	8
OG0009427	2	2	1	2	1	8
OG0009428	3	2	1	1	1	8
OG0009429	4	1	1	1	1	8
OG0009430	4	1	0	2	1	8
OG0009431	8	0	0	0	0	8
OG0009432	1	4	1	1	1	8
OG0009433	2	3	1	1	1	8
OG0009434	2	2	2	1	1	8
OG0009435	2	3	1	1	1	8
OG0009436	3	2	1	1	1	8
OG0009437	2	2	0	1	3	8
OG0009438	2	2	2	1	1	8
OG0009439	2	3	1	1	1	8
OG0009440	2	4	0	1	1	8
OG0009441	4	2	0	1	1	8
OG0009442	2	3	1	1	1	8
OG0009443	2	3	1	1	1	8
OG0009444	4	1	1	1	1	8
OG0009445	8	0	0	0	0	8
OG0009446	2	2	1	1	2	8
OG0009447	2	2	2	1	1	8
OG0009448	2	4	0	1	1	8
OG0009449	3	2	1	1	1	8
OG0009450	3	3	0	1	1	8
OG0009451	2	3	1	1	1	8
OG0009452	2	2	1	2	1	8
OG0009453	2	3	1	1	1	8
OG0009454	4	0	1	1	2	8
OG0009455	2	2	2	1	1	8
OG0009456	3	2	1	1	1	8
OG0009457	2	2	1	2	1	8
OG0009458	3	2	1	1	1	8
OG0009459	2	2	1	2	1	8
OG0009460	2	3	1	1	1	8
OG0009461	2	3	1	1	1	8
OG0009462	3	1	1	2	1	8
OG0009463	4	0	1	2	1	8
OG0009464	2	2	1	1	2	8
OG0009465	2	3	1	1	1	8
OG0009466	6	1	0	1	0	8
OG0009467	2	0	4	0	2	8
OG0009468	4	1	1	1	1	8
OG0009469	2	2	1	2	1	8
OG0009470	2	2	2	1	1	8
OG0009471	2	4	1	1	0	8
OG0009472	4	2	0	1	1	8
OG0009473	2	2	2	1	1	8
OG0009474	2	3	1	1	1	8
OG0009475	8	0	0	0	0	8
OG0009476	3	2	1	1	1	8
OG0009477	3	0	4	0	1	8
OG0009478	8	0	0	0	0	8
OG0009479	8	0	0	0	0	8
OG0009480	4	0	1	0	3	8
OG0009481	1	1	5	0	1	8
OG0009482	4	0	4	0	0	8
OG0009483	3	1	4	0	0	8
OG0009484	3	2	2	0	1	8
OG0009485	3	2	1	1	1	8
OG0009486	2	2	2	1	1	8
OG0009487	8	0	0	0	0	8
OG0009488	3	2	1	1	1	8
OG0009489	2	3	1	1	1	8
OG0009490	2	4	0	1	1	8
OG0009491	2	3	1	1	1	8
OG0009492	8	0	0	0	0	8
OG0009493	4	1	1	1	1	8
OG0009494	1	6	0	1	0	8
OG0009495	2	1	2	1	2	8
OG0009496	2	4	0	1	1	8
OG0009497	2	4	1	1	0	8
OG0009498	8	0	0	0	0	8
OG0009499	2	2	2	1	1	8
OG0009500	2	3	1	1	1	8
OG0009501	2	3	1	1	1	8
OG0009502	3	2	1	1	1	8
OG0009503	7	0	1	0	0	8
OG0009504	3	0	1	3	1	8
OG0009505	4	2	0	1	1	8
OG0009506	3	2	1	1	1	8
OG0009507	2	2	2	1	1	8
OG0009508	2	2	2	1	1	8
OG0009509	2	3	1	1	1	8
OG0009510	2	3	1	1	1	8
OG0009511	8	0	0	0	0	8
OG0009512	2	4	0	1	1	8
OG0009513	2	3	1	1	1	8
OG0009514	2	1	2	1	2	8
OG0009515	2	2	1	2	1	8
OG0009516	2	3	1	1	1	8
OG0009517	2	2	1	2	1	8
OG0009518	8	0	0	0	0	8
OG0009519	8	0	0	0	0	8
OG0009520	2	3	1	1	1	8
OG0009521	2	2	1	1	2	8
OG0009522	3	2	1	1	1	8
OG0009523	1	2	1	2	2	8
OG0009524	3	2	1	1	1	8
OG0009525	4	0	1	2	1	8
OG0009526	3	2	1	1	1	8
OG0009527	4	2	0	2	0	8
OG0009528	3	2	1	1	1	8
OG0009529	2	3	1	1	1	8
OG0009530	2	2	2	1	1	8
OG0009531	2	4	0	1	1	8
OG0009532	2	3	1	1	1	8
OG0009533	3	3	0	1	1	8
OG0009534	3	2	1	1	1	8
OG0009535	3	2	1	1	1	8
OG0009536	2	3	1	1	1	8
OG0009537	8	0	0	0	0	8
OG0009538	4	2	0	1	1	8
OG0009539	1	2	2	1	2	8
OG0009540	3	2	1	1	1	8
OG0009541	2	3	1	1	1	8
OG0009542	2	0	2	4	0	8
OG0009543	2	0	2	1	3	8
OG0009544	2	2	2	1	1	8
OG0009545	2	3	0	1	2	8
OG0009546	3	1	2	1	1	8
OG0009547	2	4	0	1	1	8
OG0009548	3	2	1	1	1	8
OG0009549	4	1	1	1	1	8
OG0009550	2	1	1	2	2	8
OG0009551	2	4	0	1	1	8
OG0009552	2	4	0	1	1	8
OG0009553	4	2	0	1	1	8
OG0009554	2	4	0	1	1	8
OG0009555	3	2	1	1	1	8
OG0009556	8	0	0	0	0	8
OG0009557	2	2	1	2	1	8
OG0009558	2	3	1	1	1	8
OG0009559	2	3	1	1	1	8
OG0009560	3	2	1	1	1	8
OG0009561	2	2	2	1	1	8
OG0009562	4	2	1	1	0	8
OG0009563	2	2	2	1	1	8
OG0009564	2	2	1	1	2	8
OG0009565	2	2	1	2	1	8
OG0009566	2	4	0	1	1	8
OG0009567	2	2	2	1	1	8
OG0009568	3	2	1	1	1	8
OG0009569	3	2	1	1	1	8
OG0009570	2	3	1	1	1	8
OG0009571	2	2	1	1	2	8
OG0009572	4	0	1	2	1	8
OG0009573	2	2	1	1	2	8
OG0009574	3	2	1	1	1	8
OG0009575	2	2	1	1	2	8
OG0009576	3	2	1	1	1	8
OG0009577	2	4	0	1	1	8
OG0009578	8	0	0	0	0	8
OG0009579	3	2	1	1	1	8
OG0009580	8	0	0	0	0	8
OG0009581	8	0	0	0	0	8
OG0009582	2	0	1	2	3	8
OG0009583	2	2	1	1	2	8
OG0009584	2	3	1	1	1	8
OG0009585	8	0	0	0	0	8
OG0009586	2	2	2	1	1	8
OG0009587	3	2	0	1	2	8
OG0009588	1	2	1	2	2	8
OG0009589	2	3	1	1	1	8
OG0009590	8	0	0	0	0	8
OG0009591	2	2	2	1	1	8
OG0009592	3	1	2	1	1	8
OG0009593	2	3	1	1	1	8
OG0009594	3	2	1	1	1	8
OG0009595	2	2	2	1	1	8
OG0009596	3	2	1	1	1	8
OG0009597	2	2	1	2	1	8
OG0009598	2	3	1	1	1	8
OG0009599	2	3	1	1	1	8
OG0009600	2	4	1	1	0	8
OG0009601	2	2	2	1	1	8
OG0009602	2	2	1	1	2	8
OG0009603	2	2	1	1	2	8
OG0009604	5	1	0	1	1	8
OG0009605	3	2	1	1	1	8
OG0009606	2	3	1	1	1	8
OG0009607	3	2	1	1	1	8
OG0009608	2	3	1	1	1	8
OG0009609	2	3	1	1	1	8
OG0009610	3	2	1	1	1	8
OG0009611	2	3	1	1	1	8
OG0009612	2	4	1	1	0	8
OG0009613	2	3	1	1	1	8
OG0009614	5	0	1	1	1	8
OG0009615	2	4	0	1	1	8
OG0009616	2	2	1	2	1	8
OG0009617	2	2	2	1	1	8
OG0009618	2	3	1	1	1	8
OG0009619	2	3	1	1	1	8
OG0009620	2	3	1	1	1	8
OG0009621	8	0	0	0	0	8
OG0009622	2	4	0	1	1	8
OG0009623	4	2	1	0	1	8
OG0009624	3	2	1	1	1	8
OG0009625	3	2	1	1	1	8
OG0009626	8	0	0	0	0	8
OG0009627	3	3	0	1	1	8
OG0009628	8	0	0	0	0	8
OG0009629	2	2	2	1	1	8
OG0009630	2	2	1	1	2	8
OG0009631	2	3	1	1	1	8
OG0009632	1	0	7	0	0	8
OG0009633	2	2	0	1	3	8
OG0009634	2	2	2	1	1	8
OG0009635	8	0	0	0	0	8
OG0009636	3	2	1	1	1	8
OG0009637	3	1	1	2	1	8
OG0009638	2	3	1	1	1	8
OG0009639	2	3	1	2	0	8
OG0009640	2	3	1	1	1	8
OG0009641	2	4	0	1	1	8
OG0009642	4	2	1	0	1	8
OG0009643	3	2	1	1	1	8
OG0009644	2	2	1	1	2	8
OG0009645	2	2	1	2	1	8
OG0009646	2	3	1	1	1	8
OG0009647	3	3	1	1	0	8
OG0009648	5	0	1	1	1	8
OG0009649	2	3	1	1	1	8
OG0009650	3	2	1	1	1	8
OG0009651	1	4	1	1	1	8
OG0009652	3	2	1	1	1	8
OG0009653	2	3	1	1	1	8
OG0009654	3	1	1	1	2	8
OG0009655	2	3	1	1	1	8
OG0009656	4	2	0	1	1	8
OG0009657	4	1	1	1	1	8
OG0009658	4	0	1	2	1	8
OG0009659	3	3	0	1	1	8
OG0009660	4	0	1	3	0	8
OG0009661	2	2	2	1	1	8
OG0009662	2	3	1	1	1	8
OG0009663	2	2	1	1	2	8
OG0009664	4	2	0	1	1	8
OG0009665	2	1	4	0	1	8
OG0009666	3	2	1	1	1	8
OG0009667	1	4	1	1	1	8
OG0009668	6	2	0	0	0	8
OG0009669	3	2	1	1	1	8
OG0009670	2	3	1	1	1	8
OG0009671	4	2	0	1	1	8
OG0009672	2	2	2	1	1	8
OG0009673	1	2	2	1	2	8
OG0009674	2	3	1	1	1	8
OG0009675	2	3	1	1	1	8
OG0009676	2	3	1	1	1	8
OG0009677	3	3	0	1	1	8
OG0009678	3	2	1	1	1	8
OG0009679	1	2	2	1	2	8
OG0009680	2	3	1	1	1	8
OG0009681	3	2	1	1	1	8
OG0009682	3	2	1	1	1	8
OG0009683	2	2	1	3	0	8
OG0009684	4	2	0	1	1	8
OG0009685	8	0	0	0	0	8
OG0009686	2	1	2	2	1	8
OG0009687	3	2	1	1	1	8
OG0009688	2	2	0	4	0	8
OG0009689	2	3	1	1	1	8
OG0009690	4	2	0	2	0	8
OG0009691	3	2	1	1	1	8
OG0009692	2	2	1	2	1	8
OG0009693	2	3	1	1	1	8
OG0009694	2	2	2	0	2	8
OG0009695	4	3	0	1	0	8
OG0009696	2	3	1	1	1	8
OG0009697	5	2	1	0	0	8
OG0009698	3	2	1	1	1	8
OG0009699	2	3	1	1	1	8
OG0009700	2	3	1	1	1	8
OG0009701	3	2	1	1	1	8
OG0009702	2	4	0	1	1	8
OG0009703	4	1	1	1	1	8
OG0009704	8	0	0	0	0	8
OG0009705	2	3	1	1	1	8
OG0009706	2	3	1	1	1	8
OG0009707	2	2	2	1	1	8
OG0009708	2	2	1	2	1	8
OG0009709	2	1	2	2	1	8
OG0009710	2	3	1	1	1	8
OG0009711	2	2	1	1	2	8
OG0009712	1	3	1	2	1	8
OG0009713	3	2	1	1	1	8
OG0009714	6	2	0	0	0	8
OG0009715	2	3	1	1	1	8
OG0009716	3	0	2	1	2	8
OG0009717	3	2	1	1	1	8
OG0009718	3	2	1	1	1	8
OG0009719	2	3	0	2	1	8
OG0009720	2	2	1	2	1	8
OG0009721	3	2	1	1	1	8
OG0009722	8	0	0	0	0	8
OG0009723	5	0	1	1	1	8
OG0009724	7	1	0	0	0	8
OG0009725	3	0	2	1	2	8
OG0009726	4	1	1	1	1	8
OG0009727	6	0	0	0	2	8
OG0009728	3	2	1	1	1	8
OG0009729	8	0	0	0	0	8
OG0009730	2	3	0	1	2	8
OG0009731	5	0	1	1	1	8
OG0009732	8	0	0	0	0	8
OG0009733	2	3	1	1	1	8
OG0009734	2	2	1	2	1	8
OG0009735	2	2	1	2	1	8
OG0009736	2	2	2	1	1	8
OG0009737	2	3	1	1	1	8
OG0009738	3	2	1	1	1	8
OG0009739	2	2	2	1	1	8
OG0009740	2	3	1	1	1	8
OG0009741	4	2	0	1	1	8
OG0009742	2	2	1	1	2	8
OG0009743	2	4	0	1	1	8
OG0009744	2	3	1	1	1	8
OG0009745	3	2	1	1	1	8
OG0009746	2	3	1	1	1	8
OG0009747	2	3	1	1	1	8
OG0009748	1	4	1	1	1	8
OG0009749	2	3	1	1	1	8
OG0009750	2	6	0	0	0	8
OG0009751	1	2	2	1	2	8
OG0009752	3	1	2	1	1	8
OG0009753	4	1	1	1	1	8
OG0009754	2	3	1	1	1	8
OG0009755	2	3	1	1	1	8
OG0009756	2	3	1	1	1	8
OG0009757	3	2	1	1	1	8
OG0009758	2	3	1	1	1	8
OG0009759	2	3	1	1	1	8
OG0009760	2	2	2	1	1	8
OG0009761	2	2	1	2	1	8
OG0009762	2	2	2	1	1	8
OG0009763	3	2	1	1	1	8
OG0009764	2	1	3	1	1	8
OG0009765	2	0	1	4	1	8
OG0009766	2	0	3	1	2	8
OG0009767	5	0	1	1	1	8
OG0009768	2	3	1	1	1	8
OG0009769	2	4	1	0	1	8
OG0009770	3	2	1	1	1	8
OG0009771	3	5	0	0	0	8
OG0009772	2	3	1	1	1	8
OG0009773	2	0	1	0	5	8
OG0009774	2	2	1	1	2	8
OG0009775	2	3	1	1	1	8
OG0009776	2	2	1	1	2	8
OG0009777	2	3	1	1	1	8
OG0009778	2	4	0	2	0	8
OG0009779	8	0	0	0	0	8
OG0009780	3	2	1	1	1	8
OG0009781	8	0	0	0	0	8
OG0009782	2	4	0	1	1	8
OG0009783	2	2	1	1	2	8
OG0009784	1	4	1	1	1	8
OG0009785	2	2	1	2	1	8
OG0009786	1	4	1	1	1	8
OG0009787	2	3	1	1	1	8
OG0009788	2	3	1	1	1	8
OG0009789	3	2	1	1	1	8
OG0009790	2	4	0	1	1	8
OG0009791	2	2	1	2	1	8
OG0009792	2	0	6	0	0	8
OG0009793	2	0	1	3	2	8
OG0009794	2	5	0	1	0	8
OG0009795	4	2	0	1	1	8
OG0009796	2	3	1	1	1	8
OG0009797	4	2	1	1	0	8
OG0009798	2	3	1	1	1	8
OG0009799	4	2	0	1	1	8
OG0009800	2	2	2	1	1	8
OG0009801	2	2	2	1	1	8
OG0009802	3	2	1	1	1	8
OG0009803	2	2	1	2	1	8
OG0009804	3	2	1	1	1	8
OG0009805	2	2	2	1	1	8
OG0009806	3	2	1	1	1	8
OG0009807	2	3	1	1	1	8
OG0009808	2	3	1	1	1	8
OG0009809	2	3	1	1	1	8
OG0009810	2	3	1	1	1	8
OG0009811	2	3	1	1	1	8
OG0009812	7	0	0	1	0	8
OG0009813	1	3	1	2	1	8
OG0009814	7	0	1	0	0	8
OG0009815	2	4	0	1	1	8
OG0009816	2	3	1	1	1	8
OG0009817	2	2	1	2	1	8
OG0009818	2	2	1	2	1	8
OG0009819	2	2	2	0	2	8
OG0009820	2	2	1	2	1	8
OG0009821	2	1	2	1	2	8
OG0009822	3	2	1	1	1	8
OG0009823	3	2	1	1	1	8
OG0009824	3	2	1	1	1	8
OG0009825	2	1	2	1	2	8
OG0009826	1	4	1	1	1	8
OG0009827	2	2	1	2	1	8
OG0009828	3	2	1	1	1	8
OG0009829	4	0	2	1	1	8
OG0009830	8	0	0	0	0	8
OG0009831	2	2	1	1	2	8
OG0009832	2	2	2	1	1	8
OG0009833	4	1	1	1	1	8
OG0009834	2	2	1	1	2	8
OG0009835	3	2	1	1	1	8
OG0009836	3	2	1	1	1	8
OG0009837	2	4	1	1	0	8
OG0009838	4	2	0	1	1	8
OG0009839	2	3	1	1	1	8
OG0009840	2	3	1	1	1	8
OG0009841	1	5	1	1	0	8
OG0009842	2	2	1	2	1	8
OG0009843	2	0	2	1	3	8
OG0009844	4	1	1	1	1	8
OG0009845	2	2	1	2	1	8
OG0009846	2	2	1	2	1	8
OG0009847	2	4	0	1	1	8
OG0009848	2	3	1	1	1	8
OG0009849	2	2	1	2	1	8
OG0009850	2	2	1	2	1	8
OG0009851	1	4	0	2	1	8
OG0009852	2	2	2	1	1	8
OG0009853	2	3	1	1	1	8
OG0009854	2	2	2	1	1	8
OG0009855	2	3	1	1	1	8
OG0009856	3	2	1	1	1	8
OG0009857	3	2	1	1	1	8
OG0009858	8	0	0	0	0	8
OG0009859	2	3	1	1	1	8
OG0009860	2	3	1	1	1	8
OG0009861	2	0	2	2	2	8
OG0009862	2	2	2	1	1	8
OG0009863	8	0	0	0	0	8
OG0009864	2	3	1	1	1	8
OG0009865	2	4	1	1	0	8
OG0009866	2	3	1	1	1	8
OG0009867	2	3	1	1	1	8
OG0009868	2	3	1	0	2	8
OG0009869	2	3	1	1	1	8
OG0009870	2	2	1	2	1	8
OG0009871	3	2	1	1	1	8
OG0009872	3	2	1	1	1	8
OG0009873	2	3	1	1	1	8
OG0009874	2	3	1	1	1	8
OG0009875	5	0	1	1	1	8
OG0009876	4	0	1	1	2	8
OG0009877	3	3	0	1	1	8
OG0009878	2	3	1	1	1	8
OG0009879	2	2	2	1	1	8
OG0009880	5	0	1	1	1	8
OG0009881	2	2	1	2	1	8
OG0009882	4	2	0	1	1	8
OG0009883	2	3	1	1	1	8
OG0009884	4	1	1	1	1	8
OG0009885	3	2	1	1	1	8
OG0009886	2	2	0	1	3	8
OG0009887	3	2	1	1	1	8
OG0009888	2	3	1	1	1	8
OG0009889	2	2	2	1	1	8
OG0009890	2	4	1	1	0	8
OG0009891	2	2	3	1	0	8
OG0009892	2	2	2	1	1	8
OG0009893	2	2	1	1	2	8
OG0009894	2	2	2	1	1	8
OG0009895	2	4	0	1	1	8
OG0009896	1	4	1	1	1	8
OG0009897	3	2	1	1	1	8
OG0009898	2	3	0	2	1	8
OG0009899	2	0	3	1	2	8
OG0009900	2	3	1	1	1	8
OG0009901	2	3	1	1	1	8
OG0009902	2	2	1	2	1	8
OG0009903	2	3	1	1	1	8
OG0009904	4	2	0	1	1	8
OG0009905	2	2	2	1	1	8
OG0009906	3	2	1	1	1	8
OG0009907	2	2	1	1	2	8
OG0009908	2	0	2	1	3	8
OG0009909	4	0	2	1	1	8
OG0009910	2	3	1	1	1	8
OG0009911	1	3	2	1	1	8
OG0009912	2	2	2	1	1	8
OG0009913	2	2	1	1	2	8
OG0009914	4	2	0	1	1	8
OG0009915	3	1	1	1	2	8
OG0009916	2	3	1	1	1	8
OG0009917	2	2	1	1	2	8
OG0009918	2	3	1	1	1	8
OG0009919	2	4	0	1	1	8
OG0009920	4	3	0	1	0	8
OG0009921	1	2	2	1	2	8
OG0009922	3	2	1	1	1	8
OG0009923	2	3	1	1	1	8
OG0009924	2	3	1	1	1	8
OG0009925	2	4	0	1	1	8
OG0009926	2	3	1	1	1	8
OG0009927	2	3	1	1	1	8
OG0009928	2	4	0	1	1	8
OG0009929	2	2	1	1	2	8
OG0009930	2	3	1	1	1	8
OG0009931	2	3	1	1	1	8
OG0009932	2	3	1	1	1	8
OG0009933	4	0	1	2	1	8
OG0009934	1	2	1	2	2	8
OG0009935	3	2	1	1	1	8
OG0009936	2	2	2	1	1	8
OG0009937	7	0	1	0	0	8
OG0009938	2	2	1	2	1	8
OG0009939	2	2	2	1	1	8
OG0009940	2	2	1	2	1	8
OG0009941	3	2	1	1	1	8
OG0009942	8	0	0	0	0	8
OG0009943	2	2	1	1	2	8
OG0009944	3	2	1	1	1	8
OG0009945	2	3	1	1	1	8
OG0009946	3	2	1	1	1	8
OG0009947	2	2	1	2	1	8
OG0009948	2	4	0	1	1	8
OG0009949	1	6	0	1	0	8
OG0009950	2	3	1	1	1	8
OG0009951	4	1	1	1	1	8
OG0009952	2	4	0	1	1	8
OG0009953	4	1	1	1	1	8
OG0009954	2	2	2	1	1	8
OG0009955	2	2	2	1	1	8
OG0009956	2	2	1	1	2	8
OG0009957	3	2	1	1	1	8
OG0009958	3	2	1	1	1	8
OG0009959	2	0	2	1	3	8
OG0009960	3	2	1	1	1	8
OG0009961	2	2	1	2	1	8
OG0009962	3	2	1	1	1	8
OG0009963	3	1	1	1	2	8
OG0009964	2	2	2	1	1	8
OG0009965	3	2	1	1	1	8
OG0009966	3	2	1	2	0	8
OG0009967	8	0	0	0	0	8
OG0009968	2	2	1	1	2	8
OG0009969	3	2	1	1	1	8
OG0009970	2	3	1	1	1	8
OG0009971	2	0	2	3	1	8
OG0009972	2	2	1	1	2	8
OG0009973	4	1	1	1	1	8
OG0009974	2	3	1	1	1	8
OG0009975	2	5	0	1	0	8
OG0009976	2	3	1	1	1	8
OG0009977	8	0	0	0	0	8
OG0009978	2	2	2	1	1	8
OG0009979	2	3	1	1	1	8
OG0009980	1	4	1	1	1	8
OG0009981	2	3	1	1	1	8
OG0009982	1	2	2	1	2	8
OG0009983	2	4	0	1	1	8
OG0009984	2	3	1	1	1	8
OG0009985	4	2	0	1	1	8
OG0009986	2	3	1	1	1	8
OG0009987	2	2	1	1	2	8
OG0009988	2	3	1	1	1	8
OG0009989	4	0	2	1	1	8
OG0009990	2	2	2	1	1	8
OG0009991	2	3	1	1	1	8
OG0009992	4	0	1	2	1	8
OG0009993	2	3	1	1	1	8
OG0009994	2	4	0	1	1	8
OG0009995	2	4	0	1	1	8
OG0009996	2	3	1	1	1	8
OG0009997	2	2	1	1	2	8
OG0009998	2	3	1	1	1	8
OG0009999	2	2	2	1	1	8
OG0010000	4	0	2	1	1	8
OG0010001	1	4	1	1	1	8
OG0010002	2	2	1	1	2	8
OG0010003	2	2	2	1	1	8
OG0010004	3	1	2	1	1	8
OG0010005	3	2	1	1	1	8
OG0010006	2	2	1	2	1	8
OG0010007	2	4	1	1	0	8
OG0010008	2	3	1	1	1	8
OG0010009	2	4	0	1	1	8
OG0010010	4	0	1	1	2	8
OG0010011	3	2	1	1	1	8
OG0010012	2	2	1	1	2	8
OG0010013	5	2	0	1	0	8
OG0010014	2	2	1	2	1	8
OG0010015	4	0	2	1	1	8
OG0010016	2	2	1	1	2	8
OG0010017	2	2	1	2	1	8
OG0010018	4	0	2	1	1	8
OG0010019	4	2	1	1	0	8
OG0010020	1	4	1	1	1	8
OG0010021	2	4	1	1	0	8
OG0010022	2	3	1	1	1	8
OG0010023	2	1	1	2	2	8
OG0010024	2	3	1	1	1	8
OG0010025	4	0	1	2	1	8
OG0010026	2	2	1	2	1	8
OG0010027	2	2	1	2	1	8
OG0010028	2	3	1	1	1	8
OG0010029	8	0	0	0	0	8
OG0010030	3	2	1	1	1	8
OG0010031	3	2	1	1	1	8
OG0010032	2	6	0	0	0	8
OG0010033	3	2	1	1	1	8
OG0010034	1	5	0	1	1	8
OG0010035	3	3	0	1	1	8
OG0010036	3	0	2	1	2	8
OG0010037	4	1	1	1	1	8
OG0010038	2	0	1	1	4	8
OG0010039	1	4	1	1	1	8
OG0010040	2	3	1	1	1	8
OG0010041	2	2	2	1	1	8
OG0010042	1	0	7	0	0	8
OG0010043	2	3	1	1	1	8
OG0010044	2	4	0	1	1	8
OG0010045	4	0	1	1	2	8
OG0010046	1	4	0	2	1	8
OG0010047	8	0	0	0	0	8
OG0010048	3	2	1	1	1	8
OG0010049	2	2	1	1	2	8
OG0010050	2	3	1	1	1	8
OG0010051	1	2	4	0	1	8
OG0010052	2	3	1	1	1	8
OG0010053	2	2	2	1	1	8
OG0010054	2	3	1	1	1	8
OG0010055	2	4	2	0	0	8
OG0010056	2	3	1	1	1	8
OG0010057	2	4	1	1	0	8
OG0010058	5	2	0	1	0	8
OG0010059	2	4	0	1	1	8
OG0010060	4	0	1	2	1	8
OG0010061	4	0	1	2	1	8
OG0010062	2	2	1	1	2	8
OG0010063	2	2	2	1	1	8
OG0010064	3	1	2	1	1	8
OG0010065	3	2	1	1	1	8
OG0010066	2	3	1	1	1	8
OG0010067	2	2	2	1	1	8
OG0010068	8	0	0	0	0	8
OG0010069	2	3	1	1	1	8
OG0010070	2	3	1	1	1	8
OG0010071	4	2	1	1	0	8
OG0010072	3	2	1	1	1	8
OG0010073	3	2	1	1	1	8
OG0010074	3	2	1	1	1	8
OG0010075	2	4	1	0	1	8
OG0010076	3	1	1	2	1	8
OG0010077	2	3	1	1	1	8
OG0010078	2	3	1	1	1	8
OG0010079	1	5	1	1	0	8
OG0010080	2	2	2	1	1	8
OG0010081	2	2	2	1	1	8
OG0010082	2	4	0	1	1	8
OG0010083	4	0	1	1	2	8
OG0010084	2	2	1	1	2	8
OG0010085	2	3	1	1	1	8
OG0010086	2	0	2	1	3	8
OG0010087	3	2	1	1	1	8
OG0010088	2	2	1	1	2	8
OG0010089	4	2	0	1	1	8
OG0010090	5	0	1	1	1	8
OG0010091	4	1	1	1	1	8
OG0010092	2	3	1	1	1	8
OG0010093	8	0	0	0	0	8
OG0010094	2	2	1	1	2	8
OG0010095	2	3	1	1	1	8
OG0010096	2	4	0	1	1	8
OG0010097	3	2	1	1	1	8
OG0010098	2	2	2	1	1	8
OG0010099	2	2	1	2	1	8
OG0010100	2	2	1	1	2	8
OG0010101	2	3	1	1	1	8
OG0010102	2	2	2	1	1	8
OG0010103	2	3	1	1	1	8
OG0010104	3	2	1	1	1	8
OG0010105	1	4	1	1	1	8
OG0010106	2	1	2	1	2	8
OG0010107	2	0	3	1	2	8
OG0010108	2	2	1	2	1	8
OG0010109	2	3	1	1	1	8
OG0010110	2	3	1	1	1	8
OG0010111	2	3	1	1	1	8
OG0010112	3	2	1	1	1	8
OG0010113	8	0	0	0	0	8
OG0010114	2	2	2	1	1	8
OG0010115	3	2	1	1	1	8
OG0010116	2	1	2	1	2	8
OG0010117	1	3	1	1	2	8
OG0010118	2	2	2	1	1	8
OG0010119	2	3	1	1	1	8
OG0010120	2	3	1	1	1	8
OG0010121	2	0	4	1	1	8
OG0010122	2	2	1	2	1	8
OG0010123	1	3	1	2	1	8
OG0010124	2	1	1	2	2	8
OG0010125	4	0	1	1	2	8
OG0010126	3	1	4	0	0	8
OG0010127	2	4	1	0	1	8
OG0010128	2	3	1	1	1	8
OG0010129	2	2	1	1	2	8
OG0010130	2	1	1	3	1	8
OG0010131	2	2	1	1	2	8
OG0010132	3	2	1	1	1	8
OG0010133	2	3	1	1	1	8
OG0010134	8	0	0	0	0	8
OG0010135	2	0	2	2	2	8
OG0010136	5	0	2	0	1	8
OG0010137	4	2	0	1	1	8
OG0010138	4	2	0	1	1	8
OG0010139	2	3	1	1	1	8
OG0010140	2	2	2	1	1	8
OG0010141	2	3	1	1	1	8
OG0010142	2	2	0	4	0	8
OG0010143	2	4	0	1	1	8
OG0010144	1	5	0	1	1	8
OG0010145	2	3	1	1	1	8
OG0010146	2	2	1	1	2	8
OG0010147	2	4	0	2	0	8
OG0010148	2	2	1	2	1	8
OG0010149	2	2	1	1	2	8
OG0010150	3	2	1	1	1	8
OG0010151	2	2	1	2	1	8
OG0010152	2	2	1	2	1	8
OG0010153	2	3	1	1	1	8
OG0010154	3	2	1	1	1	8
OG0010155	2	3	1	1	1	8
OG0010156	2	4	0	1	1	8
OG0010157	2	3	1	1	1	8
OG0010158	2	2	1	1	2	8
OG0010159	2	3	1	1	1	8
OG0010160	2	3	1	1	1	8
OG0010161	3	2	1	1	1	8
OG0010162	2	2	2	1	1	8
OG0010163	2	4	0	1	1	8
OG0010164	1	4	1	1	1	8
OG0010165	2	2	1	2	1	8
OG0010166	3	2	1	1	1	8
OG0010167	2	4	0	1	1	8
OG0010168	2	4	0	1	1	8
OG0010169	2	4	1	0	1	8
OG0010170	2	2	1	1	2	8
OG0010171	4	1	1	1	1	8
OG0010172	1	4	1	1	1	8
OG0010173	2	3	1	1	1	8
OG0010174	2	2	1	1	2	8
OG0010175	2	2	1	1	2	8
OG0010176	2	3	1	1	1	8
OG0010177	2	2	1	1	2	8
OG0010178	8	0	0	0	0	8
OG0010179	8	0	0	0	0	8
OG0010180	1	4	1	1	1	8
OG0010181	3	3	0	1	1	8
OG0010182	8	0	0	0	0	8
OG0010183	2	2	2	1	1	8
OG0010184	3	2	1	1	1	8
OG0010185	8	0	0	0	0	8
OG0010186	2	0	6	0	0	8
OG0010187	2	2	2	1	1	8
OG0010188	2	3	0	2	1	8
OG0010189	3	2	1	1	1	8
OG0010190	2	3	1	1	1	8
OG0010191	4	2	0	1	1	8
OG0010192	2	3	1	1	1	8
OG0010193	3	2	1	1	1	8
OG0010194	2	2	1	1	2	8
OG0010195	2	3	1	1	1	8
OG0010196	2	2	2	1	1	8
OG0010197	2	3	1	1	1	8
OG0010198	5	1	0	1	1	8
OG0010199	2	3	1	1	1	8
OG0010200	8	0	0	0	0	8
OG0010201	2	3	1	1	1	8
OG0010202	2	3	1	1	1	8
OG0010203	8	0	0	0	0	8
OG0010204	5	0	1	1	1	8
OG0010205	2	2	1	1	2	8
OG0010206	4	2	1	1	0	8
OG0010207	2	4	1	1	0	8
OG0010208	2	3	1	1	1	8
OG0010209	2	4	0	1	1	8
OG0010210	1	5	0	1	1	8
OG0010211	3	2	1	1	1	8
OG0010212	8	0	0	0	0	8
OG0010213	2	3	1	1	1	8
OG0010214	2	2	2	1	1	8
OG0010215	2	4	1	1	0	8
OG0010216	2	2	1	2	1	8
OG0010217	2	2	1	2	1	8
OG0010218	2	2	1	1	2	8
OG0010219	3	0	3	1	1	8
OG0010220	2	2	1	2	1	8
OG0010221	2	3	1	1	1	8
OG0010222	2	3	1	1	1	8
OG0010223	2	4	0	1	1	8
OG0010224	2	2	2	1	1	8
OG0010225	2	3	1	1	1	8
OG0010226	2	3	1	1	1	8
OG0010227	2	2	1	1	2	8
OG0010228	4	2	0	1	1	8
OG0010229	8	0	0	0	0	8
OG0010230	3	2	1	1	1	8
OG0010231	2	0	1	4	1	8
OG0010232	2	3	1	1	1	8
OG0010233	2	4	0	1	1	8
OG0010234	2	4	1	1	0	8
OG0010235	3	2	1	1	1	8
OG0010236	3	2	1	1	1	8
OG0010237	3	3	0	1	1	8
OG0010238	2	2	1	1	2	8
OG0010239	2	3	1	1	1	8
OG0010240	2	2	1	1	2	8
OG0010241	2	3	1	1	1	8
OG0010242	2	2	2	1	1	8
OG0010243	2	1	2	1	2	8
OG0010244	2	2	2	1	1	8
OG0010245	2	3	1	1	1	8
OG0010246	2	0	3	1	2	8
OG0010247	2	2	2	1	1	8
OG0010248	3	2	1	1	1	8
OG0010249	3	1	1	0	3	8
OG0010250	2	2	1	1	2	8
OG0010251	4	2	0	1	1	8
OG0010252	2	3	1	1	1	8
OG0010253	2	1	2	1	2	8
OG0010254	2	4	0	1	1	8
OG0010255	4	2	1	1	0	8
OG0010256	2	3	1	1	1	8
OG0010257	2	0	2	2	2	8
OG0010258	2	2	2	1	1	8
OG0010259	2	3	1	1	1	8
OG0010260	2	3	0	1	2	8
OG0010261	3	2	1	1	1	8
OG0010262	1	0	2	1	4	8
OG0010263	2	0	1	4	1	8
OG0010264	2	3	1	1	1	8
OG0010265	4	2	0	1	1	8
OG0010266	2	3	1	1	1	8
OG0010267	2	3	1	1	1	8
OG0010268	3	2	1	1	1	8
OG0010269	2	2	1	1	2	8
OG0010270	2	3	1	1	1	8
OG0010271	2	3	1	1	1	8
OG0010272	2	2	1	1	2	8
OG0010273	1	3	1	1	2	8
OG0010274	2	0	3	1	2	8
OG0010275	3	2	1	1	1	8
OG0010276	3	2	1	1	1	8
OG0010277	2	3	1	1	1	8
OG0010278	2	0	2	1	3	8
OG0010279	3	2	1	1	1	8
OG0010280	2	2	1	1	2	8
OG0010281	2	0	3	1	2	8
OG0010282	1	4	1	1	1	8
OG0010283	2	4	0	1	1	8
OG0010284	2	4	0	1	1	8
OG0010285	2	2	1	1	2	8
OG0010286	1	4	1	1	1	8
OG0010287	2	1	1	1	3	8
OG0010288	2	3	1	1	1	8
OG0010289	2	3	1	1	1	8
OG0010290	2	2	2	1	1	8
OG0010291	2	3	1	1	1	8
OG0010292	2	3	2	1	0	8
OG0010293	3	2	1	1	1	8
OG0010294	3	1	0	3	1	8
OG0010295	2	3	1	1	1	8
OG0010296	2	2	1	2	1	8
OG0010297	2	3	1	1	1	8
OG0010298	2	3	1	1	1	8
OG0010299	3	2	1	2	0	8
OG0010300	2	3	1	1	1	8
OG0010301	2	3	1	1	1	8
OG0010302	2	3	1	1	1	8
OG0010303	2	2	1	2	1	8
OG0010304	2	4	1	1	0	8
OG0010305	2	3	1	1	1	8
OG0010306	1	4	1	1	1	8
OG0010307	3	2	1	1	1	8
OG0010308	2	3	1	1	1	8
OG0010309	2	3	1	1	1	8
OG0010310	2	3	1	1	1	8
OG0010311	2	4	1	1	0	8
OG0010312	2	0	2	2	2	8
OG0010313	2	2	2	1	1	8
OG0010314	2	3	1	1	1	8
OG0010315	2	2	1	1	2	8
OG0010316	2	3	1	1	1	8
OG0010317	3	2	1	1	1	8
OG0010318	2	2	1	1	2	8
OG0010319	2	3	1	1	1	8
OG0010320	4	0	2	1	1	8
OG0010321	2	3	1	1	1	8
OG0010322	2	2	1	2	1	8
OG0010323	2	3	1	1	1	8
OG0010324	2	2	1	2	1	8
OG0010325	1	4	1	1	1	8
OG0010326	3	5	0	0	0	8
OG0010327	1	2	2	1	2	8
OG0010328	3	1	1	1	2	8
OG0010329	1	0	3	1	3	8
OG0010330	3	0	3	1	1	8
OG0010331	2	2	2	1	1	8
OG0010332	2	3	1	1	1	8
OG0010333	2	3	1	1	1	8
OG0010334	1	4	0	3	0	8
OG0010335	2	3	1	1	1	8
OG0010336	2	2	1	1	2	8
OG0010337	1	2	3	1	1	8
OG0010338	2	4	1	1	0	8
OG0010339	2	2	2	1	1	8
OG0010340	6	0	0	2	0	8
OG0010341	2	3	1	1	1	8
OG0010342	2	5	0	1	0	8
OG0010343	2	3	1	1	1	8
OG0010344	2	3	1	1	1	8
OG0010345	2	0	2	2	2	8
OG0010346	2	3	1	1	1	8
OG0010347	3	1	1	1	2	8
OG0010348	2	2	1	2	1	8
OG0010349	2	2	1	1	2	8
OG0010350	3	2	1	1	1	8
OG0010351	2	3	1	1	1	8
OG0010352	2	0	1	4	1	8
OG0010353	2	2	1	1	2	8
OG0010354	2	2	1	1	2	8
OG0010355	2	3	1	1	1	8
OG0010356	2	4	0	1	1	8
OG0010357	2	3	1	1	1	8
OG0010358	4	0	1	1	2	8
OG0010359	4	1	1	1	1	8
OG0010360	2	4	1	1	0	8
OG0010361	1	4	1	1	1	8
OG0010362	2	2	1	2	1	8
OG0010363	2	1	2	1	2	8
OG0010364	2	3	1	1	1	8
OG0010365	1	4	1	1	1	8
OG0010366	3	2	1	1	1	8
OG0010367	2	4	0	1	1	8
OG0010368	3	2	1	1	1	8
OG0010369	2	2	1	1	2	8
OG0010370	2	3	0	1	2	8
OG0010371	2	4	0	1	1	8
OG0010372	1	2	2	1	2	8
OG0010373	2	2	2	1	1	8
OG0010374	2	2	1	1	2	8
OG0010375	2	3	1	1	1	8
OG0010376	3	2	1	1	1	8
OG0010377	2	2	1	2	1	8
OG0010378	2	5	0	1	0	8
OG0010379	2	3	1	1	1	8
OG0010380	2	4	1	1	0	8
OG0010381	4	2	1	1	0	8
OG0010382	8	0	0	0	0	8
OG0010383	3	2	1	1	1	8
OG0010384	2	3	1	1	1	8
OG0010385	2	4	0	1	1	8
OG0010386	2	3	1	1	1	8
OG0010387	2	3	1	1	1	8
OG0010388	2	3	1	1	1	8
OG0010389	2	3	2	1	0	8
OG0010390	2	3	1	1	1	8
OG0010391	3	2	1	1	1	8
OG0010392	4	0	2	1	1	8
OG0010393	2	2	1	2	1	8
OG0010394	3	2	1	1	1	8
OG0010395	6	1	1	0	0	8
OG0010396	2	2	0	1	3	8
OG0010397	2	2	1	1	2	8
OG0010398	2	3	1	1	1	8
OG0010399	2	2	2	1	1	8
OG0010400	3	2	1	1	1	8
OG0010401	2	2	1	2	1	8
OG0010402	2	3	1	1	1	8
OG0010403	2	0	0	6	0	8
OG0010404	2	3	1	1	1	8
OG0010405	3	2	1	1	1	8
OG0010406	2	2	2	1	1	8
OG0010407	3	2	1	1	1	8
OG0010408	2	3	1	1	1	8
OG0010409	3	2	1	1	1	8
OG0010410	2	2	1	2	1	8
OG0010411	3	2	1	1	1	8
OG0010412	2	4	1	1	0	8
OG0010413	2	3	1	1	1	8
OG0010414	2	3	1	1	1	8
OG0010415	2	0	3	1	2	8
OG0010416	2	4	1	1	0	8
OG0010417	1	4	1	1	1	8
OG0010418	4	1	1	1	1	8
OG0010419	2	3	1	1	1	8
OG0010420	2	3	1	1	1	8
OG0010421	2	3	1	1	1	8
OG0010422	8	0	0	0	0	8
OG0010423	2	3	1	1	1	8
OG0010424	1	3	1	1	2	8
OG0010425	2	3	1	1	1	8
OG0010426	2	4	0	1	1	8
OG0010427	2	2	1	1	2	8
OG0010428	2	3	1	1	1	8
OG0010429	2	3	1	1	1	8
OG0010430	2	4	0	1	1	8
OG0010431	2	4	0	1	1	8
OG0010432	2	3	1	1	1	8
OG0010433	2	3	1	1	1	8
OG0010434	2	3	1	1	1	8
OG0010435	2	3	1	1	1	8
OG0010436	2	3	1	1	1	8
OG0010437	2	2	1	1	2	8
OG0010438	2	2	2	0	2	8
OG0010439	2	2	2	1	1	8
OG0010440	1	4	1	1	1	8
OG0010441	1	1	3	2	1	8
OG0010442	3	2	1	1	1	8
OG0010443	2	2	2	1	1	8
OG0010444	2	1	2	1	2	8
OG0010445	2	2	2	1	1	8
OG0010446	3	2	1	1	1	8
OG0010447	2	0	3	1	2	8
OG0010448	2	0	2	2	2	8
OG0010449	2	1	2	2	1	8
OG0010450	6	0	0	0	2	8
OG0010451	8	0	0	0	0	8
OG0010452	2	2	2	1	1	8
OG0010453	2	2	1	1	2	8
OG0010454	3	0	1	3	1	8
OG0010455	4	2	0	1	1	8
OG0010456	4	1	1	1	1	8
OG0010457	2	4	0	1	1	8
OG0010458	2	2	1	2	1	8
OG0010459	2	2	1	1	2	8
OG0010460	1	5	0	1	1	8
OG0010461	2	2	1	2	1	8
OG0010462	2	2	1	1	2	8
OG0010463	2	3	1	1	1	8
OG0010464	2	3	1	1	1	8
OG0010465	2	3	1	1	1	8
OG0010466	2	3	1	1	1	8
OG0010467	2	2	2	1	1	8
OG0010468	2	3	1	1	1	8
OG0010469	2	2	1	2	1	8
OG0010470	2	0	2	3	1	8
OG0010471	2	1	1	2	2	8
OG0010472	2	0	2	3	1	8
OG0010473	2	3	1	1	1	8
OG0010474	2	3	1	1	1	8
OG0010475	2	3	1	1	1	8
OG0010476	2	4	0	1	1	8
OG0010477	2	3	1	1	1	8
OG0010478	3	2	1	1	1	8
OG0010479	1	4	1	1	1	8
OG0010480	2	2	2	1	1	8
OG0010481	2	1	2	1	2	8
OG0010482	2	3	1	1	1	8
OG0010483	2	3	1	1	1	8
OG0010484	1	5	1	1	0	8
OG0010485	2	1	1	2	2	8
OG0010486	2	1	2	1	2	8
OG0010487	2	2	1	1	2	8
OG0010488	1	4	1	1	1	8
OG0010489	8	0	0	0	0	8
OG0010490	1	2	3	1	1	8
OG0010491	1	0	3	1	3	8
OG0010492	1	3	1	1	2	8
OG0010493	8	0	0	0	0	8
OG0010494	4	1	1	1	1	8
OG0010495	3	2	1	1	1	8
OG0010496	4	2	1	1	0	8
OG0010497	4	2	0	1	1	8
OG0010498	3	2	1	1	1	8
OG0010499	1	4	1	1	1	8
OG0010500	2	3	1	1	1	8
OG0010501	3	2	1	1	1	8
OG0010502	1	4	1	1	1	8
OG0010503	1	2	1	2	2	8
OG0010504	3	2	1	1	1	8
OG0010505	2	3	1	1	1	8
OG0010506	2	3	1	1	1	8
OG0010507	2	2	1	2	1	8
OG0010508	8	0	0	0	0	8
OG0010509	2	2	1	1	2	8
OG0010510	2	3	1	1	1	8
OG0010511	2	3	1	1	1	8
OG0010512	2	2	2	1	1	8
OG0010513	2	2	1	2	1	8
OG0010514	2	3	1	1	1	8
OG0010515	2	3	1	1	1	8
OG0010516	2	2	2	1	1	8
OG0010517	2	3	1	1	1	8
OG0010518	2	2	1	2	1	8
OG0010519	2	2	2	1	1	8
OG0010520	2	3	1	1	1	8
OG0010521	2	2	1	1	2	8
OG0010522	3	2	1	1	1	8
OG0010523	2	2	1	2	1	8
OG0010524	2	4	0	1	1	8
OG0010525	2	1	1	3	1	8
OG0010526	2	2	1	2	1	8
OG0010527	2	0	3	1	2	8
OG0010528	2	2	1	1	2	8
OG0010529	2	0	2	3	1	8
OG0010530	2	3	1	1	1	8
OG0010531	2	2	0	2	2	8
OG0010532	2	2	1	2	1	8
OG0010533	3	2	1	1	1	8
OG0010534	2	4	0	1	1	8
OG0010535	5	1	0	1	1	8
OG0010536	2	4	0	1	1	8
OG0010537	2	0	2	2	2	8
OG0010538	2	3	1	1	1	8
OG0010539	3	2	1	1	1	8
OG0010540	2	2	1	1	2	8
OG0010541	4	2	0	1	1	8
OG0010542	3	2	1	1	1	8
OG0010543	2	4	0	2	0	8
OG0010544	2	2	1	1	2	8
OG0010545	2	3	1	1	1	8
OG0010546	2	2	1	2	1	8
OG0010547	2	2	2	1	1	8
OG0010548	2	2	1	1	2	8
OG0010549	3	2	1	1	1	8
OG0010550	8	0	0	0	0	8
OG0010551	1	0	6	0	1	8
OG0010552	2	0	3	1	2	8
OG0010553	1	4	1	1	1	8
OG0010554	1	2	3	1	1	8
OG0010555	2	4	0	1	1	8
OG0010556	1	1	1	2	3	8
OG0010557	2	3	1	1	1	8
OG0010558	2	3	1	1	1	8
OG0010559	2	3	1	1	1	8
OG0010560	2	1	2	2	1	8
OG0010561	2	0	1	4	1	8
OG0010562	3	0	1	2	2	8
OG0010563	2	4	0	1	1	8
OG0010564	2	3	1	1	1	8
OG0010565	2	3	1	1	1	8
OG0010566	2	3	1	1	1	8
OG0010567	2	2	1	2	1	8
OG0010568	2	2	1	1	2	8
OG0010569	2	2	1	2	1	8
OG0010570	2	2	2	1	1	8
OG0010571	2	3	1	1	1	8
OG0010572	2	2	1	1	2	8
OG0010573	4	0	1	2	1	8
OG0010574	2	2	2	1	1	8
OG0010575	2	0	4	1	1	8
OG0010576	2	4	1	0	1	8
OG0010577	2	3	1	1	1	8
OG0010578	2	1	2	2	1	8
OG0010579	2	2	2	1	1	8
OG0010580	2	3	1	1	1	8
OG0010581	2	2	1	1	2	8
OG0010582	2	3	1	1	1	8
OG0010583	3	2	1	1	1	8
OG0010584	4	2	1	1	0	8
OG0010585	3	2	1	1	1	8
OG0010586	2	3	1	1	1	8
OG0010587	2	2	2	1	1	8
OG0010588	2	2	2	1	1	8
OG0010589	3	5	0	0	0	8
OG0010590	2	3	1	1	1	8
OG0010591	2	2	2	1	1	8
OG0010592	2	3	1	1	1	8
OG0010593	2	2	2	1	1	8
OG0010594	2	2	1	2	1	8
OG0010595	2	2	1	1	2	8
OG0010596	2	2	1	1	2	8
OG0010597	1	4	1	1	1	8
OG0010598	2	3	1	1	1	8
OG0010599	3	3	0	1	1	8
OG0010600	2	0	2	2	2	8
OG0010601	2	2	2	1	1	8
OG0010602	2	3	1	1	1	8
OG0010603	2	5	0	1	0	8
OG0010604	2	4	0	1	1	8
OG0010605	2	3	1	1	1	8
OG0010606	2	1	2	1	2	8
OG0010607	2	3	1	1	1	8
OG0010608	2	3	1	1	1	8
OG0010609	3	3	0	1	1	8
OG0010610	2	4	0	1	1	8
OG0010611	2	3	1	1	1	8
OG0010612	2	2	2	1	1	8
OG0010613	2	1	2	1	2	8
OG0010614	2	2	2	1	1	8
OG0010615	2	2	2	1	1	8
OG0010616	2	2	2	1	1	8
OG0010617	2	2	1	1	2	8
OG0010618	2	3	1	1	1	8
OG0010619	2	2	1	2	1	8
OG0010620	2	3	1	1	1	8
OG0010621	2	3	1	1	1	8
OG0010622	1	4	1	1	1	8
OG0010623	2	1	2	2	1	8
OG0010624	3	3	0	1	1	8
OG0010625	2	2	3	1	0	8
OG0010626	2	4	0	1	1	8
OG0010627	2	4	0	1	1	8
OG0010628	2	2	1	2	1	8
OG0010629	2	3	1	1	1	8
OG0010630	2	1	2	2	1	8
OG0010631	2	2	1	2	1	8
OG0010632	2	2	1	2	1	8
OG0010633	2	3	1	1	1	8
OG0010634	1	2	2	1	2	8
OG0010635	3	2	1	1	1	8
OG0010636	1	4	1	1	1	8
OG0010637	2	3	1	1	1	8
OG0010638	1	2	1	2	2	8
OG0010639	2	3	1	1	1	8
OG0010640	1	4	1	1	1	8
OG0010641	3	2	1	1	1	8
OG0010642	3	2	1	1	1	8
OG0010643	1	4	1	1	1	8
OG0010644	1	4	1	1	1	8
OG0010645	2	4	0	1	1	8
OG0010646	2	3	1	1	1	8
OG0010647	2	3	1	1	1	8
OG0010648	2	2	2	1	1	8
OG0010649	2	4	0	1	1	8
OG0010650	2	2	1	1	2	8
OG0010651	2	2	1	2	1	8
OG0010652	4	2	0	1	1	8
OG0010653	2	4	1	1	0	8
OG0010654	2	2	0	3	1	8
OG0010655	2	4	0	1	1	8
OG0010656	2	3	1	1	1	8
OG0010657	5	0	1	1	1	8
OG0010658	7	0	0	0	1	8
OG0010659	2	2	2	1	1	8
OG0010660	2	0	3	1	2	8
OG0010661	2	2	1	3	0	8
OG0010662	2	2	2	1	1	8
OG0010663	2	2	1	2	1	8
OG0010664	3	2	1	1	1	8
OG0010665	2	3	1	1	1	8
OG0010666	2	3	1	1	1	8
OG0010667	2	2	1	1	2	8
OG0010668	2	3	1	1	1	8
OG0010669	8	0	0	0	0	8
OG0010670	2	3	1	1	1	8
OG0010671	3	0	2	2	1	8
OG0010672	3	0	5	0	0	8
OG0010673	2	3	1	1	1	8
OG0010674	2	2	2	1	1	8
OG0010675	2	0	2	1	3	8
OG0010676	4	2	1	1	0	8
OG0010677	2	2	2	1	1	8
OG0010678	2	3	1	1	1	8
OG0010679	3	2	1	1	1	8
OG0010680	2	3	1	1	1	8
OG0010681	3	2	1	1	1	8
OG0010682	3	2	1	1	1	8
OG0010683	2	3	1	1	1	8
OG0010684	2	3	1	1	1	8
OG0010685	2	3	1	1	1	8
OG0010686	3	2	1	1	1	8
OG0010687	2	3	1	1	1	8
OG0010688	2	0	0	5	1	8
OG0010689	3	2	1	1	1	8
OG0010690	2	3	1	1	1	8
OG0010691	2	2	1	1	2	8
OG0010692	2	3	1	1	1	8
OG0010693	2	3	1	1	1	8
OG0010694	2	3	0	3	0	8
OG0010695	2	2	1	2	1	8
OG0010696	2	4	0	1	1	8
OG0010697	3	2	1	1	1	8
OG0010698	2	2	2	1	1	8
OG0010699	2	3	1	1	1	8
OG0010700	2	3	1	1	1	8
OG0010701	2	3	1	1	1	8
OG0010702	2	4	0	1	1	8
OG0010703	3	2	1	1	1	8
OG0010704	2	3	1	1	1	8
OG0010705	2	2	2	1	1	8
OG0010706	4	2	1	1	0	8
OG0010707	2	2	1	1	2	8
OG0010708	2	2	1	1	2	8
OG0010709	2	1	2	1	2	8
OG0010710	2	4	0	2	0	8
OG0010711	1	2	2	1	2	8
OG0010712	1	4	1	1	1	8
OG0010713	1	4	1	1	1	8
OG0010714	1	0	0	0	7	8
OG0010715	2	0	4	0	2	8
OG0010716	1	3	1	2	1	8
OG0010717	1	4	1	1	1	8
OG0010718	1	2	1	3	1	8
OG0010719	2	2	1	2	1	8
OG0010720	1	4	0	1	2	8
OG0010721	1	3	2	1	1	8
OG0010722	1	2	1	2	2	8
OG0010723	1	2	1	2	2	8
OG0010724	1	6	0	0	1	8
OG0010725	1	6	0	1	0	8
OG0010726	3	4	0	1	0	8
OG0010727	1	2	2	2	1	8
OG0010728	1	0	0	7	0	8
OG0010729	2	2	2	1	1	8
OG0010730	2	3	1	1	1	8
OG0010731	2	2	2	1	1	8
OG0010732	3	3	0	1	1	8
OG0010733	2	3	1	1	1	8
OG0010734	3	2	1	1	1	8
OG0010735	2	4	0	1	1	8
OG0010736	2	3	1	1	1	8
OG0010737	2	2	1	2	1	8
OG0010738	4	1	1	1	1	8
OG0010739	2	4	0	1	1	8
OG0010740	2	2	2	1	1	8
OG0010741	2	2	2	1	1	8
OG0010742	2	2	2	1	1	8
OG0010743	3	2	1	1	1	8
OG0010744	2	2	1	1	2	8
OG0010745	2	2	2	1	1	8
OG0010746	2	1	2	1	2	8
OG0010747	2	3	1	1	1	8
OG0010748	8	0	0	0	0	8
OG0010749	2	3	1	1	1	8
OG0010750	2	5	0	1	0	8
OG0010751	2	3	1	1	1	8
OG0010752	4	0	1	1	2	8
OG0010753	8	0	0	0	0	8
OG0010754	2	3	1	1	1	8
OG0010755	2	4	1	1	0	8
OG0010756	2	3	1	1	1	8
OG0010757	8	0	0	0	0	8
OG0010758	1	4	1	1	1	8
OG0010759	8	0	0	0	0	8
OG0010760	2	2	1	1	2	8
OG0010761	2	3	1	1	1	8
OG0010762	2	3	0	2	1	8
OG0010763	2	3	1	1	1	8
OG0010764	2	3	1	1	1	8
OG0010765	2	2	1	1	2	8
OG0010766	2	2	1	2	1	8
OG0010767	2	3	1	1	1	8
OG0010768	2	3	1	1	1	8
OG0010769	8	0	0	0	0	8
OG0010770	2	2	1	2	1	8
OG0010771	2	2	1	1	2	8
OG0010772	2	2	2	1	1	8
OG0010773	2	3	1	1	1	8
OG0010774	3	2	1	1	1	8
OG0010775	2	3	1	1	1	8
OG0010776	2	3	1	1	1	8
OG0010777	5	0	2	1	0	8
OG0010778	2	4	0	1	1	8
OG0010779	2	4	1	1	0	8
OG0010780	2	3	1	1	1	8
OG0010781	2	2	2	1	1	8
OG0010782	2	4	0	1	1	8
OG0010783	2	3	1	1	1	8
OG0010784	2	2	2	1	1	8
OG0010785	2	4	1	0	1	8
OG0010786	2	1	2	1	2	8
OG0010787	2	3	1	1	1	8
OG0010788	2	2	1	1	2	8
OG0010789	2	3	1	1	1	8
OG0010790	2	3	1	1	1	8
OG0010791	2	2	2	1	1	8
OG0010792	2	3	1	1	1	8
OG0010793	2	3	1	1	1	8
OG0010794	2	2	2	1	1	8
OG0010795	3	1	1	1	2	8
OG0010796	2	2	2	1	1	8
OG0010797	2	2	1	2	1	8
OG0010798	2	0	2	2	2	8
OG0010799	2	2	1	2	1	8
OG0010800	2	3	1	1	1	8
OG0010801	2	2	2	1	1	8
OG0010802	2	2	1	2	1	8
OG0010803	2	3	1	1	1	8
OG0010804	2	4	0	1	1	8
OG0010805	2	6	0	0	0	8
OG0010806	2	2	1	2	1	8
OG0010807	2	3	1	1	1	8
OG0010808	2	2	1	2	1	8
OG0010809	3	0	1	1	3	8
OG0010810	2	1	2	1	2	8
OG0010811	2	3	2	1	0	8
OG0010812	2	3	1	1	1	8
OG0010813	2	3	1	1	1	8
OG0010814	2	2	1	1	2	8
OG0010815	3	2	1	1	1	8
OG0010816	2	3	1	1	1	8
OG0010817	3	2	0	1	2	8
OG0010818	2	2	1	2	1	8
OG0010819	2	2	2	1	1	8
OG0010820	2	2	2	1	1	8
OG0010821	2	2	1	1	2	8
OG0010822	2	4	0	1	1	8
OG0010823	2	4	1	1	0	8
OG0010824	2	2	1	2	1	8
OG0010825	2	4	1	1	0	8
OG0010826	2	1	2	2	1	8
OG0010827	2	3	1	1	1	8
OG0010828	3	3	1	1	0	8
OG0010829	2	0	2	1	3	8
OG0010830	2	3	1	1	1	8
OG0010831	2	4	0	1	1	8
OG0010832	3	1	1	2	1	8
OG0010833	2	3	1	1	1	8
OG0010834	2	3	1	1	1	8
OG0010835	2	0	5	0	1	8
OG0010836	2	2	2	1	1	8
OG0010837	2	4	1	1	0	8
OG0010838	2	2	2	1	1	8
OG0010839	2	3	1	1	1	8
OG0010840	2	3	3	0	0	8
OG0010841	1	2	2	1	2	8
OG0010842	1	4	1	1	1	8
OG0010843	4	1	3	0	0	8
OG0010844	1	4	1	1	1	8
OG0010845	1	2	2	2	1	8
OG0010846	1	3	1	1	2	8
OG0010847	1	2	2	1	2	8
OG0010848	1	2	2	1	2	8
OG0010849	1	3	2	1	1	8
OG0010850	1	4	1	1	1	8
OG0010851	1	2	2	1	2	8
OG0010852	1	4	1	1	1	8
OG0010853	1	4	1	1	1	8
OG0010854	1	2	2	1	2	8
OG0010855	1	3	1	2	1	8
OG0010856	2	6	0	0	0	8
OG0010857	1	4	1	1	1	8
OG0010858	1	1	3	0	3	8
OG0010859	1	4	1	1	1	8
OG0010860	2	2	0	1	3	8
OG0010861	2	2	2	1	1	8
OG0010862	2	3	1	1	1	8
OG0010863	1	2	3	1	1	8
OG0010864	1	4	1	1	1	8
OG0010865	2	3	1	1	1	8
OG0010866	2	2	1	1	2	8
OG0010867	4	1	1	1	1	8
OG0010868	3	2	1	1	1	8
OG0010869	2	2	2	1	1	8
OG0010870	2	2	2	1	1	8
OG0010871	1	4	1	1	1	8
OG0010872	1	4	0	1	2	8
OG0010873	1	3	1	2	1	8
OG0010874	1	2	1	3	1	8
OG0010875	1	4	1	1	1	8
OG0010876	1	4	0	2	1	8
OG0010877	1	4	1	1	1	8
OG0010878	1	2	5	0	0	8
OG0010879	2	2	1	2	1	8
OG0010880	1	7	0	0	0	8
OG0010881	1	4	2	1	0	8
OG0010882	0	8	0	0	0	8
OG0010883	0	8	0	0	0	8
OG0010884	0	2	5	1	0	8
OG0010885	0	8	0	0	0	8
OG0010886	0	8	0	0	0	8
OG0010887	0	8	0	0	0	8
OG0010888	0	5	1	1	1	8
OG0010889	0	8	0	0	0	8
OG0010890	0	8	0	0	0	8
OG0010891	0	8	0	0	0	8
OG0010892	0	8	0	0	0	8
OG0010893	0	8	0	0	0	8
OG0010894	0	8	0	0	0	8
OG0010895	0	4	1	2	1	8
OG0010896	0	8	0	0	0	8
OG0010897	0	8	0	0	0	8
OG0010898	0	8	0	0	0	8
OG0010899	0	8	0	0	0	8
OG0010900	0	8	0	0	0	8
OG0010901	0	8	0	0	0	8
OG0010902	0	7	0	0	1	8
OG0010903	0	8	0	0	0	8
OG0010904	0	8	0	0	0	8
OG0010905	0	8	0	0	0	8
OG0010906	0	7	0	0	1	8
OG0010907	0	8	0	0	0	8
OG0010908	0	8	0	0	0	8
OG0010909	0	8	0	0	0	8
OG0010910	0	4	2	1	1	8
OG0010911	0	5	1	1	1	8
OG0010912	0	8	0	0	0	8
OG0010913	0	2	3	1	2	8
OG0010914	0	8	0	0	0	8
OG0010915	0	6	0	1	1	8
OG0010916	0	6	1	0	1	8
OG0010917	0	8	0	0	0	8
OG0010918	0	4	4	0	0	8
OG0010919	0	8	0	0	0	8
OG0010920	0	8	0	0	0	8
OG0010921	0	8	0	0	0	8
OG0010922	0	8	0	0	0	8
OG0010923	0	8	0	0	0	8
OG0010924	0	4	2	1	1	8
OG0010925	0	8	0	0	0	8
OG0010926	0	8	0	0	0	8
OG0010927	0	4	1	2	1	8
OG0010928	0	8	0	0	0	8
OG0010929	0	8	0	0	0	8
OG0010930	0	8	0	0	0	8
OG0010931	0	8	0	0	0	8
OG0010932	0	8	0	0	0	8
OG0010933	0	8	0	0	0	8
OG0010934	0	8	0	0	0	8
OG0010935	0	8	0	0	0	8
OG0010936	0	2	4	0	2	8
OG0010937	0	4	0	3	1	8
OG0010938	0	8	0	0	0	8
OG0010939	0	8	0	0	0	8
OG0010940	0	8	0	0	0	8
OG0010941	0	8	0	0	0	8
OG0010942	0	2	2	1	3	8
OG0010943	0	8	0	0	0	8
OG0010944	0	4	1	2	1	8
OG0010945	0	8	0	0	0	8
OG0010946	0	8	0	0	0	8
OG0010947	0	8	0	0	0	8
OG0010948	0	7	0	1	0	8
OG0010949	0	5	1	1	1	8
OG0010950	0	8	0	0	0	8
OG0010951	0	8	0	0	0	8
OG0010952	0	8	0	0	0	8
OG0010953	0	6	1	0	1	8
OG0010954	0	8	0	0	0	8
OG0010955	0	8	0	0	0	8
OG0010956	0	2	2	1	3	8
OG0010957	0	8	0	0	0	8
OG0010958	0	8	0	0	0	8
OG0010959	0	5	1	1	1	8
OG0010960	0	8	0	0	0	8
OG0010961	0	8	0	0	0	8
OG0010962	0	8	0	0	0	8
OG0010963	0	7	0	1	0	8
OG0010964	0	8	0	0	0	8
OG0010965	0	8	0	0	0	8
OG0010966	0	8	0	0	0	8
OG0010967	0	2	3	1	2	8
OG0010968	0	8	0	0	0	8
OG0010969	0	5	1	1	1	8
OG0010970	0	5	1	1	1	8
OG0010971	0	8	0	0	0	8
OG0010972	0	4	2	0	2	8
OG0010973	0	8	0	0	0	8
OG0010974	0	8	0	0	0	8
OG0010975	0	8	0	0	0	8
OG0010976	0	8	0	0	0	8
OG0010977	0	8	0	0	0	8
OG0010978	0	6	1	1	0	8
OG0010979	0	5	1	1	1	8
OG0010980	0	4	1	1	2	8
OG0010981	0	7	0	0	1	8
OG0010982	0	8	0	0	0	8
OG0010983	0	8	0	0	0	8
OG0010984	0	7	0	1	0	8
OG0010985	0	8	0	0	0	8
OG0010986	0	8	0	0	0	8
OG0010987	0	8	0	0	0	8
OG0010988	0	7	0	1	0	8
OG0010989	0	8	0	0	0	8
OG0010990	0	8	0	0	0	8
OG0010991	0	6	0	1	1	8
OG0010992	0	6	0	1	1	8
OG0010993	0	8	0	0	0	8
OG0010994	0	8	0	0	0	8
OG0010995	0	4	1	1	2	8
OG0010996	0	8	0	0	0	8
OG0010997	0	8	0	0	0	8
OG0010998	0	5	1	1	1	8
OG0010999	0	6	1	0	1	8
OG0011000	0	8	0	0	0	8
OG0011001	0	8	0	0	0	8
OG0011002	0	8	0	0	0	8
OG0011003	0	8	0	0	0	8
OG0011004	0	8	0	0	0	8
OG0011005	0	8	0	0	0	8
OG0011006	0	8	0	0	0	8
OG0011007	0	3	2	1	2	8
OG0011008	0	8	0	0	0	8
OG0011009	0	8	0	0	0	8
OG0011010	0	8	0	0	0	8
OG0011011	0	8	0	0	0	8
OG0011012	0	8	0	0	0	8
OG0011013	0	8	0	0	0	8
OG0011014	0	8	0	0	0	8
OG0011015	0	6	0	1	1	8
OG0011016	0	3	2	1	2	8
OG0011017	0	4	2	1	1	8
OG0011018	0	8	0	0	0	8
OG0011019	0	8	0	0	0	8
OG0011020	0	8	0	0	0	8
OG0011021	0	3	3	1	1	8
OG0011022	0	8	0	0	0	8
OG0011023	0	8	0	0	0	8
OG0011024	0	8	0	0	0	8
OG0011025	0	5	1	1	1	8
OG0011026	0	8	0	0	0	8
OG0011027	0	8	0	0	0	8
OG0011028	0	8	0	0	0	8
OG0011029	0	5	1	1	1	8
OG0011030	0	6	0	1	1	8
OG0011031	0	8	0	0	0	8
OG0011032	0	8	0	0	0	8
OG0011033	0	7	0	1	0	8
OG0011034	0	8	0	0	0	8
OG0011035	0	8	0	0	0	8
OG0011036	0	8	0	0	0	8
OG0011037	0	8	0	0	0	8
OG0011038	0	8	0	0	0	8
OG0011039	0	8	0	0	0	8
OG0011040	0	3	2	1	2	8
OG0011041	0	8	0	0	0	8
OG0011042	0	3	2	1	2	8
OG0011043	0	4	2	1	1	8
OG0011044	0	5	1	1	1	8
OG0011045	0	8	0	0	0	8
OG0011046	0	2	3	1	2	8
OG0011047	0	8	0	0	0	8
OG0011048	0	8	0	0	0	8
OG0011049	0	8	0	0	0	8
OG0011050	0	8	0	0	0	8
OG0011051	0	8	0	0	0	8
OG0011052	0	8	0	0	0	8
OG0011053	0	8	0	0	0	8
OG0011054	0	4	1	2	1	8
OG0011055	0	8	0	0	0	8
OG0011056	0	6	1	0	1	8
OG0011057	0	8	0	0	0	8
OG0011058	0	8	0	0	0	8
OG0011059	0	8	0	0	0	8
OG0011060	0	8	0	0	0	8
OG0011061	0	8	0	0	0	8
OG0011062	0	8	0	0	0	8
OG0011063	0	8	0	0	0	8
OG0011064	0	4	2	1	1	8
OG0011065	0	8	0	0	0	8
OG0011066	0	4	1	1	2	8
OG0011067	0	8	0	0	0	8
OG0011068	0	8	0	0	0	8
OG0011069	0	4	2	1	1	8
OG0011070	0	8	0	0	0	8
OG0011071	0	8	0	0	0	8
OG0011072	0	8	0	0	0	8
OG0011073	0	8	0	0	0	8
OG0011074	0	4	0	2	2	8
OG0011075	0	7	0	1	0	8
OG0011076	0	1	3	0	4	8
OG0011077	0	8	0	0	0	8
OG0011078	0	7	1	0	0	8
OG0011079	0	8	0	0	0	8
OG0011080	0	8	0	0	0	8
OG0011081	0	5	1	0	2	8
OG0011082	0	8	0	0	0	8
OG0011083	0	5	0	1	2	8
OG0011084	0	8	0	0	0	8
OG0011085	0	1	2	1	4	8
OG0011086	0	8	0	0	0	8
OG0011087	0	4	1	1	2	8
OG0011088	0	8	0	0	0	8
OG0011089	0	8	0	0	0	8
OG0011090	0	3	2	1	2	8
OG0011091	0	8	0	0	0	8
OG0011092	0	8	0	0	0	8
OG0011093	0	8	0	0	0	8
OG0011094	0	8	0	0	0	8
OG0011095	0	4	1	2	1	8
OG0011096	0	5	1	1	1	8
OG0011097	0	1	6	0	1	8
OG0011098	0	8	0	0	0	8
OG0011099	0	8	0	0	0	8
OG0011100	0	8	0	0	0	8
OG0011101	0	8	0	0	0	8
OG0011102	0	8	0	0	0	8
OG0011103	0	5	1	1	1	8
OG0011104	0	8	0	0	0	8
OG0011105	0	8	0	0	0	8
OG0011106	0	8	0	0	0	8
OG0011107	0	8	0	0	0	8
OG0011108	0	5	1	1	1	8
OG0011109	0	3	5	0	0	8
OG0011110	0	8	0	0	0	8
OG0011111	0	8	0	0	0	8
OG0011112	0	8	0	0	0	8
OG0011113	0	1	3	0	4	8
OG0011114	0	8	0	0	0	8
OG0011115	0	5	1	1	1	8
OG0011116	0	5	1	1	1	8
OG0011117	0	8	0	0	0	8
OG0011118	0	8	0	0	0	8
OG0011119	0	8	0	0	0	8
OG0011120	0	3	2	1	2	8
OG0011121	0	5	1	1	1	8
OG0011122	0	4	1	1	2	8
OG0011123	0	8	0	0	0	8
OG0011124	0	8	0	0	0	8
OG0011125	0	4	2	1	1	8
OG0011126	0	8	0	0	0	8
OG0011127	0	8	0	0	0	8
OG0011128	0	8	0	0	0	8
OG0011129	0	8	0	0	0	8
OG0011130	0	8	0	0	0	8
OG0011131	0	5	1	1	1	8
OG0011132	0	4	0	3	1	8
OG0011133	0	8	0	0	0	8
OG0011134	0	8	0	0	0	8
OG0011135	0	8	0	0	0	8
OG0011136	0	5	0	1	2	8
OG0011137	0	5	1	1	1	8
OG0011138	0	8	0	0	0	8
OG0011139	0	8	0	0	0	8
OG0011140	0	8	0	0	0	8
OG0011141	0	4	1	1	2	8
OG0011142	0	4	0	3	1	8
OG0011143	0	5	1	1	1	8
OG0011144	0	8	0	0	0	8
OG0011145	0	2	2	1	3	8
OG0011146	0	2	3	2	1	8
OG0011147	0	8	0	0	0	8
OG0011148	0	8	0	0	0	8
OG0011149	0	6	0	1	1	8
OG0011150	0	8	0	0	0	8
OG0011151	0	5	1	2	0	8
OG0011152	0	4	2	0	2	8
OG0011153	0	6	0	0	2	8
OG0011154	0	8	0	0	0	8
OG0011155	0	5	1	1	1	8
OG0011156	0	3	2	0	3	8
OG0011157	0	8	0	0	0	8
OG0011158	0	7	0	1	0	8
OG0011159	0	8	0	0	0	8
OG0011160	0	1	1	1	5	8
OG0011161	0	2	3	1	2	8
OG0011162	0	5	0	1	2	8
OG0011163	0	8	0	0	0	8
OG0011164	0	8	0	0	0	8
OG0011165	0	8	0	0	0	8
OG0011166	0	7	0	1	0	8
OG0011167	0	4	2	1	1	8
OG0011168	0	8	0	0	0	8
OG0011169	0	8	0	0	0	8
OG0011170	0	8	0	0	0	8
OG0011171	0	7	0	1	0	8
OG0011172	0	5	1	1	1	8
OG0011173	0	8	0	0	0	8
OG0011174	0	3	2	1	2	8
OG0011175	0	5	1	1	1	8
OG0011176	0	8	0	0	0	8
OG0011177	0	8	0	0	0	8
OG0011178	0	8	0	0	0	8
OG0011179	0	7	0	1	0	8
OG0011180	0	8	0	0	0	8
OG0011181	0	8	0	0	0	8
OG0011182	0	6	1	0	1	8
OG0011183	0	8	0	0	0	8
OG0011184	0	2	2	2	2	8
OG0011185	0	8	0	0	0	8
OG0011186	0	8	0	0	0	8
OG0011187	0	2	3	1	2	8
OG0011188	0	3	1	0	4	8
OG0011189	0	1	2	3	2	8
OG0011190	0	1	3	1	3	8
OG0011191	0	8	0	0	0	8
OG0011192	0	0	8	0	0	8
OG0011193	0	0	3	3	2	8
OG0011194	0	0	8	0	0	8
OG0011195	0	0	5	0	3	8
OG0011196	0	0	8	0	0	8
OG0011197	0	0	2	0	6	8
OG0011198	0	0	5	0	3	8
OG0011199	0	0	8	0	0	8
OG0011200	0	0	1	6	1	8
OG0011201	0	0	6	0	2	8
OG0011202	0	0	5	0	3	8
OG0011203	0	0	6	0	2	8
OG0011204	0	0	8	0	0	8
OG0011205	0	0	8	0	0	8
OG0011206	0	0	8	0	0	8
OG0011207	0	0	8	0	0	8
OG0011208	0	0	6	0	2	8
OG0011209	0	0	2	3	3	8
OG0011210	0	0	5	0	3	8
OG0011211	0	0	1	7	0	8
OG0011212	0	0	1	6	1	8
OG0011213	0	0	5	0	3	8
OG0011214	0	0	5	0	3	8
OG0011215	0	0	5	2	1	8
OG0011216	0	0	7	0	1	8
OG0011217	0	0	1	0	7	8
OG0011218	0	0	1	0	7	8
OG0011219	0	0	8	0	0	8
OG0011220	0	0	8	0	0	8
OG0011221	0	0	8	0	0	8
OG0011222	0	0	1	0	7	8
OG0011223	0	0	3	2	3	8
OG0011224	0	0	3	1	4	8
OG0011225	0	0	4	0	4	8
OG0011226	0	0	5	0	3	8
OG0011227	0	0	7	0	1	8
OG0011228	0	0	1	0	7	8
OG0011229	0	0	1	0	7	8
OG0011230	0	0	8	0	0	8
OG0011231	0	0	1	1	6	8
OG0011232	0	0	2	0	6	8
OG0011233	0	0	8	0	0	8
OG0011234	0	0	4	0	4	8
OG0011235	0	0	6	1	1	8
OG0011236	0	0	8	0	0	8
OG0011237	0	0	5	0	3	8
OG0011238	0	0	1	5	2	8
OG0011239	0	0	1	4	3	8
OG0011240	0	0	7	0	1	8
OG0011241	0	0	6	1	1	8
OG0011242	0	0	1	0	7	8
OG0011243	0	0	3	2	3	8
OG0011244	0	0	8	0	0	8
OG0011245	0	0	1	0	7	8
OG0011246	0	0	3	0	5	8
OG0011247	0	0	7	0	1	8
OG0011248	0	0	2	3	3	8
OG0011249	0	0	4	1	3	8
OG0011250	0	0	4	1	3	8
OG0011251	0	0	6	0	2	8
OG0011252	0	0	2	0	6	8
OG0011253	0	0	8	0	0	8
OG0011254	0	0	1	0	7	8
OG0011255	0	0	1	0	7	8
OG0011256	0	0	0	8	0	8
OG0011257	0	0	0	8	0	8
OG0011258	0	0	0	8	0	8
OG0011259	0	0	0	8	0	8
OG0011260	0	0	0	8	0	8
OG0011261	0	0	0	8	0	8
OG0011262	0	0	0	8	0	8
OG0011263	0	0	0	6	2	8
OG0011264	0	0	0	8	0	8
OG0011265	0	0	0	8	0	8
OG0011266	0	0	0	8	0	8
OG0011267	0	0	0	7	1	8
OG0011268	0	0	0	8	0	8
OG0011269	0	0	0	8	0	8
OG0011270	0	0	0	8	0	8
OG0011271	0	0	0	8	0	8
OG0011272	0	0	0	0	8	8
OG0011273	0	0	0	0	8	8
OG0011274	0	0	0	0	8	8
OG0011275	0	0	0	0	8	8
OG0011276	0	0	0	0	8	8
OG0011277	0	0	0	0	8	8
OG0011278	0	0	0	0	8	8
OG0011279	0	0	0	0	8	8
OG0011280	0	0	0	0	8	8
OG0011281	0	0	0	0	8	8
OG0011282	0	0	0	0	8	8
OG0011283	0	0	0	0	8	8
OG0011284	0	0	0	0	8	8
OG0011285	0	0	0	0	8	8
OG0011286	0	0	0	0	8	8
OG0011287	0	0	0	0	8	8
OG0011288	0	0	0	0	8	8
OG0011289	0	0	0	0	8	8
OG0011290	0	0	0	0	8	8
OG0011291	0	0	0	0	8	8
OG0011292	0	0	0	0	8	8
OG0011293	0	0	0	0	8	8
OG0011294	0	0	0	0	8	8
OG0011295	4	2	0	1	0	7
OG0011296	7	0	0	0	0	7
OG0011297	7	0	0	0	0	7
OG0011298	2	1	2	1	1	7
OG0011299	2	2	1	1	1	7
OG0011300	7	0	0	0	0	7
OG0011301	2	2	1	1	1	7
OG0011302	2	2	0	1	2	7
OG0011303	2	2	1	1	1	7
OG0011304	2	2	1	1	1	7
OG0011305	2	2	1	1	1	7
OG0011306	4	0	1	1	1	7
OG0011307	7	0	0	0	0	7
OG0011308	3	2	0	1	1	7
OG0011309	7	0	0	0	0	7
OG0011310	2	4	0	1	0	7
OG0011311	3	3	0	1	0	7
OG0011312	2	2	1	1	1	7
OG0011313	4	0	1	1	1	7
OG0011314	2	2	1	1	1	7
OG0011315	2	2	1	1	1	7
OG0011316	2	2	1	1	1	7
OG0011317	3	1	1	1	1	7
OG0011318	2	2	1	1	1	7
OG0011319	7	0	0	0	0	7
OG0011320	2	2	1	1	1	7
OG0011321	7	0	0	0	0	7
OG0011322	2	2	1	1	1	7
OG0011323	7	0	0	0	0	7
OG0011324	2	2	1	1	1	7
OG0011325	2	2	1	1	1	7
OG0011326	2	2	1	1	1	7
OG0011327	2	2	1	1	1	7
OG0011328	2	2	1	1	1	7
OG0011329	2	2	1	1	1	7
OG0011330	7	0	0	0	0	7
OG0011331	7	0	0	0	0	7
OG0011332	7	0	0	0	0	7
OG0011333	2	2	1	1	1	7
OG0011334	2	2	1	1	1	7
OG0011335	2	2	1	1	1	7
OG0011336	7	0	0	0	0	7
OG0011337	2	2	1	1	1	7
OG0011338	3	2	1	1	0	7
OG0011339	2	1	2	1	1	7
OG0011340	2	2	1	1	1	7
OG0011341	2	2	1	1	1	7
OG0011342	1	4	0	1	1	7
OG0011343	2	2	1	1	1	7
OG0011344	2	2	1	1	1	7
OG0011345	2	3	0	1	1	7
OG0011346	2	2	1	1	1	7
OG0011347	6	0	1	0	0	7
OG0011348	2	5	0	0	0	7
OG0011349	7	0	0	0	0	7
OG0011350	7	0	0	0	0	7
OG0011351	2	2	1	1	1	7
OG0011352	2	2	1	1	1	7
OG0011353	3	2	1	1	0	7
OG0011354	2	2	1	1	1	7
OG0011355	2	2	1	1	1	7
OG0011356	7	0	0	0	0	7
OG0011357	3	2	1	1	0	7
OG0011358	6	0	1	0	0	7
OG0011359	3	1	1	1	1	7
OG0011360	2	2	1	1	1	7
OG0011361	2	1	2	1	1	7
OG0011362	2	2	1	1	1	7
OG0011363	3	2	1	1	0	7
OG0011364	7	0	0	0	0	7
OG0011365	2	2	1	1	1	7
OG0011366	2	2	1	1	1	7
OG0011367	2	3	0	1	1	7
OG0011368	3	2	0	1	1	7
OG0011369	2	2	1	1	1	7
OG0011370	7	0	0	0	0	7
OG0011371	2	2	1	1	1	7
OG0011372	2	2	1	1	1	7
OG0011373	7	0	0	0	0	7
OG0011374	2	3	0	1	1	7
OG0011375	2	2	1	1	1	7
OG0011376	2	2	1	1	1	7
OG0011377	2	4	0	0	1	7
OG0011378	4	0	1	1	1	7
OG0011379	7	0	0	0	0	7
OG0011380	2	2	1	1	1	7
OG0011381	2	2	1	1	1	7
OG0011382	2	2	1	1	1	7
OG0011383	2	2	1	1	1	7
OG0011384	2	2	1	1	1	7
OG0011385	7	0	0	0	0	7
OG0011386	4	2	0	1	0	7
OG0011387	7	0	0	0	0	7
OG0011388	2	2	1	1	1	7
OG0011389	2	2	1	1	1	7
OG0011390	2	2	1	1	1	7
OG0011391	2	3	0	1	1	7
OG0011392	2	2	1	1	1	7
OG0011393	2	0	1	1	3	7
OG0011394	2	2	1	1	1	7
OG0011395	6	0	1	0	0	7
OG0011396	2	2	1	1	1	7
OG0011397	2	2	1	1	1	7
OG0011398	2	3	0	1	1	7
OG0011399	2	0	2	1	2	7
OG0011400	2	2	1	1	1	7
OG0011401	2	2	1	1	1	7
OG0011402	2	2	1	1	1	7
OG0011403	2	2	1	1	1	7
OG0011404	6	0	0	1	0	7
OG0011405	2	1	2	1	1	7
OG0011406	2	2	0	2	1	7
OG0011407	2	2	1	1	1	7
OG0011408	4	0	1	1	1	7
OG0011409	4	0	1	1	1	7
OG0011410	2	2	1	1	1	7
OG0011411	3	2	1	1	0	7
OG0011412	2	2	1	1	1	7
OG0011413	2	2	1	1	1	7
OG0011414	2	2	1	1	1	7
OG0011415	2	2	1	1	1	7
OG0011416	2	2	1	1	1	7
OG0011417	2	2	1	1	1	7
OG0011418	2	2	1	1	1	7
OG0011419	2	2	1	1	1	7
OG0011420	2	1	2	1	1	7
OG0011421	2	2	1	1	1	7
OG0011422	5	0	0	2	0	7
OG0011423	2	1	2	1	1	7
OG0011424	2	3	0	1	1	7
OG0011425	7	0	0	0	0	7
OG0011426	4	1	0	1	1	7
OG0011427	7	0	0	0	0	7
OG0011428	2	3	0	1	1	7
OG0011429	2	2	1	1	1	7
OG0011430	2	2	1	1	1	7
OG0011431	2	3	1	1	0	7
OG0011432	1	3	1	1	1	7
OG0011433	2	2	1	1	1	7
OG0011434	2	2	1	1	1	7
OG0011435	2	2	1	1	1	7
OG0011436	1	3	1	1	1	7
OG0011437	2	2	1	1	1	7
OG0011438	2	2	1	1	1	7
OG0011439	2	3	0	1	1	7
OG0011440	7	0	0	0	0	7
OG0011441	7	0	0	0	0	7
OG0011442	2	2	1	1	1	7
OG0011443	2	2	1	1	1	7
OG0011444	2	2	1	1	1	7
OG0011445	2	2	1	1	1	7
OG0011446	2	2	1	1	1	7
OG0011447	2	2	1	1	1	7
OG0011448	2	2	1	1	1	7
OG0011449	2	2	1	1	1	7
OG0011450	2	2	1	1	1	7
OG0011451	2	2	1	1	1	7
OG0011452	7	0	0	0	0	7
OG0011453	2	2	1	1	1	7
OG0011454	2	2	1	1	1	7
OG0011455	7	0	0	0	0	7
OG0011456	4	2	0	1	0	7
OG0011457	2	1	1	2	1	7
OG0011458	2	2	1	1	1	7
OG0011459	7	0	0	0	0	7
OG0011460	3	1	1	1	1	7
OG0011461	2	0	2	1	2	7
OG0011462	7	0	0	0	0	7
OG0011463	2	2	1	1	1	7
OG0011464	7	0	0	0	0	7
OG0011465	6	1	0	0	0	7
OG0011466	2	2	1	1	1	7
OG0011467	2	2	1	1	1	7
OG0011468	2	2	1	1	1	7
OG0011469	2	2	1	1	1	7
OG0011470	2	2	1	1	1	7
OG0011471	3	1	1	1	1	7
OG0011472	4	0	1	1	1	7
OG0011473	2	2	1	1	1	7
OG0011474	7	0	0	0	0	7
OG0011475	3	0	2	0	2	7
OG0011476	4	1	1	1	0	7
OG0011477	7	0	0	0	0	7
OG0011478	7	0	0	0	0	7
OG0011479	3	1	3	0	0	7
OG0011480	3	2	2	0	0	7
OG0011481	7	0	0	0	0	7
OG0011482	6	0	0	0	1	7
OG0011483	2	2	1	1	1	7
OG0011484	2	2	1	1	1	7
OG0011485	2	2	1	1	1	7
OG0011486	2	2	1	1	1	7
OG0011487	2	2	1	1	1	7
OG0011488	2	2	1	1	1	7
OG0011489	2	2	1	1	1	7
OG0011490	2	2	1	1	1	7
OG0011491	1	0	2	2	2	7
OG0011492	3	1	1	1	1	7
OG0011493	2	0	1	3	1	7
OG0011494	2	3	1	1	0	7
OG0011495	2	2	1	1	1	7
OG0011496	2	4	0	1	0	7
OG0011497	4	0	1	1	1	7
OG0011498	7	0	0	0	0	7
OG0011499	3	1	1	1	1	7
OG0011500	2	2	1	1	1	7
OG0011501	2	2	1	1	1	7
OG0011502	2	2	1	1	1	7
OG0011503	2	2	1	1	1	7
OG0011504	2	2	1	1	1	7
OG0011505	2	2	1	1	1	7
OG0011506	2	1	1	1	2	7
OG0011507	7	0	0	0	0	7
OG0011508	7	0	0	0	0	7
OG0011509	5	0	2	0	0	7
OG0011510	2	2	1	1	1	7
OG0011511	2	2	1	1	1	7
OG0011512	1	3	1	1	1	7
OG0011513	2	2	1	1	1	7
OG0011514	2	2	1	1	1	7
OG0011515	2	2	0	1	2	7
OG0011516	4	1	1	1	0	7
OG0011517	2	2	1	1	1	7
OG0011518	2	2	1	1	1	7
OG0011519	2	2	1	1	1	7
OG0011520	2	2	1	1	1	7
OG0011521	1	2	2	1	1	7
OG0011522	2	2	1	1	1	7
OG0011523	2	3	1	1	0	7
OG0011524	2	4	0	1	0	7
OG0011525	7	0	0	0	0	7
OG0011526	2	2	1	1	1	7
OG0011527	2	2	1	1	1	7
OG0011528	2	2	1	1	1	7
OG0011529	2	2	1	1	1	7
OG0011530	2	2	1	1	1	7
OG0011531	2	0	2	1	2	7
OG0011532	2	2	1	1	1	7
OG0011533	2	2	1	1	1	7
OG0011534	7	0	0	0	0	7
OG0011535	2	2	1	1	1	7
OG0011536	2	2	1	1	1	7
OG0011537	3	0	1	1	2	7
OG0011538	3	2	0	1	1	7
OG0011539	2	2	1	1	1	7
OG0011540	2	2	1	1	1	7
OG0011541	7	0	0	0	0	7
OG0011542	2	2	1	1	1	7
OG0011543	2	2	1	1	1	7
OG0011544	2	2	1	1	1	7
OG0011545	7	0	0	0	0	7
OG0011546	2	3	0	1	1	7
OG0011547	7	0	0	0	0	7
OG0011548	2	2	1	1	1	7
OG0011549	3	2	1	1	0	7
OG0011550	2	2	1	1	1	7
OG0011551	1	1	2	1	2	7
OG0011552	2	3	1	1	0	7
OG0011553	5	1	0	1	0	7
OG0011554	1	2	1	2	1	7
OG0011555	2	2	1	1	1	7
OG0011556	2	2	1	1	1	7
OG0011557	2	2	1	1	1	7
OG0011558	2	2	1	1	1	7
OG0011559	2	2	1	1	1	7
OG0011560	7	0	0	0	0	7
OG0011561	2	2	1	1	1	7
OG0011562	2	2	1	1	1	7
OG0011563	2	4	0	1	0	7
OG0011564	2	2	1	1	1	7
OG0011565	2	0	1	3	1	7
OG0011566	2	2	1	1	1	7
OG0011567	2	2	1	1	1	7
OG0011568	7	0	0	0	0	7
OG0011569	2	2	1	1	1	7
OG0011570	2	0	2	1	2	7
OG0011571	3	1	1	1	1	7
OG0011572	2	2	1	1	1	7
OG0011573	3	2	0	1	1	7
OG0011574	2	2	1	1	1	7
OG0011575	2	2	1	1	1	7
OG0011576	2	2	1	1	1	7
OG0011577	3	2	1	1	0	7
OG0011578	2	2	1	1	1	7
OG0011579	2	2	1	1	1	7
OG0011580	2	2	1	1	1	7
OG0011581	2	2	1	1	1	7
OG0011582	3	2	0	1	1	7
OG0011583	2	2	1	1	1	7
OG0011584	2	2	1	1	1	7
OG0011585	2	2	1	1	1	7
OG0011586	7	0	0	0	0	7
OG0011587	7	0	0	0	0	7
OG0011588	2	2	1	1	1	7
OG0011589	2	2	1	1	1	7
OG0011590	2	2	1	1	1	7
OG0011591	2	2	1	1	1	7
OG0011592	2	2	1	1	1	7
OG0011593	2	2	1	1	1	7
OG0011594	7	0	0	0	0	7
OG0011595	7	0	0	0	0	7
OG0011596	2	2	1	1	1	7
OG0011597	1	3	1	1	1	7
OG0011598	2	2	1	1	1	7
OG0011599	2	2	1	1	1	7
OG0011600	6	0	0	1	0	7
OG0011601	2	2	1	1	1	7
OG0011602	2	2	1	1	1	7
OG0011603	2	2	1	1	1	7
OG0011604	2	2	1	2	0	7
OG0011605	2	0	2	1	2	7
OG0011606	2	2	1	1	1	7
OG0011607	4	2	0	0	1	7
OG0011608	2	2	1	1	1	7
OG0011609	2	2	1	1	1	7
OG0011610	2	0	2	1	2	7
OG0011611	2	2	1	1	1	7
OG0011612	2	2	1	1	1	7
OG0011613	2	2	1	1	1	7
OG0011614	3	2	0	1	1	7
OG0011615	7	0	0	0	0	7
OG0011616	2	2	1	1	1	7
OG0011617	2	3	0	1	1	7
OG0011618	6	0	0	1	0	7
OG0011619	2	2	1	1	1	7
OG0011620	2	2	1	1	1	7
OG0011621	2	3	0	1	1	7
OG0011622	4	0	0	3	0	7
OG0011623	6	1	0	0	0	7
OG0011624	2	2	1	1	1	7
OG0011625	2	1	1	1	2	7
OG0011626	2	3	1	0	1	7
OG0011627	7	0	0	0	0	7
OG0011628	2	2	1	2	0	7
OG0011629	2	2	1	1	1	7
OG0011630	2	2	1	1	1	7
OG0011631	2	2	1	1	1	7
OG0011632	2	2	0	2	1	7
OG0011633	2	0	2	1	2	7
OG0011634	7	0	0	0	0	7
OG0011635	2	0	2	1	2	7
OG0011636	4	2	0	1	0	7
OG0011637	2	2	1	1	1	7
OG0011638	2	2	1	1	1	7
OG0011639	2	3	1	1	0	7
OG0011640	7	0	0	0	0	7
OG0011641	2	2	1	1	1	7
OG0011642	2	2	1	1	1	7
OG0011643	2	2	1	1	1	7
OG0011644	2	2	1	1	1	7
OG0011645	2	2	1	1	1	7
OG0011646	3	2	0	1	1	7
OG0011647	2	2	1	1	1	7
OG0011648	2	2	1	1	1	7
OG0011649	2	4	0	1	0	7
OG0011650	3	0	2	1	1	7
OG0011651	4	3	0	0	0	7
OG0011652	2	2	1	1	1	7
OG0011653	1	2	2	1	1	7
OG0011654	7	0	0	0	0	7
OG0011655	2	2	0	1	2	7
OG0011656	2	0	2	1	2	7
OG0011657	2	2	1	1	1	7
OG0011658	2	2	1	1	1	7
OG0011659	2	2	1	1	1	7
OG0011660	2	2	1	1	1	7
OG0011661	2	2	1	1	1	7
OG0011662	3	2	2	0	0	7
OG0011663	2	2	1	1	1	7
OG0011664	2	2	1	1	1	7
OG0011665	2	2	2	1	0	7
OG0011666	3	1	1	2	0	7
OG0011667	7	0	0	0	0	7
OG0011668	2	4	0	0	1	7
OG0011669	3	1	1	1	1	7
OG0011670	2	2	1	1	1	7
OG0011671	2	2	1	1	1	7
OG0011672	2	2	1	1	1	7
OG0011673	2	2	1	1	1	7
OG0011674	2	2	1	1	1	7
OG0011675	2	2	1	1	1	7
OG0011676	5	0	1	1	0	7
OG0011677	2	2	1	1	1	7
OG0011678	2	2	1	1	1	7
OG0011679	2	2	1	1	1	7
OG0011680	2	2	1	1	1	7
OG0011681	2	2	1	1	1	7
OG0011682	4	0	0	3	0	7
OG0011683	2	2	1	1	1	7
OG0011684	2	2	1	1	1	7
OG0011685	7	0	0	0	0	7
OG0011686	2	2	1	1	1	7
OG0011687	2	2	1	1	1	7
OG0011688	2	1	1	1	2	7
OG0011689	1	3	1	1	1	7
OG0011690	2	2	1	1	1	7
OG0011691	2	1	1	2	1	7
OG0011692	2	2	1	1	1	7
OG0011693	2	2	1	1	1	7
OG0011694	2	2	1	1	1	7
OG0011695	2	2	1	1	1	7
OG0011696	2	2	1	1	1	7
OG0011697	2	2	1	1	1	7
OG0011698	7	0	0	0	0	7
OG0011699	2	2	1	1	1	7
OG0011700	2	1	1	2	1	7
OG0011701	2	2	1	1	1	7
OG0011702	2	2	1	1	1	7
OG0011703	2	0	2	1	2	7
OG0011704	1	3	1	1	1	7
OG0011705	2	2	1	1	1	7
OG0011706	2	2	1	1	1	7
OG0011707	7	0	0	0	0	7
OG0011708	3	1	0	2	1	7
OG0011709	2	2	1	1	1	7
OG0011710	2	2	1	1	1	7
OG0011711	2	2	1	1	1	7
OG0011712	2	0	2	2	1	7
OG0011713	7	0	0	0	0	7
OG0011714	2	2	1	1	1	7
OG0011715	7	0	0	0	0	7
OG0011716	3	2	0	1	1	7
OG0011717	2	2	1	1	1	7
OG0011718	2	2	1	1	1	7
OG0011719	2	2	1	1	1	7
OG0011720	2	2	1	1	1	7
OG0011721	2	2	1	1	1	7
OG0011722	1	5	0	1	0	7
OG0011723	2	2	1	1	1	7
OG0011724	4	1	0	0	2	7
OG0011725	2	1	1	2	1	7
OG0011726	2	2	1	1	1	7
OG0011727	2	2	1	1	1	7
OG0011728	2	2	1	1	1	7
OG0011729	7	0	0	0	0	7
OG0011730	2	2	1	1	1	7
OG0011731	7	0	0	0	0	7
OG0011732	2	2	1	1	1	7
OG0011733	2	2	0	2	1	7
OG0011734	2	4	1	0	0	7
OG0011735	2	2	1	1	1	7
OG0011736	7	0	0	0	0	7
OG0011737	2	2	1	1	1	7
OG0011738	2	2	1	1	1	7
OG0011739	2	2	1	1	1	7
OG0011740	2	2	1	1	1	7
OG0011741	7	0	0	0	0	7
OG0011742	2	2	1	1	1	7
OG0011743	2	2	1	1	1	7
OG0011744	2	2	1	1	1	7
OG0011745	2	2	1	1	1	7
OG0011746	2	4	0	1	0	7
OG0011747	2	2	1	1	1	7
OG0011748	2	2	1	1	1	7
OG0011749	3	3	0	1	0	7
OG0011750	3	2	0	1	1	7
OG0011751	2	2	1	1	1	7
OG0011752	1	1	2	1	2	7
OG0011753	2	2	1	1	1	7
OG0011754	1	2	1	1	2	7
OG0011755	3	2	0	1	1	7
OG0011756	2	2	1	1	1	7
OG0011757	2	2	1	1	1	7
OG0011758	2	2	1	1	1	7
OG0011759	3	2	0	1	1	7
OG0011760	2	4	0	1	0	7
OG0011761	2	2	1	1	1	7
OG0011762	2	2	1	1	1	7
OG0011763	1	1	2	1	2	7
OG0011764	2	2	1	1	1	7
OG0011765	2	2	1	1	1	7
OG0011766	2	3	0	1	1	7
OG0011767	2	2	1	1	1	7
OG0011768	3	1	1	1	1	7
OG0011769	4	0	1	1	1	7
OG0011770	2	0	1	3	1	7
OG0011771	3	3	0	1	0	7
OG0011772	2	2	1	1	1	7
OG0011773	7	0	0	0	0	7
OG0011774	3	2	0	1	1	7
OG0011775	7	0	0	0	0	7
OG0011776	4	2	0	1	0	7
OG0011777	2	2	1	1	1	7
OG0011778	2	2	1	1	1	7
OG0011779	7	0	0	0	0	7
OG0011780	2	4	0	0	1	7
OG0011781	2	2	1	1	1	7
OG0011782	2	2	1	1	1	7
OG0011783	2	2	1	1	1	7
OG0011784	2	2	1	1	1	7
OG0011785	2	2	1	1	1	7
OG0011786	2	2	1	1	1	7
OG0011787	2	2	1	1	1	7
OG0011788	7	0	0	0	0	7
OG0011789	2	2	1	1	1	7
OG0011790	2	2	1	1	1	7
OG0011791	2	2	1	1	1	7
OG0011792	2	2	1	1	1	7
OG0011793	2	2	1	1	1	7
OG0011794	2	2	1	1	1	7
OG0011795	2	2	1	1	1	7
OG0011796	2	0	1	2	2	7
OG0011797	5	1	0	0	1	7
OG0011798	2	2	1	1	1	7
OG0011799	2	2	1	1	1	7
OG0011800	2	2	1	1	1	7
OG0011801	2	2	1	1	1	7
OG0011802	2	2	1	1	1	7
OG0011803	2	2	1	1	1	7
OG0011804	1	0	2	1	3	7
OG0011805	2	2	1	1	1	7
OG0011806	4	0	0	2	1	7
OG0011807	2	2	1	1	1	7
OG0011808	4	0	0	2	1	7
OG0011809	2	2	1	1	1	7
OG0011810	2	3	0	1	1	7
OG0011811	2	2	1	1	1	7
OG0011812	7	0	0	0	0	7
OG0011813	2	2	1	1	1	7
OG0011814	2	3	0	1	1	7
OG0011815	2	2	1	1	1	7
OG0011816	2	2	1	1	1	7
OG0011817	2	2	1	1	1	7
OG0011818	2	2	1	1	1	7
OG0011819	2	0	1	3	1	7
OG0011820	4	0	0	0	3	7
OG0011821	2	2	1	1	1	7
OG0011822	2	2	1	1	1	7
OG0011823	2	2	1	1	1	7
OG0011824	2	2	1	1	1	7
OG0011825	2	2	1	1	1	7
OG0011826	2	2	1	1	1	7
OG0011827	2	2	1	1	1	7
OG0011828	2	2	1	1	1	7
OG0011829	2	3	1	1	0	7
OG0011830	2	2	1	1	1	7
OG0011831	2	2	1	1	1	7
OG0011832	2	2	1	1	1	7
OG0011833	7	0	0	0	0	7
OG0011834	2	2	1	1	1	7
OG0011835	2	0	2	1	2	7
OG0011836	2	2	1	1	1	7
OG0011837	2	2	1	1	1	7
OG0011838	2	1	1	2	1	7
OG0011839	2	2	1	1	1	7
OG0011840	3	1	1	1	1	7
OG0011841	2	2	0	2	1	7
OG0011842	2	2	1	1	1	7
OG0011843	2	3	0	1	1	7
OG0011844	2	2	1	1	1	7
OG0011845	2	2	1	1	1	7
OG0011846	2	2	1	1	1	7
OG0011847	2	2	1	1	1	7
OG0011848	2	3	0	1	1	7
OG0011849	2	2	1	1	1	7
OG0011850	2	2	1	1	1	7
OG0011851	3	2	0	1	1	7
OG0011852	7	0	0	0	0	7
OG0011853	4	0	1	1	1	7
OG0011854	2	2	1	1	1	7
OG0011855	2	2	1	1	1	7
OG0011856	3	1	1	1	1	7
OG0011857	2	2	1	1	1	7
OG0011858	2	2	1	1	1	7
OG0011859	7	0	0	0	0	7
OG0011860	2	3	0	1	1	7
OG0011861	2	0	1	2	2	7
OG0011862	2	2	1	1	1	7
OG0011863	2	3	0	1	1	7
OG0011864	2	2	1	1	1	7
OG0011865	2	2	1	1	1	7
OG0011866	2	2	0	3	0	7
OG0011867	2	2	1	1	1	7
OG0011868	2	2	1	1	1	7
OG0011869	1	2	1	2	1	7
OG0011870	2	3	0	1	1	7
OG0011871	2	2	1	1	1	7
OG0011872	2	2	1	1	1	7
OG0011873	2	2	1	1	1	7
OG0011874	2	2	1	1	1	7
OG0011875	7	0	0	0	0	7
OG0011876	2	2	1	1	1	7
OG0011877	7	0	0	0	0	7
OG0011878	6	1	0	0	0	7
OG0011879	2	2	1	1	1	7
OG0011880	2	3	1	1	0	7
OG0011881	3	0	1	2	1	7
OG0011882	2	2	1	1	1	7
OG0011883	2	2	1	1	1	7
OG0011884	7	0	0	0	0	7
OG0011885	2	2	1	1	1	7
OG0011886	2	2	1	1	1	7
OG0011887	2	2	1	1	1	7
OG0011888	2	2	1	1	1	7
OG0011889	2	2	1	1	1	7
OG0011890	2	2	1	1	1	7
OG0011891	1	3	1	1	1	7
OG0011892	3	2	1	1	0	7
OG0011893	2	4	0	1	0	7
OG0011894	3	0	1	1	2	7
OG0011895	2	5	0	0	0	7
OG0011896	2	1	1	2	1	7
OG0011897	2	2	1	1	1	7
OG0011898	7	0	0	0	0	7
OG0011899	2	2	1	1	1	7
OG0011900	2	2	1	1	1	7
OG0011901	2	2	1	1	1	7
OG0011902	2	2	1	1	1	7
OG0011903	2	2	1	1	1	7
OG0011904	3	0	1	1	2	7
OG0011905	2	2	1	1	1	7
OG0011906	2	2	1	1	1	7
OG0011907	2	2	1	1	1	7
OG0011908	2	2	1	1	1	7
OG0011909	2	2	1	1	1	7
OG0011910	2	2	1	1	1	7
OG0011911	2	2	1	1	1	7
OG0011912	2	2	1	1	1	7
OG0011913	1	2	1	2	1	7
OG0011914	2	3	0	1	1	7
OG0011915	2	3	0	1	1	7
OG0011916	2	2	1	1	1	7
OG0011917	2	2	1	1	1	7
OG0011918	2	2	1	1	1	7
OG0011919	2	2	1	1	1	7
OG0011920	4	0	1	1	1	7
OG0011921	2	2	0	2	1	7
OG0011922	2	2	1	1	1	7
OG0011923	3	1	1	1	1	7
OG0011924	2	3	0	1	1	7
OG0011925	2	2	1	1	1	7
OG0011926	2	2	1	1	1	7
OG0011927	2	2	1	1	1	7
OG0011928	2	2	1	1	1	7
OG0011929	2	2	1	1	1	7
OG0011930	2	2	1	1	1	7
OG0011931	2	2	1	1	1	7
OG0011932	2	2	1	1	1	7
OG0011933	2	2	1	1	1	7
OG0011934	2	2	1	1	1	7
OG0011935	2	2	1	1	1	7
OG0011936	2	2	1	1	1	7
OG0011937	2	2	1	1	1	7
OG0011938	2	2	1	1	1	7
OG0011939	3	3	0	1	0	7
OG0011940	2	2	1	1	1	7
OG0011941	4	0	1	1	1	7
OG0011942	2	2	1	1	1	7
OG0011943	2	2	1	1	1	7
OG0011944	2	2	1	1	1	7
OG0011945	1	4	0	1	1	7
OG0011946	1	0	2	2	2	7
OG0011947	2	2	1	1	1	7
OG0011948	3	1	1	1	1	7
OG0011949	3	0	2	0	2	7
OG0011950	2	1	1	1	2	7
OG0011951	2	2	1	1	1	7
OG0011952	2	2	1	1	1	7
OG0011953	2	2	1	1	1	7
OG0011954	2	2	1	1	1	7
OG0011955	2	2	1	1	1	7
OG0011956	2	2	1	1	1	7
OG0011957	2	2	1	1	1	7
OG0011958	2	3	1	1	0	7
OG0011959	2	2	1	1	1	7
OG0011960	2	2	1	1	1	7
OG0011961	2	2	1	1	1	7
OG0011962	2	2	1	1	1	7
OG0011963	7	0	0	0	0	7
OG0011964	2	5	0	0	0	7
OG0011965	2	2	1	1	1	7
OG0011966	1	1	2	1	2	7
OG0011967	2	2	1	1	1	7
OG0011968	2	2	1	1	1	7
OG0011969	3	1	1	1	1	7
OG0011970	2	2	1	1	1	7
OG0011971	2	2	1	1	1	7
OG0011972	2	2	1	1	1	7
OG0011973	4	0	1	1	1	7
OG0011974	2	3	1	1	0	7
OG0011975	2	2	1	1	1	7
OG0011976	6	0	0	1	0	7
OG0011977	2	2	1	1	1	7
OG0011978	2	2	1	1	1	7
OG0011979	2	2	1	1	1	7
OG0011980	3	2	1	0	1	7
OG0011981	2	2	1	1	1	7
OG0011982	2	2	1	1	1	7
OG0011983	2	2	1	1	1	7
OG0011984	4	0	1	1	1	7
OG0011985	2	2	1	1	1	7
OG0011986	7	0	0	0	0	7
OG0011987	3	2	0	1	1	7
OG0011988	4	2	0	1	0	7
OG0011989	2	0	2	2	1	7
OG0011990	2	1	1	2	1	7
OG0011991	3	2	0	1	1	7
OG0011992	2	2	1	1	1	7
OG0011993	2	2	1	1	1	7
OG0011994	4	0	1	1	1	7
OG0011995	2	2	1	1	1	7
OG0011996	2	2	1	1	1	7
OG0011997	2	2	1	1	1	7
OG0011998	2	2	1	1	1	7
OG0011999	4	2	1	0	0	7
OG0012000	2	2	1	1	1	7
OG0012001	2	3	0	1	1	7
OG0012002	2	1	1	2	1	7
OG0012003	1	1	2	1	2	7
OG0012004	2	2	1	1	1	7
OG0012005	2	2	1	1	1	7
OG0012006	2	2	1	1	1	7
OG0012007	2	0	1	2	2	7
OG0012008	2	2	1	1	1	7
OG0012009	2	0	2	1	2	7
OG0012010	2	2	1	1	1	7
OG0012011	2	2	1	1	1	7
OG0012012	2	2	1	1	1	7
OG0012013	2	2	1	1	1	7
OG0012014	2	2	1	1	1	7
OG0012015	2	2	1	1	1	7
OG0012016	4	0	0	3	0	7
OG0012017	2	2	1	1	1	7
OG0012018	2	2	1	1	1	7
OG0012019	2	2	1	1	1	7
OG0012020	2	2	1	1	1	7
OG0012021	6	0	1	0	0	7
OG0012022	2	0	3	1	1	7
OG0012023	4	1	0	1	1	7
OG0012024	4	1	1	0	1	7
OG0012025	2	2	1	1	1	7
OG0012026	3	0	2	2	0	7
OG0012027	2	2	1	2	0	7
OG0012028	2	2	1	1	1	7
OG0012029	2	2	1	1	1	7
OG0012030	2	2	1	1	1	7
OG0012031	2	2	1	1	1	7
OG0012032	2	2	1	1	1	7
OG0012033	2	2	1	1	1	7
OG0012034	3	0	1	1	2	7
OG0012035	4	0	1	1	1	7
OG0012036	2	2	1	1	1	7
OG0012037	2	2	1	1	1	7
OG0012038	2	2	1	1	1	7
OG0012039	2	2	1	1	1	7
OG0012040	2	2	1	1	1	7
OG0012041	2	0	2	1	2	7
OG0012042	2	2	1	1	1	7
OG0012043	2	2	1	1	1	7
OG0012044	2	2	1	1	1	7
OG0012045	2	2	1	1	1	7
OG0012046	2	2	1	1	1	7
OG0012047	7	0	0	0	0	7
OG0012048	2	2	1	1	1	7
OG0012049	2	2	1	1	1	7
OG0012050	2	2	1	1	1	7
OG0012051	2	1	1	1	2	7
OG0012052	2	2	1	1	1	7
OG0012053	2	2	1	1	1	7
OG0012054	2	4	0	1	0	7
OG0012055	2	2	1	1	1	7
OG0012056	1	0	0	6	0	7
OG0012057	2	2	0	2	1	7
OG0012058	2	2	1	1	1	7
OG0012059	2	2	1	1	1	7
OG0012060	2	4	0	1	0	7
OG0012061	2	2	1	1	1	7
OG0012062	2	2	1	1	1	7
OG0012063	2	2	1	1	1	7
OG0012064	4	0	1	1	1	7
OG0012065	2	2	1	1	1	7
OG0012066	2	2	1	1	1	7
OG0012067	2	2	1	1	1	7
OG0012068	2	2	1	1	1	7
OG0012069	7	0	0	0	0	7
OG0012070	2	2	1	1	1	7
OG0012071	2	2	1	1	1	7
OG0012072	2	2	1	1	1	7
OG0012073	2	2	1	1	1	7
OG0012074	2	4	0	1	0	7
OG0012075	5	0	0	1	1	7
OG0012076	2	2	1	1	1	7
OG0012077	2	2	1	1	1	7
OG0012078	2	2	1	1	1	7
OG0012079	2	2	1	1	1	7
OG0012080	2	2	1	1	1	7
OG0012081	2	2	1	1	1	7
OG0012082	4	0	1	1	1	7
OG0012083	2	2	1	1	1	7
OG0012084	2	2	0	1	2	7
OG0012085	2	2	1	1	1	7
OG0012086	6	1	0	0	0	7
OG0012087	2	2	1	1	1	7
OG0012088	2	2	1	1	1	7
OG0012089	2	2	1	1	1	7
OG0012090	2	2	1	1	1	7
OG0012091	3	2	0	1	1	7
OG0012092	2	2	1	1	1	7
OG0012093	2	2	1	1	1	7
OG0012094	2	2	1	1	1	7
OG0012095	2	2	1	1	1	7
OG0012096	2	2	1	2	0	7
OG0012097	2	2	1	1	1	7
OG0012098	3	1	1	1	1	7
OG0012099	3	1	1	1	1	7
OG0012100	2	2	1	1	1	7
OG0012101	2	2	1	1	1	7
OG0012102	2	2	1	1	1	7
OG0012103	2	1	2	1	1	7
OG0012104	2	2	1	1	1	7
OG0012105	1	3	1	1	1	7
OG0012106	2	2	1	1	1	7
OG0012107	2	2	1	1	1	7
OG0012108	2	2	1	1	1	7
OG0012109	3	2	0	1	1	7
OG0012110	7	0	0	0	0	7
OG0012111	2	2	1	1	1	7
OG0012112	2	1	1	1	2	7
OG0012113	2	2	1	1	1	7
OG0012114	2	2	1	1	1	7
OG0012115	2	2	1	1	1	7
OG0012116	2	2	1	1	1	7
OG0012117	2	2	1	1	1	7
OG0012118	6	0	1	0	0	7
OG0012119	2	2	1	1	1	7
OG0012120	2	2	1	1	1	7
OG0012121	2	2	1	1	1	7
OG0012122	2	2	1	1	1	7
OG0012123	2	2	1	1	1	7
OG0012124	2	2	1	1	1	7
OG0012125	2	4	0	1	0	7
OG0012126	2	3	0	1	1	7
OG0012127	2	1	2	1	1	7
OG0012128	2	2	1	1	1	7
OG0012129	2	2	1	1	1	7
OG0012130	2	2	1	1	1	7
OG0012131	2	2	1	1	1	7
OG0012132	2	2	1	1	1	7
OG0012133	4	0	1	1	1	7
OG0012134	2	2	0	1	2	7
OG0012135	2	2	1	1	1	7
OG0012136	4	0	1	1	1	7
OG0012137	2	2	1	1	1	7
OG0012138	2	2	1	1	1	7
OG0012139	2	2	1	1	1	7
OG0012140	2	2	1	1	1	7
OG0012141	2	2	1	1	1	7
OG0012142	1	3	1	1	1	7
OG0012143	2	2	1	1	1	7
OG0012144	2	2	1	1	1	7
OG0012145	2	2	1	1	1	7
OG0012146	1	3	1	1	1	7
OG0012147	2	2	1	1	1	7
OG0012148	1	0	0	0	6	7
OG0012149	2	2	1	1	1	7
OG0012150	2	2	1	1	1	7
OG0012151	2	2	1	1	1	7
OG0012152	2	2	1	1	1	7
OG0012153	2	2	2	1	0	7
OG0012154	2	2	1	1	1	7
OG0012155	2	2	1	1	1	7
OG0012156	2	2	1	1	1	7
OG0012157	2	1	0	1	3	7
OG0012158	1	2	1	2	1	7
OG0012159	2	2	1	1	1	7
OG0012160	2	0	1	3	1	7
OG0012161	2	2	1	1	1	7
OG0012162	2	2	1	1	1	7
OG0012163	2	2	1	1	1	7
OG0012164	2	3	0	1	1	7
OG0012165	2	3	0	1	1	7
OG0012166	2	2	1	1	1	7
OG0012167	2	2	1	1	1	7
OG0012168	2	2	1	1	1	7
OG0012169	2	2	1	1	1	7
OG0012170	2	2	1	1	1	7
OG0012171	2	2	1	1	1	7
OG0012172	2	2	1	1	1	7
OG0012173	2	2	1	1	1	7
OG0012174	2	2	1	1	1	7
OG0012175	2	2	1	1	1	7
OG0012176	2	2	1	1	1	7
OG0012177	2	2	1	1	1	7
OG0012178	2	2	1	1	1	7
OG0012179	2	2	1	1	1	7
OG0012180	2	2	1	1	1	7
OG0012181	1	2	0	2	2	7
OG0012182	1	2	2	1	1	7
OG0012183	2	2	1	1	1	7
OG0012184	2	2	1	1	1	7
OG0012185	2	2	1	1	1	7
OG0012186	2	2	1	1	1	7
OG0012187	2	2	1	1	1	7
OG0012188	2	2	1	1	1	7
OG0012189	7	0	0	0	0	7
OG0012190	2	4	0	1	0	7
OG0012191	2	1	1	1	2	7
OG0012192	6	1	0	0	0	7
OG0012193	3	1	1	1	1	7
OG0012194	2	2	1	1	1	7
OG0012195	2	2	1	1	1	7
OG0012196	2	0	2	1	2	7
OG0012197	2	1	2	1	1	7
OG0012198	1	2	1	2	1	7
OG0012199	2	2	1	1	1	7
OG0012200	2	2	1	1	1	7
OG0012201	2	2	1	1	1	7
OG0012202	2	2	1	1	1	7
OG0012203	2	2	1	1	1	7
OG0012204	2	2	0	2	1	7
OG0012205	4	2	0	1	0	7
OG0012206	2	2	1	1	1	7
OG0012207	1	3	1	1	1	7
OG0012208	6	0	0	1	0	7
OG0012209	2	2	1	1	1	7
OG0012210	2	0	0	1	4	7
OG0012211	2	2	1	1	1	7
OG0012212	2	2	1	1	1	7
OG0012213	2	0	2	1	2	7
OG0012214	2	1	1	1	2	7
OG0012215	2	2	1	1	1	7
OG0012216	2	2	1	1	1	7
OG0012217	2	2	1	1	1	7
OG0012218	2	2	1	1	1	7
OG0012219	2	2	1	1	1	7
OG0012220	2	2	1	1	1	7
OG0012221	2	2	1	1	1	7
OG0012222	2	2	1	1	1	7
OG0012223	2	2	1	1	1	7
OG0012224	3	2	0	1	1	7
OG0012225	2	2	1	1	1	7
OG0012226	2	2	1	1	1	7
OG0012227	2	2	1	1	1	7
OG0012228	4	0	1	1	1	7
OG0012229	2	2	1	1	1	7
OG0012230	2	2	1	1	1	7
OG0012231	2	2	1	1	1	7
OG0012232	2	2	1	1	1	7
OG0012233	2	2	1	1	1	7
OG0012234	3	2	0	1	1	7
OG0012235	3	2	0	1	1	7
OG0012236	2	2	1	1	1	7
OG0012237	2	3	0	1	1	7
OG0012238	2	2	1	1	1	7
OG0012239	2	3	1	1	0	7
OG0012240	2	2	1	1	1	7
OG0012241	2	2	1	1	1	7
OG0012242	2	2	1	1	1	7
OG0012243	2	2	1	1	1	7
OG0012244	7	0	0	0	0	7
OG0012245	2	2	1	1	1	7
OG0012246	2	3	0	1	1	7
OG0012247	2	2	1	1	1	7
OG0012248	4	0	1	1	1	7
OG0012249	2	2	1	1	1	7
OG0012250	2	2	1	1	1	7
OG0012251	2	2	1	1	1	7
OG0012252	2	2	1	1	1	7
OG0012253	2	0	2	1	2	7
OG0012254	7	0	0	0	0	7
OG0012255	2	2	1	1	1	7
OG0012256	2	2	1	1	1	7
OG0012257	2	2	1	1	1	7
OG0012258	7	0	0	0	0	7
OG0012259	2	2	1	1	1	7
OG0012260	2	3	1	1	0	7
OG0012261	2	2	1	1	1	7
OG0012262	2	2	1	1	1	7
OG0012263	2	2	1	1	1	7
OG0012264	2	2	1	1	1	7
OG0012265	2	2	1	1	1	7
OG0012266	2	2	1	1	1	7
OG0012267	2	2	1	1	1	7
OG0012268	2	2	1	1	1	7
OG0012269	2	0	2	1	2	7
OG0012270	2	2	1	1	1	7
OG0012271	2	3	0	1	1	7
OG0012272	2	2	1	1	1	7
OG0012273	2	2	2	1	0	7
OG0012274	2	2	1	1	1	7
OG0012275	2	2	1	1	1	7
OG0012276	1	3	1	1	1	7
OG0012277	2	2	1	1	1	7
OG0012278	3	2	0	1	1	7
OG0012279	2	2	1	1	1	7
OG0012280	2	2	1	1	1	7
OG0012281	1	5	0	1	0	7
OG0012282	2	2	1	1	1	7
OG0012283	2	2	1	1	1	7
OG0012284	1	5	1	0	0	7
OG0012285	2	2	1	1	1	7
OG0012286	4	1	0	1	1	7
OG0012287	3	2	0	1	1	7
OG0012288	2	2	1	1	1	7
OG0012289	2	3	0	1	1	7
OG0012290	2	2	1	1	1	7
OG0012291	2	2	1	1	1	7
OG0012292	4	0	1	1	1	7
OG0012293	2	2	1	1	1	7
OG0012294	2	1	1	2	1	7
OG0012295	2	3	0	1	1	7
OG0012296	2	2	1	1	1	7
OG0012297	2	2	1	1	1	7
OG0012298	2	2	1	1	1	7
OG0012299	2	2	1	1	1	7
OG0012300	2	3	0	1	1	7
OG0012301	2	2	1	1	1	7
OG0012302	7	0	0	0	0	7
OG0012303	2	2	1	1	1	7
OG0012304	2	2	2	1	0	7
OG0012305	2	2	1	1	1	7
OG0012306	2	1	1	2	1	7
OG0012307	2	2	1	1	1	7
OG0012308	3	2	0	1	1	7
OG0012309	2	2	1	1	1	7
OG0012310	2	2	1	1	1	7
OG0012311	1	2	2	1	1	7
OG0012312	4	0	1	1	1	7
OG0012313	2	2	1	1	1	7
OG0012314	2	1	1	1	2	7
OG0012315	2	3	1	1	0	7
OG0012316	2	0	4	0	1	7
OG0012317	2	2	1	1	1	7
OG0012318	4	2	0	1	0	7
OG0012319	2	0	2	0	3	7
OG0012320	2	2	1	1	1	7
OG0012321	7	0	0	0	0	7
OG0012322	2	2	1	1	1	7
OG0012323	2	2	1	1	1	7
OG0012324	2	2	1	1	1	7
OG0012325	2	0	1	1	3	7
OG0012326	2	2	1	1	1	7
OG0012327	2	2	1	1	1	7
OG0012328	2	2	1	1	1	7
OG0012329	7	0	0	0	0	7
OG0012330	2	2	1	1	1	7
OG0012331	2	3	0	1	1	7
OG0012332	2	2	1	1	1	7
OG0012333	2	3	0	2	0	7
OG0012334	2	2	1	1	1	7
OG0012335	2	2	1	1	1	7
OG0012336	2	2	1	1	1	7
OG0012337	2	2	0	2	1	7
OG0012338	2	3	0	1	1	7
OG0012339	2	2	1	1	1	7
OG0012340	3	0	1	1	2	7
OG0012341	2	2	1	1	1	7
OG0012342	2	2	1	1	1	7
OG0012343	2	2	1	1	1	7
OG0012344	2	2	1	1	1	7
OG0012345	2	2	1	1	1	7
OG0012346	2	2	1	1	1	7
OG0012347	2	2	1	1	1	7
OG0012348	2	2	1	1	1	7
OG0012349	2	2	1	1	1	7
OG0012350	2	2	1	1	1	7
OG0012351	2	2	1	1	1	7
OG0012352	2	3	0	1	1	7
OG0012353	6	0	1	0	0	7
OG0012354	2	2	1	1	1	7
OG0012355	2	2	1	1	1	7
OG0012356	2	3	0	1	1	7
OG0012357	2	2	1	1	1	7
OG0012358	7	0	0	0	0	7
OG0012359	2	2	1	1	1	7
OG0012360	2	2	1	1	1	7
OG0012361	2	2	1	1	1	7
OG0012362	2	1	1	1	2	7
OG0012363	2	2	1	1	1	7
OG0012364	1	4	1	1	0	7
OG0012365	4	2	1	0	0	7
OG0012366	2	2	1	1	1	7
OG0012367	1	2	1	1	2	7
OG0012368	2	2	1	1	1	7
OG0012369	2	2	0	1	2	7
OG0012370	7	0	0	0	0	7
OG0012371	1	3	1	1	1	7
OG0012372	2	2	1	1	1	7
OG0012373	2	1	1	1	2	7
OG0012374	2	2	1	1	1	7
OG0012375	2	2	1	1	1	7
OG0012376	2	2	1	1	1	7
OG0012377	7	0	0	0	0	7
OG0012378	2	2	1	1	1	7
OG0012379	2	2	1	1	1	7
OG0012380	2	2	1	1	1	7
OG0012381	2	2	1	1	1	7
OG0012382	2	2	1	1	1	7
OG0012383	2	3	0	1	1	7
OG0012384	2	2	1	1	1	7
OG0012385	1	2	2	1	1	7
OG0012386	2	2	1	1	1	7
OG0012387	2	2	1	1	1	7
OG0012388	2	2	1	1	1	7
OG0012389	3	2	0	1	1	7
OG0012390	2	2	1	1	1	7
OG0012391	2	2	1	1	1	7
OG0012392	2	2	0	2	1	7
OG0012393	2	2	1	1	1	7
OG0012394	2	2	1	1	1	7
OG0012395	2	2	1	1	1	7
OG0012396	2	2	1	1	1	7
OG0012397	2	2	1	1	1	7
OG0012398	7	0	0	0	0	7
OG0012399	4	0	0	2	1	7
OG0012400	2	2	1	1	1	7
OG0012401	2	2	1	1	1	7
OG0012402	2	2	1	1	1	7
OG0012403	7	0	0	0	0	7
OG0012404	2	2	1	1	1	7
OG0012405	2	2	1	1	1	7
OG0012406	2	3	0	1	1	7
OG0012407	1	3	1	1	1	7
OG0012408	2	2	1	1	1	7
OG0012409	1	3	1	1	1	7
OG0012410	2	2	1	1	1	7
OG0012411	2	2	1	1	1	7
OG0012412	2	2	1	1	1	7
OG0012413	2	2	1	1	1	7
OG0012414	2	2	1	1	1	7
OG0012415	2	2	1	1	1	7
OG0012416	2	2	1	1	1	7
OG0012417	2	1	1	2	1	7
OG0012418	2	3	0	1	1	7
OG0012419	2	2	1	1	1	7
OG0012420	2	2	1	1	1	7
OG0012421	2	2	1	1	1	7
OG0012422	2	2	1	1	1	7
OG0012423	2	2	1	1	1	7
OG0012424	2	2	1	1	1	7
OG0012425	2	2	1	1	1	7
OG0012426	2	2	1	1	1	7
OG0012427	7	0	0	0	0	7
OG0012428	2	2	1	1	1	7
OG0012429	2	3	0	1	1	7
OG0012430	2	4	0	1	0	7
OG0012431	2	2	1	1	1	7
OG0012432	7	0	0	0	0	7
OG0012433	2	1	2	1	1	7
OG0012434	2	2	1	1	1	7
OG0012435	2	0	2	1	2	7
OG0012436	2	2	1	1	1	7
OG0012437	2	4	0	1	0	7
OG0012438	2	3	0	1	1	7
OG0012439	2	2	1	1	1	7
OG0012440	7	0	0	0	0	7
OG0012441	2	3	0	1	1	7
OG0012442	2	2	1	1	1	7
OG0012443	2	2	1	1	1	7
OG0012444	2	2	0	2	1	7
OG0012445	2	2	1	1	1	7
OG0012446	2	2	1	1	1	7
OG0012447	4	0	1	1	1	7
OG0012448	2	2	2	1	0	7
OG0012449	4	0	2	0	1	7
OG0012450	2	1	2	1	1	7
OG0012451	2	3	0	1	1	7
OG0012452	2	2	1	2	0	7
OG0012453	2	2	1	1	1	7
OG0012454	2	2	1	1	1	7
OG0012455	2	0	2	1	2	7
OG0012456	2	2	1	1	1	7
OG0012457	2	2	1	1	1	7
OG0012458	2	2	1	1	1	7
OG0012459	2	2	1	1	1	7
OG0012460	2	2	1	1	1	7
OG0012461	2	2	1	1	1	7
OG0012462	2	2	1	1	1	7
OG0012463	2	2	1	1	1	7
OG0012464	2	2	1	2	0	7
OG0012465	2	3	0	1	1	7
OG0012466	2	2	1	1	1	7
OG0012467	2	2	1	1	1	7
OG0012468	2	2	1	1	1	7
OG0012469	7	0	0	0	0	7
OG0012470	2	2	1	1	1	7
OG0012471	2	2	1	1	1	7
OG0012472	2	2	1	1	1	7
OG0012473	2	2	1	1	1	7
OG0012474	2	2	1	1	1	7
OG0012475	2	2	1	1	1	7
OG0012476	2	2	1	1	1	7
OG0012477	2	2	1	1	1	7
OG0012478	2	2	1	1	1	7
OG0012479	2	2	0	1	2	7
OG0012480	2	2	1	1	1	7
OG0012481	2	2	1	1	1	7
OG0012482	2	2	1	1	1	7
OG0012483	2	0	2	1	2	7
OG0012484	2	1	2	1	1	7
OG0012485	2	2	1	1	1	7
OG0012486	2	2	1	1	1	7
OG0012487	2	2	1	1	1	7
OG0012488	2	2	1	1	1	7
OG0012489	2	2	1	1	1	7
OG0012490	2	2	0	2	1	7
OG0012491	2	2	1	1	1	7
OG0012492	2	2	1	1	1	7
OG0012493	2	2	1	1	1	7
OG0012494	2	2	1	1	1	7
OG0012495	4	0	1	1	1	7
OG0012496	2	2	1	1	1	7
OG0012497	2	2	1	1	1	7
OG0012498	3	2	1	1	0	7
OG0012499	3	2	0	1	1	7
OG0012500	2	2	1	1	1	7
OG0012501	7	0	0	0	0	7
OG0012502	2	2	1	1	1	7
OG0012503	2	1	1	1	2	7
OG0012504	2	2	1	1	1	7
OG0012505	3	2	1	1	0	7
OG0012506	2	2	1	1	1	7
OG0012507	2	3	0	1	1	7
OG0012508	2	3	1	1	0	7
OG0012509	2	2	1	1	1	7
OG0012510	2	2	1	1	1	7
OG0012511	2	3	1	0	1	7
OG0012512	7	0	0	0	0	7
OG0012513	2	2	1	1	1	7
OG0012514	2	2	1	1	1	7
OG0012515	2	2	1	1	1	7
OG0012516	2	2	1	1	1	7
OG0012517	6	1	0	0	0	7
OG0012518	2	2	1	1	1	7
OG0012519	1	0	0	6	0	7
OG0012520	2	0	2	1	2	7
OG0012521	2	2	1	1	1	7
OG0012522	2	2	1	1	1	7
OG0012523	2	2	1	1	1	7
OG0012524	2	2	1	1	1	7
OG0012525	7	0	0	0	0	7
OG0012526	2	2	1	1	1	7
OG0012527	2	2	1	1	1	7
OG0012528	2	2	1	1	1	7
OG0012529	2	1	3	0	1	7
OG0012530	2	2	1	1	1	7
OG0012531	2	2	1	1	1	7
OG0012532	2	4	0	1	0	7
OG0012533	2	2	1	1	1	7
OG0012534	2	2	1	1	1	7
OG0012535	4	0	1	1	1	7
OG0012536	2	2	1	1	1	7
OG0012537	2	3	0	1	1	7
OG0012538	2	3	1	1	0	7
OG0012539	2	2	1	1	1	7
OG0012540	2	2	1	1	1	7
OG0012541	2	2	1	1	1	7
OG0012542	2	2	1	1	1	7
OG0012543	2	0	2	1	2	7
OG0012544	2	2	0	2	1	7
OG0012545	2	2	1	1	1	7
OG0012546	2	2	1	1	1	7
OG0012547	2	2	1	1	1	7
OG0012548	2	2	1	1	1	7
OG0012549	2	2	1	1	1	7
OG0012550	2	4	0	1	0	7
OG0012551	2	2	1	1	1	7
OG0012552	2	1	2	1	1	7
OG0012553	2	2	1	1	1	7
OG0012554	2	2	1	1	1	7
OG0012555	2	2	1	1	1	7
OG0012556	2	2	1	1	1	7
OG0012557	2	2	1	1	1	7
OG0012558	2	2	1	1	1	7
OG0012559	2	2	1	1	1	7
OG0012560	2	0	0	4	1	7
OG0012561	2	2	1	1	1	7
OG0012562	2	1	2	1	1	7
OG0012563	3	0	1	1	2	7
OG0012564	7	0	0	0	0	7
OG0012565	2	0	1	3	1	7
OG0012566	2	2	1	1	1	7
OG0012567	2	3	0	1	1	7
OG0012568	2	2	1	1	1	7
OG0012569	2	2	1	1	1	7
OG0012570	2	2	1	1	1	7
OG0012571	2	2	1	1	1	7
OG0012572	2	2	1	1	1	7
OG0012573	2	2	1	1	1	7
OG0012574	2	2	1	1	1	7
OG0012575	2	3	0	1	1	7
OG0012576	2	2	1	1	1	7
OG0012577	2	2	1	1	1	7
OG0012578	2	2	0	1	2	7
OG0012579	2	2	1	1	1	7
OG0012580	2	2	1	1	1	7
OG0012581	2	3	1	1	0	7
OG0012582	2	2	1	1	1	7
OG0012583	2	2	1	1	1	7
OG0012584	2	1	2	1	1	7
OG0012585	2	1	1	1	2	7
OG0012586	2	4	0	1	0	7
OG0012587	2	2	1	1	1	7
OG0012588	2	2	1	1	1	7
OG0012589	2	2	1	1	1	7
OG0012590	4	0	1	1	1	7
OG0012591	2	2	0	1	2	7
OG0012592	2	2	1	1	1	7
OG0012593	2	2	1	1	1	7
OG0012594	2	2	1	1	1	7
OG0012595	4	0	1	1	1	7
OG0012596	2	2	1	1	1	7
OG0012597	2	2	1	1	1	7
OG0012598	2	0	2	2	1	7
OG0012599	2	2	1	1	1	7
OG0012600	2	2	1	1	1	7
OG0012601	2	2	1	1	1	7
OG0012602	2	2	1	1	1	7
OG0012603	2	2	1	1	1	7
OG0012604	2	2	1	1	1	7
OG0012605	4	0	1	1	1	7
OG0012606	2	2	1	1	1	7
OG0012607	2	2	1	1	1	7
OG0012608	2	2	1	1	1	7
OG0012609	2	2	1	1	1	7
OG0012610	2	2	1	1	1	7
OG0012611	2	2	1	1	1	7
OG0012612	2	2	1	1	1	7
OG0012613	2	1	1	1	2	7
OG0012614	3	1	1	1	1	7
OG0012615	2	1	1	1	2	7
OG0012616	2	2	1	1	1	7
OG0012617	2	2	1	1	1	7
OG0012618	2	2	1	1	1	7
OG0012619	2	2	1	1	1	7
OG0012620	4	0	1	0	2	7
OG0012621	2	2	1	1	1	7
OG0012622	2	2	1	1	1	7
OG0012623	5	2	0	0	0	7
OG0012624	2	2	1	1	1	7
OG0012625	2	2	1	1	1	7
OG0012626	2	2	1	1	1	7
OG0012627	3	2	0	1	1	7
OG0012628	2	2	1	1	1	7
OG0012629	2	2	1	1	1	7
OG0012630	2	2	1	2	0	7
OG0012631	2	2	1	1	1	7
OG0012632	3	1	1	1	1	7
OG0012633	2	2	1	1	1	7
OG0012634	2	2	1	1	1	7
OG0012635	2	2	1	1	1	7
OG0012636	2	2	1	1	1	7
OG0012637	2	2	1	1	1	7
OG0012638	2	1	1	2	1	7
OG0012639	7	0	0	0	0	7
OG0012640	3	2	0	1	1	7
OG0012641	7	0	0	0	0	7
OG0012642	2	2	1	1	1	7
OG0012643	2	2	1	1	1	7
OG0012644	2	2	1	1	1	7
OG0012645	4	0	1	1	1	7
OG0012646	2	2	1	1	1	7
OG0012647	1	2	1	2	1	7
OG0012648	2	3	0	1	1	7
OG0012649	2	2	1	1	1	7
OG0012650	4	1	0	1	1	7
OG0012651	1	3	1	1	1	7
OG0012652	2	2	1	1	1	7
OG0012653	2	2	1	1	1	7
OG0012654	2	2	1	1	1	7
OG0012655	2	2	1	1	1	7
OG0012656	2	2	1	1	1	7
OG0012657	2	0	3	1	1	7
OG0012658	1	3	1	1	1	7
OG0012659	2	2	1	1	1	7
OG0012660	2	0	2	1	2	7
OG0012661	2	2	1	1	1	7
OG0012662	2	2	1	1	1	7
OG0012663	2	2	1	1	1	7
OG0012664	2	2	1	1	1	7
OG0012665	2	2	1	1	1	7
OG0012666	2	2	1	1	1	7
OG0012667	2	2	1	2	0	7
OG0012668	3	0	1	1	2	7
OG0012669	2	2	1	1	1	7
OG0012670	2	1	2	1	1	7
OG0012671	2	1	2	1	1	7
OG0012672	2	0	3	1	1	7
OG0012673	2	2	1	1	1	7
OG0012674	3	2	0	1	1	7
OG0012675	2	2	1	1	1	7
OG0012676	2	1	1	1	2	7
OG0012677	2	2	1	1	1	7
OG0012678	2	2	1	1	1	7
OG0012679	2	2	1	1	1	7
OG0012680	2	2	1	1	1	7
OG0012681	2	2	1	1	1	7
OG0012682	1	3	0	2	1	7
OG0012683	2	2	1	1	1	7
OG0012684	2	2	1	1	1	7
OG0012685	2	2	1	1	1	7
OG0012686	2	2	1	1	1	7
OG0012687	2	2	1	1	1	7
OG0012688	2	2	1	1	1	7
OG0012689	2	2	1	1	1	7
OG0012690	2	2	1	1	1	7
OG0012691	2	2	1	1	1	7
OG0012692	2	2	1	1	1	7
OG0012693	2	2	1	1	1	7
OG0012694	2	2	0	2	1	7
OG0012695	2	2	1	1	1	7
OG0012696	2	2	1	1	1	7
OG0012697	2	2	1	1	1	7
OG0012698	2	2	1	1	1	7
OG0012699	2	2	1	1	1	7
OG0012700	2	2	1	1	1	7
OG0012701	2	2	0	2	1	7
OG0012702	2	2	1	1	1	7
OG0012703	2	2	1	1	1	7
OG0012704	2	2	1	1	1	7
OG0012705	2	5	0	0	0	7
OG0012706	2	1	1	1	2	7
OG0012707	2	2	1	1	1	7
OG0012708	2	1	2	1	1	7
OG0012709	2	2	1	1	1	7
OG0012710	2	2	1	1	1	7
OG0012711	2	2	1	1	1	7
OG0012712	2	2	1	1	1	7
OG0012713	2	3	0	1	1	7
OG0012714	2	2	1	1	1	7
OG0012715	2	2	1	1	1	7
OG0012716	2	2	0	2	1	7
OG0012717	4	0	1	1	1	7
OG0012718	2	2	1	1	1	7
OG0012719	2	0	0	5	0	7
OG0012720	2	2	1	1	1	7
OG0012721	2	2	1	1	1	7
OG0012722	2	2	1	1	1	7
OG0012723	2	2	1	1	1	7
OG0012724	2	0	0	4	1	7
OG0012725	2	2	1	1	1	7
OG0012726	1	3	2	0	1	7
OG0012727	2	1	1	2	1	7
OG0012728	1	3	1	1	1	7
OG0012729	2	2	1	1	1	7
OG0012730	2	2	1	1	1	7
OG0012731	2	2	1	1	1	7
OG0012732	2	1	2	1	1	7
OG0012733	1	2	1	1	2	7
OG0012734	2	2	1	1	1	7
OG0012735	2	3	0	1	1	7
OG0012736	2	5	0	0	0	7
OG0012737	2	2	1	1	1	7
OG0012738	2	3	0	1	1	7
OG0012739	2	2	1	1	1	7
OG0012740	2	2	1	1	1	7
OG0012741	2	4	0	1	0	7
OG0012742	2	2	1	1	1	7
OG0012743	2	2	1	1	1	7
OG0012744	2	2	1	1	1	7
OG0012745	2	2	1	1	1	7
OG0012746	2	2	1	1	1	7
OG0012747	4	0	1	2	0	7
OG0012748	2	2	1	1	1	7
OG0012749	2	2	1	1	1	7
OG0012750	2	2	1	1	1	7
OG0012751	2	1	1	2	1	7
OG0012752	2	2	1	1	1	7
OG0012753	2	2	1	1	1	7
OG0012754	2	2	1	1	1	7
OG0012755	2	2	1	1	1	7
OG0012756	2	2	1	1	1	7
OG0012757	2	0	1	2	2	7
OG0012758	2	2	1	1	1	7
OG0012759	3	2	0	1	1	7
OG0012760	2	2	1	1	1	7
OG0012761	4	1	0	1	1	7
OG0012762	2	2	1	1	1	7
OG0012763	2	2	1	1	1	7
OG0012764	2	2	1	1	1	7
OG0012765	2	2	1	1	1	7
OG0012766	2	2	1	1	1	7
OG0012767	2	2	1	1	1	7
OG0012768	4	0	1	1	1	7
OG0012769	1	4	0	1	1	7
OG0012770	2	2	1	1	1	7
OG0012771	2	2	1	1	1	7
OG0012772	2	2	1	1	1	7
OG0012773	2	2	1	1	1	7
OG0012774	2	2	1	1	1	7
OG0012775	2	2	1	1	1	7
OG0012776	2	2	1	1	1	7
OG0012777	7	0	0	0	0	7
OG0012778	2	2	1	1	1	7
OG0012779	3	2	0	1	1	7
OG0012780	2	2	1	1	1	7
OG0012781	2	2	1	1	1	7
OG0012782	2	2	1	1	1	7
OG0012783	2	3	0	1	1	7
OG0012784	2	0	1	2	2	7
OG0012785	2	3	1	1	0	7
OG0012786	2	2	1	1	1	7
OG0012787	4	0	1	1	1	7
OG0012788	2	0	2	1	2	7
OG0012789	2	2	1	1	1	7
OG0012790	2	2	1	1	1	7
OG0012791	4	2	0	1	0	7
OG0012792	2	2	1	1	1	7
OG0012793	2	2	1	1	1	7
OG0012794	3	1	1	1	1	7
OG0012795	2	2	1	1	1	7
OG0012796	1	6	0	0	0	7
OG0012797	2	2	2	0	1	7
OG0012798	2	2	1	1	1	7
OG0012799	2	2	1	1	1	7
OG0012800	2	2	1	1	1	7
OG0012801	2	1	2	1	1	7
OG0012802	2	2	1	1	1	7
OG0012803	2	2	1	1	1	7
OG0012804	2	2	1	1	1	7
OG0012805	2	2	1	1	1	7
OG0012806	2	0	2	1	2	7
OG0012807	2	2	1	1	1	7
OG0012808	2	2	1	1	1	7
OG0012809	1	4	1	0	1	7
OG0012810	2	2	1	1	1	7
OG0012811	2	2	1	1	1	7
OG0012812	2	2	1	1	1	7
OG0012813	2	4	0	1	0	7
OG0012814	2	2	1	1	1	7
OG0012815	2	2	1	1	1	7
OG0012816	2	2	1	1	1	7
OG0012817	2	2	1	1	1	7
OG0012818	2	2	1	1	1	7
OG0012819	2	2	1	1	1	7
OG0012820	2	1	1	2	1	7
OG0012821	2	3	1	1	0	7
OG0012822	2	2	1	1	1	7
OG0012823	2	2	1	1	1	7
OG0012824	2	2	1	1	1	7
OG0012825	2	2	1	1	1	7
OG0012826	2	2	1	1	1	7
OG0012827	4	2	0	1	0	7
OG0012828	2	2	1	1	1	7
OG0012829	2	2	1	1	1	7
OG0012830	2	2	1	1	1	7
OG0012831	2	2	1	1	1	7
OG0012832	2	2	1	1	1	7
OG0012833	4	1	0	1	1	7
OG0012834	2	1	2	1	1	7
OG0012835	2	2	1	1	1	7
OG0012836	2	2	1	1	1	7
OG0012837	2	2	1	1	1	7
OG0012838	2	2	1	1	1	7
OG0012839	2	2	1	1	1	7
OG0012840	2	1	2	1	1	7
OG0012841	2	2	1	1	1	7
OG0012842	2	2	1	1	1	7
OG0012843	2	2	1	1	1	7
OG0012844	1	3	0	2	1	7
OG0012845	2	0	2	1	2	7
OG0012846	2	2	1	1	1	7
OG0012847	2	2	1	1	1	7
OG0012848	2	2	1	1	1	7
OG0012849	2	2	1	1	1	7
OG0012850	2	2	1	1	1	7
OG0012851	2	2	1	1	1	7
OG0012852	2	2	1	1	1	7
OG0012853	2	2	1	1	1	7
OG0012854	2	2	1	1	1	7
OG0012855	2	2	1	1	1	7
OG0012856	2	2	1	1	1	7
OG0012857	2	2	1	1	1	7
OG0012858	3	1	1	1	1	7
OG0012859	2	2	1	1	1	7
OG0012860	2	2	1	1	1	7
OG0012861	2	2	1	1	1	7
OG0012862	2	2	1	1	1	7
OG0012863	2	4	0	1	0	7
OG0012864	2	1	1	1	2	7
OG0012865	2	2	1	1	1	7
OG0012866	2	2	1	1	1	7
OG0012867	2	2	1	1	1	7
OG0012868	2	2	1	1	1	7
OG0012869	2	1	1	2	1	7
OG0012870	2	2	1	1	1	7
OG0012871	2	0	2	1	2	7
OG0012872	2	2	1	1	1	7
OG0012873	1	2	1	2	1	7
OG0012874	2	2	1	1	1	7
OG0012875	2	4	0	0	1	7
OG0012876	2	2	1	1	1	7
OG0012877	2	2	1	1	1	7
OG0012878	2	2	1	1	1	7
OG0012879	2	0	2	1	2	7
OG0012880	2	2	1	1	1	7
OG0012881	2	2	1	1	1	7
OG0012882	2	2	1	1	1	7
OG0012883	2	1	1	1	2	7
OG0012884	2	2	1	1	1	7
OG0012885	2	2	1	1	1	7
OG0012886	2	2	1	1	1	7
OG0012887	2	2	1	1	1	7
OG0012888	2	3	0	1	1	7
OG0012889	2	2	1	1	1	7
OG0012890	2	2	1	1	1	7
OG0012891	3	2	0	1	1	7
OG0012892	2	1	1	2	1	7
OG0012893	2	2	1	1	1	7
OG0012894	2	2	1	1	1	7
OG0012895	2	2	1	1	1	7
OG0012896	2	2	1	1	1	7
OG0012897	1	1	2	1	2	7
OG0012898	2	2	1	1	1	7
OG0012899	2	2	1	1	1	7
OG0012900	2	1	2	1	1	7
OG0012901	7	0	0	0	0	7
OG0012902	2	2	1	1	1	7
OG0012903	7	0	0	0	0	7
OG0012904	1	3	1	1	1	7
OG0012905	2	2	1	1	1	7
OG0012906	6	0	1	0	0	7
OG0012907	1	2	2	1	1	7
OG0012908	2	2	1	1	1	7
OG0012909	2	1	2	1	1	7
OG0012910	2	2	1	1	1	7
OG0012911	2	2	1	1	1	7
OG0012912	1	3	1	1	1	7
OG0012913	2	0	2	1	2	7
OG0012914	2	2	0	1	2	7
OG0012915	2	4	0	1	0	7
OG0012916	3	1	1	1	1	7
OG0012917	2	2	0	2	1	7
OG0012918	2	0	3	1	1	7
OG0012919	2	2	1	1	1	7
OG0012920	2	2	1	1	1	7
OG0012921	2	2	1	1	1	7
OG0012922	2	2	1	1	1	7
OG0012923	2	2	1	1	1	7
OG0012924	2	2	1	1	1	7
OG0012925	2	2	1	1	1	7
OG0012926	2	0	2	1	2	7
OG0012927	2	2	1	1	1	7
OG0012928	2	2	1	1	1	7
OG0012929	2	2	1	1	1	7
OG0012930	2	2	1	1	1	7
OG0012931	2	2	1	1	1	7
OG0012932	2	2	1	1	1	7
OG0012933	2	2	1	1	1	7
OG0012934	2	2	1	1	1	7
OG0012935	2	2	1	1	1	7
OG0012936	2	3	0	1	1	7
OG0012937	2	2	1	1	1	7
OG0012938	3	1	1	1	1	7
OG0012939	2	0	2	1	2	7
OG0012940	2	2	1	1	1	7
OG0012941	2	2	1	1	1	7
OG0012942	2	2	1	1	1	7
OG0012943	2	2	1	1	1	7
OG0012944	2	2	1	1	1	7
OG0012945	2	2	1	1	1	7
OG0012946	2	4	0	1	0	7
OG0012947	4	0	1	2	0	7
OG0012948	2	2	1	1	1	7
OG0012949	2	2	1	1	1	7
OG0012950	2	2	1	1	1	7
OG0012951	2	0	2	1	2	7
OG0012952	2	2	1	1	1	7
OG0012953	2	2	1	1	1	7
OG0012954	2	2	1	1	1	7
OG0012955	2	2	1	1	1	7
OG0012956	2	4	0	1	0	7
OG0012957	2	2	1	1	1	7
OG0012958	2	2	1	1	1	7
OG0012959	2	2	1	1	1	7
OG0012960	2	2	1	1	1	7
OG0012961	2	2	1	1	1	7
OG0012962	2	2	1	1	1	7
OG0012963	2	2	1	1	1	7
OG0012964	3	2	0	1	1	7
OG0012965	2	2	1	1	1	7
OG0012966	2	2	1	1	1	7
OG0012967	2	2	1	1	1	7
OG0012968	1	3	1	1	1	7
OG0012969	2	2	1	1	1	7
OG0012970	3	2	0	1	1	7
OG0012971	2	2	1	1	1	7
OG0012972	1	5	0	1	0	7
OG0012973	2	5	0	0	0	7
OG0012974	2	2	1	1	1	7
OG0012975	2	2	1	1	1	7
OG0012976	2	2	1	1	1	7
OG0012977	2	2	1	1	1	7
OG0012978	2	2	1	1	1	7
OG0012979	2	2	1	1	1	7
OG0012980	2	3	1	1	0	7
OG0012981	2	2	1	1	1	7
OG0012982	2	2	1	1	1	7
OG0012983	2	2	1	1	1	7
OG0012984	2	3	0	1	1	7
OG0012985	2	2	1	1	1	7
OG0012986	2	2	1	1	1	7
OG0012987	2	2	1	1	1	7
OG0012988	3	1	1	1	1	7
OG0012989	2	2	1	1	1	7
OG0012990	2	2	1	1	1	7
OG0012991	2	3	0	1	1	7
OG0012992	2	2	1	1	1	7
OG0012993	2	2	1	1	1	7
OG0012994	2	2	1	1	1	7
OG0012995	2	2	1	1	1	7
OG0012996	2	2	1	1	1	7
OG0012997	3	2	1	1	0	7
OG0012998	2	2	1	1	1	7
OG0012999	2	2	1	1	1	7
OG0013000	3	2	0	1	1	7
OG0013001	2	2	1	1	1	7
OG0013002	2	2	1	1	1	7
OG0013003	2	2	1	1	1	7
OG0013004	2	2	1	1	1	7
OG0013005	2	2	1	1	1	7
OG0013006	2	2	1	1	1	7
OG0013007	1	4	1	1	0	7
OG0013008	2	2	1	1	1	7
OG0013009	2	2	1	1	1	7
OG0013010	2	2	1	1	1	7
OG0013011	2	2	1	1	1	7
OG0013012	2	2	1	1	1	7
OG0013013	2	0	2	1	2	7
OG0013014	2	2	1	1	1	7
OG0013015	1	6	0	0	0	7
OG0013016	2	2	1	1	1	7
OG0013017	1	2	2	1	1	7
OG0013018	2	2	1	1	1	7
OG0013019	2	2	1	1	1	7
OG0013020	1	2	2	1	1	7
OG0013021	2	2	1	1	1	7
OG0013022	2	2	1	1	1	7
OG0013023	2	2	1	1	1	7
OG0013024	2	2	1	1	1	7
OG0013025	2	2	1	1	1	7
OG0013026	2	0	3	1	1	7
OG0013027	2	2	1	1	1	7
OG0013028	2	2	1	1	1	7
OG0013029	2	3	0	1	1	7
OG0013030	2	4	0	1	0	7
OG0013031	2	2	1	1	1	7
OG0013032	2	2	1	1	1	7
OG0013033	3	1	1	1	1	7
OG0013034	2	2	1	1	1	7
OG0013035	1	2	1	2	1	7
OG0013036	2	0	1	2	2	7
OG0013037	2	0	3	1	1	7
OG0013038	2	2	1	1	1	7
OG0013039	2	2	1	1	1	7
OG0013040	2	0	4	0	1	7
OG0013041	2	2	1	1	1	7
OG0013042	2	2	1	1	1	7
OG0013043	2	2	1	1	1	7
OG0013044	2	2	1	1	1	7
OG0013045	2	2	1	1	1	7
OG0013046	2	2	1	1	1	7
OG0013047	2	2	1	1	1	7
OG0013048	2	2	1	1	1	7
OG0013049	2	3	1	1	0	7
OG0013050	4	2	0	0	1	7
OG0013051	2	2	1	1	1	7
OG0013052	2	2	1	1	1	7
OG0013053	2	2	1	1	1	7
OG0013054	2	4	0	1	0	7
OG0013055	2	4	0	1	0	7
OG0013056	2	2	1	1	1	7
OG0013057	1	0	3	1	2	7
OG0013058	2	3	0	1	1	7
OG0013059	1	4	0	1	1	7
OG0013060	2	2	1	1	1	7
OG0013061	2	3	0	1	1	7
OG0013062	2	2	1	1	1	7
OG0013063	2	1	1	2	1	7
OG0013064	2	2	1	1	1	7
OG0013065	2	2	1	1	1	7
OG0013066	2	2	1	1	1	7
OG0013067	2	2	1	1	1	7
OG0013068	2	2	1	1	1	7
OG0013069	2	2	1	1	1	7
OG0013070	2	2	1	1	1	7
OG0013071	7	0	0	0	0	7
OG0013072	1	3	1	1	1	7
OG0013073	1	3	1	1	1	7
OG0013074	2	3	0	0	2	7
OG0013075	2	2	1	1	1	7
OG0013076	1	1	1	2	2	7
OG0013077	2	2	1	1	1	7
OG0013078	2	4	0	1	0	7
OG0013079	1	2	2	1	1	7
OG0013080	1	4	1	1	0	7
OG0013081	7	0	0	0	0	7
OG0013082	1	2	1	2	1	7
OG0013083	1	1	1	1	3	7
OG0013084	1	3	1	1	1	7
OG0013085	6	0	1	0	0	7
OG0013086	2	2	1	1	1	7
OG0013087	6	1	0	0	0	7
OG0013088	2	2	1	1	1	7
OG0013089	2	2	1	1	1	7
OG0013090	2	2	1	1	1	7
OG0013091	2	2	1	1	1	7
OG0013092	2	2	1	1	1	7
OG0013093	2	2	1	1	1	7
OG0013094	2	2	1	1	1	7
OG0013095	2	2	1	1	1	7
OG0013096	2	2	1	1	1	7
OG0013097	1	3	1	1	1	7
OG0013098	2	3	1	0	1	7
OG0013099	2	2	1	1	1	7
OG0013100	2	2	1	1	1	7
OG0013101	4	0	1	1	1	7
OG0013102	7	0	0	0	0	7
OG0013103	2	1	1	1	2	7
OG0013104	2	2	1	1	1	7
OG0013105	2	2	1	1	1	7
OG0013106	7	0	0	0	0	7
OG0013107	2	2	1	1	1	7
OG0013108	4	0	1	1	1	7
OG0013109	2	2	1	1	1	7
OG0013110	2	2	1	1	1	7
OG0013111	2	2	1	1	1	7
OG0013112	2	2	1	1	1	7
OG0013113	3	2	1	1	0	7
OG0013114	2	2	1	1	1	7
OG0013115	2	2	1	1	1	7
OG0013116	2	2	1	1	1	7
OG0013117	2	2	1	1	1	7
OG0013118	2	3	1	0	1	7
OG0013119	2	0	1	2	2	7
OG0013120	2	2	1	1	1	7
OG0013121	2	2	1	1	1	7
OG0013122	2	2	1	1	1	7
OG0013123	2	2	1	1	1	7
OG0013124	2	2	1	1	1	7
OG0013125	2	0	4	0	1	7
OG0013126	2	2	1	1	1	7
OG0013127	2	2	1	1	1	7
OG0013128	2	2	1	1	1	7
OG0013129	2	2	1	1	1	7
OG0013130	2	0	1	2	2	7
OG0013131	2	0	2	1	2	7
OG0013132	2	4	0	1	0	7
OG0013133	2	2	1	1	1	7
OG0013134	2	2	1	1	1	7
OG0013135	2	2	1	1	1	7
OG0013136	2	2	1	1	1	7
OG0013137	2	2	1	2	0	7
OG0013138	1	3	1	1	1	7
OG0013139	2	2	1	1	1	7
OG0013140	2	2	1	1	1	7
OG0013141	2	2	1	1	1	7
OG0013142	2	2	1	1	1	7
OG0013143	2	2	1	1	1	7
OG0013144	2	2	1	1	1	7
OG0013145	2	2	0	1	2	7
OG0013146	2	2	1	1	1	7
OG0013147	2	2	1	1	1	7
OG0013148	2	2	1	1	1	7
OG0013149	2	2	1	1	1	7
OG0013150	2	2	1	1	1	7
OG0013151	2	2	1	1	1	7
OG0013152	1	4	0	1	1	7
OG0013153	2	2	1	1	1	7
OG0013154	2	2	1	1	1	7
OG0013155	2	3	0	1	1	7
OG0013156	2	0	2	1	2	7
OG0013157	2	2	1	1	1	7
OG0013158	2	4	0	1	0	7
OG0013159	2	0	1	3	1	7
OG0013160	2	2	1	1	1	7
OG0013161	2	2	1	1	1	7
OG0013162	1	3	1	1	1	7
OG0013163	1	3	1	1	1	7
OG0013164	4	1	2	0	0	7
OG0013165	1	3	1	1	1	7
OG0013166	1	2	1	2	1	7
OG0013167	1	2	0	3	1	7
OG0013168	1	3	1	1	1	7
OG0013169	2	2	1	1	1	7
OG0013170	1	2	2	1	1	7
OG0013171	1	5	0	1	0	7
OG0013172	2	0	2	1	2	7
OG0013173	1	1	2	1	2	7
OG0013174	1	1	1	2	2	7
OG0013175	1	0	2	1	3	7
OG0013176	1	3	1	1	1	7
OG0013177	2	2	1	1	1	7
OG0013178	1	2	2	1	1	7
OG0013179	1	3	1	1	1	7
OG0013180	1	5	1	0	0	7
OG0013181	1	2	1	1	2	7
OG0013182	1	2	1	2	1	7
OG0013183	1	2	2	1	1	7
OG0013184	1	3	1	1	1	7
OG0013185	2	2	1	1	1	7
OG0013186	2	2	1	1	1	7
OG0013187	2	2	1	1	1	7
OG0013188	2	2	1	1	1	7
OG0013189	2	2	1	1	1	7
OG0013190	2	2	1	1	1	7
OG0013191	2	4	0	1	0	7
OG0013192	2	2	1	1	1	7
OG0013193	2	2	1	1	1	7
OG0013194	2	2	1	1	1	7
OG0013195	2	3	0	1	1	7
OG0013196	2	1	2	1	1	7
OG0013197	2	2	1	1	1	7
OG0013198	2	2	0	2	1	7
OG0013199	2	2	1	1	1	7
OG0013200	2	2	1	1	1	7
OG0013201	2	2	1	1	1	7
OG0013202	2	2	1	1	1	7
OG0013203	2	2	1	1	1	7
OG0013204	2	2	1	1	1	7
OG0013205	2	0	1	0	4	7
OG0013206	2	2	1	1	1	7
OG0013207	3	2	1	1	0	7
OG0013208	2	0	2	1	2	7
OG0013209	2	3	0	1	1	7
OG0013210	2	2	1	1	1	7
OG0013211	2	2	1	1	1	7
OG0013212	2	2	1	1	1	7
OG0013213	7	0	0	0	0	7
OG0013214	1	4	1	1	0	7
OG0013215	7	0	0	0	0	7
OG0013216	2	2	1	1	1	7
OG0013217	2	2	1	1	1	7
OG0013218	2	2	1	1	1	7
OG0013219	2	2	1	1	1	7
OG0013220	2	2	1	1	1	7
OG0013221	2	1	1	1	2	7
OG0013222	2	2	1	1	1	7
OG0013223	2	2	1	1	1	7
OG0013224	4	0	1	1	1	7
OG0013225	2	2	1	1	1	7
OG0013226	2	2	1	1	1	7
OG0013227	2	2	1	1	1	7
OG0013228	2	2	1	1	1	7
OG0013229	2	2	1	1	1	7
OG0013230	3	2	1	1	0	7
OG0013231	2	2	1	1	1	7
OG0013232	2	2	1	1	1	7
OG0013233	2	2	1	1	1	7
OG0013234	2	2	1	1	1	7
OG0013235	2	2	1	1	1	7
OG0013236	2	2	1	1	1	7
OG0013237	2	2	1	1	1	7
OG0013238	2	2	1	1	1	7
OG0013239	2	2	1	1	1	7
OG0013240	2	2	1	1	1	7
OG0013241	2	2	1	1	1	7
OG0013242	2	2	1	1	1	7
OG0013243	2	2	1	1	1	7
OG0013244	2	4	0	1	0	7
OG0013245	2	2	1	1	1	7
OG0013246	2	2	1	1	1	7
OG0013247	2	2	1	1	1	7
OG0013248	2	2	1	1	1	7
OG0013249	3	2	0	1	1	7
OG0013250	2	0	0	5	0	7
OG0013251	2	0	3	1	1	7
OG0013252	2	2	1	1	1	7
OG0013253	2	2	1	1	1	7
OG0013254	2	2	1	1	1	7
OG0013255	4	0	1	1	1	7
OG0013256	2	2	1	1	1	7
OG0013257	1	3	1	1	1	7
OG0013258	2	1	2	1	1	7
OG0013259	2	1	1	1	2	7
OG0013260	2	2	1	1	1	7
OG0013261	2	2	1	1	1	7
OG0013262	2	2	1	1	1	7
OG0013263	1	2	1	2	1	7
OG0013264	2	2	1	1	1	7
OG0013265	2	2	1	1	1	7
OG0013266	2	2	1	1	1	7
OG0013267	2	1	1	2	1	7
OG0013268	2	2	1	1	1	7
OG0013269	2	2	1	1	1	7
OG0013270	2	2	1	1	1	7
OG0013271	2	2	1	1	1	7
OG0013272	2	2	1	1	1	7
OG0013273	2	0	2	3	0	7
OG0013274	2	2	1	1	1	7
OG0013275	2	2	1	1	1	7
OG0013276	2	0	2	1	2	7
OG0013277	2	2	1	1	1	7
OG0013278	2	2	1	1	1	7
OG0013279	2	2	1	1	1	7
OG0013280	2	2	1	1	1	7
OG0013281	2	2	0	1	2	7
OG0013282	2	2	1	1	1	7
OG0013283	2	2	1	1	1	7
OG0013284	1	3	1	1	1	7
OG0013285	2	2	1	1	1	7
OG0013286	2	0	2	1	2	7
OG0013287	2	2	1	1	1	7
OG0013288	2	2	1	1	1	7
OG0013289	2	3	0	1	1	7
OG0013290	2	2	1	1	1	7
OG0013291	2	3	1	0	1	7
OG0013292	2	2	1	1	1	7
OG0013293	2	2	1	1	1	7
OG0013294	2	2	1	1	1	7
OG0013295	2	3	0	1	1	7
OG0013296	2	1	1	2	1	7
OG0013297	2	2	1	1	1	7
OG0013298	2	1	1	2	1	7
OG0013299	2	2	1	1	1	7
OG0013300	4	0	1	1	1	7
OG0013301	1	0	5	0	1	7
OG0013302	2	2	1	1	1	7
OG0013303	2	2	1	1	1	7
OG0013304	1	1	4	0	1	7
OG0013305	2	2	1	1	1	7
OG0013306	3	2	0	1	1	7
OG0013307	2	2	1	1	1	7
OG0013308	1	0	3	1	2	7
OG0013309	2	2	2	0	1	7
OG0013310	2	2	1	1	1	7
OG0013311	2	2	1	1	1	7
OG0013312	2	2	1	1	1	7
OG0013313	2	3	0	1	1	7
OG0013314	2	2	1	1	1	7
OG0013315	2	2	1	1	1	7
OG0013316	2	2	1	1	1	7
OG0013317	2	2	1	1	1	7
OG0013318	2	1	1	1	2	7
OG0013319	2	2	1	1	1	7
OG0013320	2	2	1	1	1	7
OG0013321	2	2	1	1	1	7
OG0013322	2	2	1	1	1	7
OG0013323	2	2	1	1	1	7
OG0013324	2	2	1	1	1	7
OG0013325	2	2	1	1	1	7
OG0013326	2	2	1	1	1	7
OG0013327	2	3	0	2	0	7
OG0013328	2	2	1	1	1	7
OG0013329	2	2	1	1	1	7
OG0013330	2	2	1	1	1	7
OG0013331	1	3	1	1	1	7
OG0013332	1	2	2	1	1	7
OG0013333	1	5	0	1	0	7
OG0013334	1	2	2	1	1	7
OG0013335	1	3	2	1	0	7
OG0013336	1	3	1	1	1	7
OG0013337	1	0	1	4	1	7
OG0013338	1	1	2	0	3	7
OG0013339	1	2	2	1	1	7
OG0013340	1	2	1	1	2	7
OG0013341	1	2	1	1	2	7
OG0013342	1	4	0	1	1	7
OG0013343	1	2	1	1	2	7
OG0013344	1	3	1	1	1	7
OG0013345	1	4	1	1	0	7
OG0013346	1	3	1	2	0	7
OG0013347	1	4	0	1	1	7
OG0013348	1	2	2	1	1	7
OG0013349	1	2	1	2	1	7
OG0013350	1	3	1	1	1	7
OG0013351	1	3	1	1	1	7
OG0013352	1	3	1	1	1	7
OG0013353	1	2	1	2	1	7
OG0013354	1	3	1	1	1	7
OG0013355	1	0	0	0	6	7
OG0013356	2	3	0	1	1	7
OG0013357	1	6	0	0	0	7
OG0013358	1	2	1	2	1	7
OG0013359	2	5	0	0	0	7
OG0013360	1	6	0	0	0	7
OG0013361	1	2	2	1	1	7
OG0013362	1	3	1	1	1	7
OG0013363	1	2	1	2	1	7
OG0013364	1	2	1	2	1	7
OG0013365	2	2	1	1	1	7
OG0013366	2	2	1	1	1	7
OG0013367	2	2	1	1	1	7
OG0013368	2	2	1	1	1	7
OG0013369	2	2	0	2	1	7
OG0013370	2	2	1	1	1	7
OG0013371	2	2	1	1	1	7
OG0013372	2	2	1	1	1	7
OG0013373	2	2	1	1	1	7
OG0013374	2	2	1	1	1	7
OG0013375	1	1	2	1	2	7
OG0013376	2	2	1	1	1	7
OG0013377	1	2	1	2	1	7
OG0013378	2	3	0	1	1	7
OG0013379	1	2	2	1	1	7
OG0013380	2	3	0	1	1	7
OG0013381	1	2	1	2	1	7
OG0013382	1	4	1	0	1	7
OG0013383	1	2	1	2	1	7
OG0013384	2	3	0	1	1	7
OG0013385	1	0	6	0	0	7
OG0013386	2	2	1	1	1	7
OG0013387	1	3	1	1	1	7
OG0013388	1	6	0	0	0	7
OG0013389	1	1	2	1	2	7
OG0013390	1	4	0	1	1	7
OG0013391	1	4	0	2	0	7
OG0013392	1	2	1	2	1	7
OG0013393	1	3	1	1	1	7
OG0013394	1	6	0	0	0	7
OG0013395	1	2	1	2	1	7
OG0013396	1	3	1	1	1	7
OG0013397	0	7	0	0	0	7
OG0013398	0	7	0	0	0	7
OG0013399	0	4	1	1	1	7
OG0013400	0	7	0	0	0	7
OG0013401	0	4	1	1	1	7
OG0013402	0	7	0	0	0	7
OG0013403	0	4	0	0	3	7
OG0013404	0	7	0	0	0	7
OG0013405	0	3	1	1	2	7
OG0013406	0	7	0	0	0	7
OG0013407	0	7	0	0	0	7
OG0013408	0	7	0	0	0	7
OG0013409	0	7	0	0	0	7
OG0013410	0	2	2	1	2	7
OG0013411	0	6	0	1	0	7
OG0013412	0	7	0	0	0	7
OG0013413	0	7	0	0	0	7
OG0013414	0	6	0	0	1	7
OG0013415	0	7	0	0	0	7
OG0013416	0	7	0	0	0	7
OG0013417	0	7	0	0	0	7
OG0013418	0	7	0	0	0	7
OG0013419	0	7	0	0	0	7
OG0013420	0	3	3	0	1	7
OG0013421	0	7	0	0	0	7
OG0013422	0	7	0	0	0	7
OG0013423	0	4	1	1	1	7
OG0013424	0	7	0	0	0	7
OG0013425	0	7	0	0	0	7
OG0013426	0	7	0	0	0	7
OG0013427	0	7	0	0	0	7
OG0013428	0	7	0	0	0	7
OG0013429	0	7	0	0	0	7
OG0013430	0	7	0	0	0	7
OG0013431	0	7	0	0	0	7
OG0013432	0	4	1	1	1	7
OG0013433	0	7	0	0	0	7
OG0013434	0	4	1	1	1	7
OG0013435	0	7	0	0	0	7
OG0013436	0	6	0	1	0	7
OG0013437	0	7	0	0	0	7
OG0013438	0	4	1	1	1	7
OG0013439	0	7	0	0	0	7
OG0013440	0	7	0	0	0	7
OG0013441	0	7	0	0	0	7
OG0013442	0	4	1	1	1	7
OG0013443	0	4	1	1	1	7
OG0013444	0	7	0	0	0	7
OG0013445	0	7	0	0	0	7
OG0013446	0	7	0	0	0	7
OG0013447	0	4	1	1	1	7
OG0013448	0	7	0	0	0	7
OG0013449	0	7	0	0	0	7
OG0013450	0	4	1	1	1	7
OG0013451	0	5	1	1	0	7
OG0013452	0	7	0	0	0	7
OG0013453	0	7	0	0	0	7
OG0013454	0	7	0	0	0	7
OG0013455	0	7	0	0	0	7
OG0013456	0	6	0	1	0	7
OG0013457	0	7	0	0	0	7
OG0013458	0	7	0	0	0	7
OG0013459	0	7	0	0	0	7
OG0013460	0	7	0	0	0	7
OG0013461	0	7	0	0	0	7
OG0013462	0	7	0	0	0	7
OG0013463	0	6	0	0	1	7
OG0013464	0	7	0	0	0	7
OG0013465	0	7	0	0	0	7
OG0013466	0	7	0	0	0	7
OG0013467	0	7	0	0	0	7
OG0013468	0	7	0	0	0	7
OG0013469	0	6	0	1	0	7
OG0013470	0	4	1	1	1	7
OG0013471	0	3	2	1	1	7
OG0013472	0	4	1	1	1	7
OG0013473	0	7	0	0	0	7
OG0013474	0	7	0	0	0	7
OG0013475	0	2	2	1	2	7
OG0013476	0	7	0	0	0	7
OG0013477	0	7	0	0	0	7
OG0013478	0	2	2	1	2	7
OG0013479	0	7	0	0	0	7
OG0013480	0	7	0	0	0	7
OG0013481	0	7	0	0	0	7
OG0013482	0	7	0	0	0	7
OG0013483	0	7	0	0	0	7
OG0013484	0	7	0	0	0	7
OG0013485	0	7	0	0	0	7
OG0013486	0	5	0	1	1	7
OG0013487	0	7	0	0	0	7
OG0013488	0	7	0	0	0	7
OG0013489	0	7	0	0	0	7
OG0013490	0	7	0	0	0	7
OG0013491	0	7	0	0	0	7
OG0013492	0	4	0	3	0	7
OG0013493	0	7	0	0	0	7
OG0013494	0	7	0	0	0	7
OG0013495	0	7	0	0	0	7
OG0013496	0	7	0	0	0	7
OG0013497	0	6	0	0	1	7
OG0013498	0	7	0	0	0	7
OG0013499	0	7	0	0	0	7
OG0013500	0	7	0	0	0	7
OG0013501	0	7	0	0	0	7
OG0013502	0	7	0	0	0	7
OG0013503	0	4	1	1	1	7
OG0013504	0	7	0	0	0	7
OG0013505	0	4	1	1	1	7
OG0013506	0	7	0	0	0	7
OG0013507	0	7	0	0	0	7
OG0013508	0	7	0	0	0	7
OG0013509	0	2	2	1	2	7
OG0013510	0	7	0	0	0	7
OG0013511	0	7	0	0	0	7
OG0013512	0	7	0	0	0	7
OG0013513	0	4	1	1	1	7
OG0013514	0	7	0	0	0	7
OG0013515	0	7	0	0	0	7
OG0013516	0	7	0	0	0	7
OG0013517	0	7	0	0	0	7
OG0013518	0	2	3	1	1	7
OG0013519	0	7	0	0	0	7
OG0013520	0	7	0	0	0	7
OG0013521	0	7	0	0	0	7
OG0013522	0	7	0	0	0	7
OG0013523	0	7	0	0	0	7
OG0013524	0	7	0	0	0	7
OG0013525	0	7	0	0	0	7
OG0013526	0	7	0	0	0	7
OG0013527	0	7	0	0	0	7
OG0013528	0	7	0	0	0	7
OG0013529	0	7	0	0	0	7
OG0013530	0	7	0	0	0	7
OG0013531	0	7	0	0	0	7
OG0013532	0	7	0	0	0	7
OG0013533	0	7	0	0	0	7
OG0013534	0	7	0	0	0	7
OG0013535	0	7	0	0	0	7
OG0013536	0	7	0	0	0	7
OG0013537	0	7	0	0	0	7
OG0013538	0	4	1	1	1	7
OG0013539	0	3	1	1	2	7
OG0013540	0	4	1	1	1	7
OG0013541	0	7	0	0	0	7
OG0013542	0	7	0	0	0	7
OG0013543	0	7	0	0	0	7
OG0013544	0	7	0	0	0	7
OG0013545	0	7	0	0	0	7
OG0013546	0	7	0	0	0	7
OG0013547	0	5	0	1	1	7
OG0013548	0	6	0	1	0	7
OG0013549	0	7	0	0	0	7
OG0013550	0	7	0	0	0	7
OG0013551	0	7	0	0	0	7
OG0013552	0	7	0	0	0	7
OG0013553	0	5	0	2	0	7
OG0013554	0	7	0	0	0	7
OG0013555	0	7	0	0	0	7
OG0013556	0	7	0	0	0	7
OG0013557	0	7	0	0	0	7
OG0013558	0	7	0	0	0	7
OG0013559	0	7	0	0	0	7
OG0013560	0	7	0	0	0	7
OG0013561	0	4	1	1	1	7
OG0013562	0	7	0	0	0	7
OG0013563	0	7	0	0	0	7
OG0013564	0	7	0	0	0	7
OG0013565	0	7	0	0	0	7
OG0013566	0	7	0	0	0	7
OG0013567	0	7	0	0	0	7
OG0013568	0	7	0	0	0	7
OG0013569	0	7	0	0	0	7
OG0013570	0	7	0	0	0	7
OG0013571	0	7	0	0	0	7
OG0013572	0	6	0	1	0	7
OG0013573	0	7	0	0	0	7
OG0013574	0	7	0	0	0	7
OG0013575	0	6	0	1	0	7
OG0013576	0	7	0	0	0	7
OG0013577	0	7	0	0	0	7
OG0013578	0	7	0	0	0	7
OG0013579	0	7	0	0	0	7
OG0013580	0	7	0	0	0	7
OG0013581	0	5	0	1	1	7
OG0013582	0	7	0	0	0	7
OG0013583	0	7	0	0	0	7
OG0013584	0	4	1	1	1	7
OG0013585	0	4	1	1	1	7
OG0013586	0	7	0	0	0	7
OG0013587	0	7	0	0	0	7
OG0013588	0	4	1	2	0	7
OG0013589	0	7	0	0	0	7
OG0013590	0	7	0	0	0	7
OG0013591	0	7	0	0	0	7
OG0013592	0	7	0	0	0	7
OG0013593	0	4	1	1	1	7
OG0013594	0	7	0	0	0	7
OG0013595	0	7	0	0	0	7
OG0013596	0	7	0	0	0	7
OG0013597	0	7	0	0	0	7
OG0013598	0	7	0	0	0	7
OG0013599	0	4	1	1	1	7
OG0013600	0	7	0	0	0	7
OG0013601	0	7	0	0	0	7
OG0013602	0	7	0	0	0	7
OG0013603	0	7	0	0	0	7
OG0013604	0	6	1	0	0	7
OG0013605	0	6	0	1	0	7
OG0013606	0	7	0	0	0	7
OG0013607	0	7	0	0	0	7
OG0013608	0	7	0	0	0	7
OG0013609	0	7	0	0	0	7
OG0013610	0	7	0	0	0	7
OG0013611	0	7	0	0	0	7
OG0013612	0	4	1	1	1	7
OG0013613	0	3	1	1	2	7
OG0013614	0	6	0	1	0	7
OG0013615	0	3	1	2	1	7
OG0013616	0	5	0	1	1	7
OG0013617	0	7	0	0	0	7
OG0013618	0	4	1	1	1	7
OG0013619	0	7	0	0	0	7
OG0013620	0	7	0	0	0	7
OG0013621	0	6	0	1	0	7
OG0013622	0	4	1	1	1	7
OG0013623	0	7	0	0	0	7
OG0013624	0	7	0	0	0	7
OG0013625	0	4	1	1	1	7
OG0013626	0	7	0	0	0	7
OG0013627	0	6	1	0	0	7
OG0013628	0	2	4	0	1	7
OG0013629	0	7	0	0	0	7
OG0013630	0	7	0	0	0	7
OG0013631	0	7	0	0	0	7
OG0013632	0	7	0	0	0	7
OG0013633	0	7	0	0	0	7
OG0013634	0	7	0	0	0	7
OG0013635	0	7	0	0	0	7
OG0013636	0	7	0	0	0	7
OG0013637	0	3	3	0	1	7
OG0013638	0	7	0	0	0	7
OG0013639	0	7	0	0	0	7
OG0013640	0	2	2	1	2	7
OG0013641	0	7	0	0	0	7
OG0013642	0	7	0	0	0	7
OG0013643	0	7	0	0	0	7
OG0013644	0	7	0	0	0	7
OG0013645	0	7	0	0	0	7
OG0013646	0	7	0	0	0	7
OG0013647	0	7	0	0	0	7
OG0013648	0	7	0	0	0	7
OG0013649	0	7	0	0	0	7
OG0013650	0	7	0	0	0	7
OG0013651	0	7	0	0	0	7
OG0013652	0	6	0	1	0	7
OG0013653	0	2	2	2	1	7
OG0013654	0	4	1	1	1	7
OG0013655	0	7	0	0	0	7
OG0013656	0	5	1	1	0	7
OG0013657	0	4	0	2	1	7
OG0013658	0	1	1	3	2	7
OG0013659	0	7	0	0	0	7
OG0013660	0	7	0	0	0	7
OG0013661	0	6	0	1	0	7
OG0013662	0	6	0	1	0	7
OG0013663	0	2	2	1	2	7
OG0013664	0	7	0	0	0	7
OG0013665	0	4	0	1	2	7
OG0013666	0	7	0	0	0	7
OG0013667	0	7	0	0	0	7
OG0013668	0	7	0	0	0	7
OG0013669	0	6	0	1	0	7
OG0013670	0	7	0	0	0	7
OG0013671	0	4	1	1	1	7
OG0013672	0	4	0	1	2	7
OG0013673	0	7	0	0	0	7
OG0013674	0	7	0	0	0	7
OG0013675	0	7	0	0	0	7
OG0013676	0	7	0	0	0	7
OG0013677	0	7	0	0	0	7
OG0013678	0	7	0	0	0	7
OG0013679	0	4	1	1	1	7
OG0013680	0	7	0	0	0	7
OG0013681	0	3	1	1	2	7
OG0013682	0	7	0	0	0	7
OG0013683	0	7	0	0	0	7
OG0013684	0	7	0	0	0	7
OG0013685	0	7	0	0	0	7
OG0013686	0	7	0	0	0	7
OG0013687	0	2	2	1	2	7
OG0013688	0	7	0	0	0	7
OG0013689	0	7	0	0	0	7
OG0013690	0	7	0	0	0	7
OG0013691	0	4	1	1	1	7
OG0013692	0	7	0	0	0	7
OG0013693	0	7	0	0	0	7
OG0013694	0	4	1	1	1	7
OG0013695	0	7	0	0	0	7
OG0013696	0	7	0	0	0	7
OG0013697	0	7	0	0	0	7
OG0013698	0	7	0	0	0	7
OG0013699	0	4	1	2	0	7
OG0013700	0	7	0	0	0	7
OG0013701	0	7	0	0	0	7
OG0013702	0	7	0	0	0	7
OG0013703	0	7	0	0	0	7
OG0013704	0	5	0	1	1	7
OG0013705	0	3	1	2	1	7
OG0013706	0	7	0	0	0	7
OG0013707	0	7	0	0	0	7
OG0013708	0	7	0	0	0	7
OG0013709	0	7	0	0	0	7
OG0013710	0	7	0	0	0	7
OG0013711	0	7	0	0	0	7
OG0013712	0	7	0	0	0	7
OG0013713	0	6	0	1	0	7
OG0013714	0	7	0	0	0	7
OG0013715	0	6	0	1	0	7
OG0013716	0	6	0	1	0	7
OG0013717	0	7	0	0	0	7
OG0013718	0	2	1	3	1	7
OG0013719	0	4	1	1	1	7
OG0013720	0	7	0	0	0	7
OG0013721	0	7	0	0	0	7
OG0013722	0	4	1	1	1	7
OG0013723	0	7	0	0	0	7
OG0013724	0	7	0	0	0	7
OG0013725	0	7	0	0	0	7
OG0013726	0	7	0	0	0	7
OG0013727	0	7	0	0	0	7
OG0013728	0	7	0	0	0	7
OG0013729	0	4	2	1	0	7
OG0013730	0	4	1	1	1	7
OG0013731	0	7	0	0	0	7
OG0013732	0	7	0	0	0	7
OG0013733	0	7	0	0	0	7
OG0013734	0	7	0	0	0	7
OG0013735	0	4	0	2	1	7
OG0013736	0	7	0	0	0	7
OG0013737	0	7	0	0	0	7
OG0013738	0	6	0	1	0	7
OG0013739	0	5	0	1	1	7
OG0013740	0	7	0	0	0	7
OG0013741	0	7	0	0	0	7
OG0013742	0	4	1	1	1	7
OG0013743	0	7	0	0	0	7
OG0013744	0	7	0	0	0	7
OG0013745	0	7	0	0	0	7
OG0013746	0	7	0	0	0	7
OG0013747	0	7	0	0	0	7
OG0013748	0	2	2	0	3	7
OG0013749	0	7	0	0	0	7
OG0013750	0	2	2	2	1	7
OG0013751	0	7	0	0	0	7
OG0013752	0	7	0	0	0	7
OG0013753	0	6	0	1	0	7
OG0013754	0	7	0	0	0	7
OG0013755	0	4	1	1	1	7
OG0013756	0	6	0	1	0	7
OG0013757	0	7	0	0	0	7
OG0013758	0	7	0	0	0	7
OG0013759	0	6	0	1	0	7
OG0013760	0	7	0	0	0	7
OG0013761	0	4	1	1	1	7
OG0013762	0	7	0	0	0	7
OG0013763	0	7	0	0	0	7
OG0013764	0	7	0	0	0	7
OG0013765	0	6	0	1	0	7
OG0013766	0	7	0	0	0	7
OG0013767	0	7	0	0	0	7
OG0013768	0	7	0	0	0	7
OG0013769	0	4	1	1	1	7
OG0013770	0	7	0	0	0	7
OG0013771	0	3	1	2	1	7
OG0013772	0	7	0	0	0	7
OG0013773	0	7	0	0	0	7
OG0013774	0	7	0	0	0	7
OG0013775	0	4	1	1	1	7
OG0013776	0	4	1	1	1	7
OG0013777	0	7	0	0	0	7
OG0013778	0	7	0	0	0	7
OG0013779	0	5	0	2	0	7
OG0013780	0	1	0	6	0	7
OG0013781	0	2	1	3	1	7
OG0013782	0	7	0	0	0	7
OG0013783	0	7	0	0	0	7
OG0013784	0	1	5	0	1	7
OG0013785	0	7	0	0	0	7
OG0013786	0	7	0	0	0	7
OG0013787	0	7	0	0	0	7
OG0013788	0	2	0	5	0	7
OG0013789	0	4	1	1	1	7
OG0013790	0	6	0	1	0	7
OG0013791	0	7	0	0	0	7
OG0013792	0	7	0	0	0	7
OG0013793	0	7	0	0	0	7
OG0013794	0	2	3	1	1	7
OG0013795	0	7	0	0	0	7
OG0013796	0	2	2	3	0	7
OG0013797	0	5	1	0	1	7
OG0013798	0	7	0	0	0	7
OG0013799	0	7	0	0	0	7
OG0013800	0	2	2	2	1	7
OG0013801	0	6	0	1	0	7
OG0013802	0	2	4	0	1	7
OG0013803	0	2	1	1	3	7
OG0013804	0	7	0	0	0	7
OG0013805	0	7	0	0	0	7
OG0013806	0	6	0	1	0	7
OG0013807	0	1	5	0	1	7
OG0013808	0	3	3	0	1	7
OG0013809	0	3	1	1	2	7
OG0013810	0	4	1	1	1	7
OG0013811	0	3	1	2	1	7
OG0013812	0	7	0	0	0	7
OG0013813	0	1	0	0	6	7
OG0013814	0	4	1	1	1	7
OG0013815	0	7	0	0	0	7
OG0013816	0	4	1	1	1	7
OG0013817	0	4	1	1	1	7
OG0013818	0	7	0	0	0	7
OG0013819	0	7	0	0	0	7
OG0013820	0	7	0	0	0	7
OG0013821	0	6	0	1	0	7
OG0013822	0	7	0	0	0	7
OG0013823	0	2	2	1	2	7
OG0013824	0	1	5	0	1	7
OG0013825	0	2	2	1	2	7
OG0013826	0	2	2	2	1	7
OG0013827	0	2	2	2	1	7
OG0013828	0	2	2	1	2	7
OG0013829	0	3	2	1	1	7
OG0013830	0	4	1	1	1	7
OG0013831	0	1	6	0	0	7
OG0013832	0	7	0	0	0	7
OG0013833	0	7	0	0	0	7
OG0013834	0	7	0	0	0	7
OG0013835	0	4	1	1	1	7
OG0013836	0	2	2	1	2	7
OG0013837	0	3	1	0	3	7
OG0013838	0	2	2	1	2	7
OG0013839	0	2	2	1	2	7
OG0013840	0	1	6	0	0	7
OG0013841	0	0	5	0	2	7
OG0013842	0	0	5	0	2	7
OG0013843	0	0	5	0	2	7
OG0013844	0	0	7	0	0	7
OG0013845	0	0	2	1	4	7
OG0013846	0	0	7	0	0	7
OG0013847	0	0	7	0	0	7
OG0013848	0	0	3	1	3	7
OG0013849	0	0	2	0	5	7
OG0013850	0	0	4	1	2	7
OG0013851	0	0	2	0	5	7
OG0013852	0	0	1	5	1	7
OG0013853	0	0	5	0	2	7
OG0013854	0	0	5	1	1	7
OG0013855	0	0	4	0	3	7
OG0013856	0	0	3	2	2	7
OG0013857	0	0	6	0	1	7
OG0013858	0	0	5	0	2	7
OG0013859	0	0	6	0	1	7
OG0013860	0	0	1	0	6	7
OG0013861	0	0	2	1	4	7
OG0013862	0	0	1	6	0	7
OG0013863	0	0	6	0	1	7
OG0013864	0	0	4	0	3	7
OG0013865	0	0	5	0	2	7
OG0013866	0	0	6	0	1	7
OG0013867	0	0	3	0	4	7
OG0013868	0	0	4	1	2	7
OG0013869	0	0	3	0	4	7
OG0013870	0	0	4	0	3	7
OG0013871	0	0	7	0	0	7
OG0013872	0	0	6	0	1	7
OG0013873	0	0	1	0	6	7
OG0013874	0	0	6	0	1	7
OG0013875	0	0	3	0	4	7
OG0013876	0	0	2	2	3	7
OG0013877	0	0	2	3	2	7
OG0013878	0	0	6	0	1	7
OG0013879	0	0	6	0	1	7
OG0013880	0	0	7	0	0	7
OG0013881	0	0	3	1	3	7
OG0013882	0	0	4	0	3	7
OG0013883	0	0	6	0	1	7
OG0013884	0	0	7	0	0	7
OG0013885	0	0	5	0	2	7
OG0013886	0	0	4	0	3	7
OG0013887	0	0	2	1	4	7
OG0013888	0	0	1	0	6	7
OG0013889	0	0	1	2	4	7
OG0013890	0	0	6	0	1	7
OG0013891	0	0	7	0	0	7
OG0013892	0	0	1	3	3	7
OG0013893	0	0	2	0	5	7
OG0013894	0	0	1	1	5	7
OG0013895	0	0	2	1	4	7
OG0013896	0	0	6	0	1	7
OG0013897	0	0	6	0	1	7
OG0013898	0	0	7	0	0	7
OG0013899	0	0	1	0	6	7
OG0013900	0	0	3	1	3	7
OG0013901	0	0	1	0	6	7
OG0013902	0	0	3	1	3	7
OG0013903	0	0	4	1	2	7
OG0013904	0	0	2	1	4	7
OG0013905	0	0	7	0	0	7
OG0013906	0	0	5	0	2	7
OG0013907	0	0	4	0	3	7
OG0013908	0	0	5	2	0	7
OG0013909	0	0	1	0	6	7
OG0013910	0	0	4	0	3	7
OG0013911	0	0	3	0	4	7
OG0013912	0	0	3	1	3	7
OG0013913	0	0	1	0	6	7
OG0013914	0	0	1	0	6	7
OG0013915	0	0	5	0	2	7
OG0013916	0	0	6	0	1	7
OG0013917	0	0	5	0	2	7
OG0013918	0	0	1	0	6	7
OG0013919	0	0	4	0	3	7
OG0013920	0	0	4	0	3	7
OG0013921	0	0	2	2	3	7
OG0013922	0	0	7	0	0	7
OG0013923	0	0	2	2	3	7
OG0013924	0	0	2	0	5	7
OG0013925	0	0	1	4	2	7
OG0013926	0	0	5	0	2	7
OG0013927	0	0	7	0	0	7
OG0013928	0	0	1	0	6	7
OG0013929	0	0	1	0	6	7
OG0013930	0	0	1	5	1	7
OG0013931	0	0	1	0	6	7
OG0013932	0	0	0	7	0	7
OG0013933	0	0	0	3	4	7
OG0013934	0	0	0	3	4	7
OG0013935	0	0	0	7	0	7
OG0013936	0	0	0	7	0	7
OG0013937	0	0	0	7	0	7
OG0013938	0	0	0	7	0	7
OG0013939	0	0	0	1	6	7
OG0013940	0	0	0	7	0	7
OG0013941	0	0	0	7	0	7
OG0013942	0	0	0	7	0	7
OG0013943	0	0	0	7	0	7
OG0013944	0	0	0	0	7	7
OG0013945	0	0	0	0	7	7
OG0013946	0	0	0	0	7	7
OG0013947	0	0	0	0	7	7
OG0013948	0	0	0	0	7	7
OG0013949	0	0	0	0	7	7
OG0013950	0	0	0	0	7	7
OG0013951	0	0	0	0	7	7
OG0013952	0	0	0	0	7	7
OG0013953	0	0	0	0	7	7
OG0013954	0	0	0	0	7	7
OG0013955	0	0	0	0	7	7
OG0013956	0	0	0	0	7	7
OG0013957	0	0	0	0	7	7
OG0013958	0	0	0	0	7	7
OG0013959	0	0	0	0	7	7
OG0013960	0	0	0	0	7	7
OG0013961	0	0	0	0	7	7
OG0013962	0	0	0	0	7	7
OG0013963	0	0	0	0	7	7
OG0013964	0	0	0	0	7	7
OG0013965	0	0	0	0	7	7
OG0013966	0	0	0	0	7	7
OG0013967	0	0	0	0	7	7
OG0013968	0	0	0	0	7	7
OG0013969	0	0	0	0	7	7
OG0013970	0	0	0	0	7	7
OG0013971	0	0	0	0	7	7
OG0013972	6	0	0	0	0	6
OG0013973	6	0	0	0	0	6
OG0013974	6	0	0	0	0	6
OG0013975	6	0	0	0	0	6
OG0013976	6	0	0	0	0	6
OG0013977	2	2	0	1	1	6
OG0013978	2	1	1	1	1	6
OG0013979	1	2	1	1	1	6
OG0013980	2	2	0	1	1	6
OG0013981	6	0	0	0	0	6
OG0013982	2	3	0	1	0	6
OG0013983	2	4	0	0	0	6
OG0013984	6	0	0	0	0	6
OG0013985	4	0	0	1	1	6
OG0013986	2	2	1	0	1	6
OG0013987	2	1	1	1	1	6
OG0013988	2	1	1	1	1	6
OG0013989	6	0	0	0	0	6
OG0013990	2	2	0	1	1	6
OG0013991	6	0	0	0	0	6
OG0013992	2	1	1	1	1	6
OG0013993	2	2	1	0	1	6
OG0013994	2	2	0	1	1	6
OG0013995	2	1	1	1	1	6
OG0013996	2	1	1	1	1	6
OG0013997	3	1	0	1	1	6
OG0013998	6	0	0	0	0	6
OG0013999	4	1	1	0	0	6
OG0014000	2	0	1	1	2	6
OG0014001	2	2	1	1	0	6
OG0014002	1	2	1	1	1	6
OG0014003	6	0	0	0	0	6
OG0014004	4	0	1	1	0	6
OG0014005	2	2	0	1	1	6
OG0014006	6	0	0	0	0	6
OG0014007	6	0	0	0	0	6
OG0014008	2	1	0	1	2	6
OG0014009	6	0	0	0	0	6
OG0014010	2	1	1	1	1	6
OG0014011	6	0	0	0	0	6
OG0014012	6	0	0	0	0	6
OG0014013	2	2	0	1	1	6
OG0014014	2	2	0	1	1	6
OG0014015	6	0	0	0	0	6
OG0014016	5	0	0	1	0	6
OG0014017	2	2	1	1	0	6
OG0014018	1	2	1	1	1	6
OG0014019	2	0	2	0	2	6
OG0014020	2	1	1	1	1	6
OG0014021	6	0	0	0	0	6
OG0014022	2	2	0	1	1	6
OG0014023	1	2	1	1	1	6
OG0014024	2	2	0	1	1	6
OG0014025	2	3	0	1	0	6
OG0014026	2	1	1	1	1	6
OG0014027	1	0	2	1	2	6
OG0014028	2	0	3	1	0	6
OG0014029	3	1	0	1	1	6
OG0014030	5	0	0	1	0	6
OG0014031	6	0	0	0	0	6
OG0014032	1	2	0	2	1	6
OG0014033	1	0	1	3	1	6
OG0014034	2	0	2	1	1	6
OG0014035	2	1	1	1	1	6
OG0014036	1	2	1	1	1	6
OG0014037	2	2	0	1	1	6
OG0014038	2	2	0	1	1	6
OG0014039	2	2	0	1	1	6
OG0014040	2	1	1	1	1	6
OG0014041	2	2	0	1	1	6
OG0014042	6	0	0	0	0	6
OG0014043	2	2	0	1	1	6
OG0014044	2	1	1	1	1	6
OG0014045	6	0	0	0	0	6
OG0014046	1	2	1	1	1	6
OG0014047	2	1	1	1	1	6
OG0014048	1	1	1	2	1	6
OG0014049	6	0	0	0	0	6
OG0014050	2	0	2	1	1	6
OG0014051	2	2	0	1	1	6
OG0014052	2	2	0	1	1	6
OG0014053	6	0	0	0	0	6
OG0014054	6	0	0	0	0	6
OG0014055	3	2	0	1	0	6
OG0014056	2	1	1	1	1	6
OG0014057	2	1	1	1	1	6
OG0014058	2	0	1	2	1	6
OG0014059	2	0	1	2	1	6
OG0014060	2	0	3	0	1	6
OG0014061	2	2	0	1	1	6
OG0014062	2	2	0	1	1	6
OG0014063	2	1	1	1	1	6
OG0014064	2	2	0	1	1	6
OG0014065	6	0	0	0	0	6
OG0014066	3	2	0	1	0	6
OG0014067	4	0	0	1	1	6
OG0014068	2	2	0	1	1	6
OG0014069	1	2	1	1	1	6
OG0014070	6	0	0	0	0	6
OG0014071	2	2	0	1	1	6
OG0014072	3	1	1	0	1	6
OG0014073	1	0	2	1	2	6
OG0014074	4	0	1	0	1	6
OG0014075	6	0	0	0	0	6
OG0014076	4	1	0	0	1	6
OG0014077	5	1	0	0	0	6
OG0014078	3	0	1	0	2	6
OG0014079	4	1	1	0	0	6
OG0014080	4	0	0	1	1	6
OG0014081	1	0	5	0	0	6
OG0014082	5	0	0	0	1	6
OG0014083	6	0	0	0	0	6
OG0014084	6	0	0	0	0	6
OG0014085	3	0	2	0	1	6
OG0014086	3	0	3	0	0	6
OG0014087	6	0	0	0	0	6
OG0014088	1	0	4	1	0	6
OG0014089	3	0	1	1	1	6
OG0014090	6	0	0	0	0	6
OG0014091	6	0	0	0	0	6
OG0014092	2	1	1	1	1	6
OG0014093	6	0	0	0	0	6
OG0014094	2	1	1	1	1	6
OG0014095	2	2	1	1	0	6
OG0014096	2	1	1	1	1	6
OG0014097	2	2	0	1	1	6
OG0014098	2	2	0	1	1	6
OG0014099	6	0	0	0	0	6
OG0014100	2	2	0	1	1	6
OG0014101	6	0	0	0	0	6
OG0014102	2	1	1	1	1	6
OG0014103	2	1	1	1	1	6
OG0014104	2	2	0	1	1	6
OG0014105	6	0	0	0	0	6
OG0014106	4	0	2	0	0	6
OG0014107	6	0	0	0	0	6
OG0014108	2	2	0	1	1	6
OG0014109	6	0	0	0	0	6
OG0014110	6	0	0	0	0	6
OG0014111	2	1	1	1	1	6
OG0014112	5	0	0	0	1	6
OG0014113	6	0	0	0	0	6
OG0014114	2	2	0	1	1	6
OG0014115	2	2	0	1	1	6
OG0014116	6	0	0	0	0	6
OG0014117	2	1	1	1	1	6
OG0014118	6	0	0	0	0	6
OG0014119	2	1	1	1	1	6
OG0014120	2	2	0	1	1	6
OG0014121	2	2	0	1	1	6
OG0014122	3	1	0	1	1	6
OG0014123	2	2	0	1	1	6
OG0014124	6	0	0	0	0	6
OG0014125	6	0	0	0	0	6
OG0014126	3	0	1	1	1	6
OG0014127	5	1	0	0	0	6
OG0014128	2	1	1	1	1	6
OG0014129	4	0	0	1	1	6
OG0014130	2	1	1	1	1	6
OG0014131	3	0	1	1	1	6
OG0014132	4	1	1	0	0	6
OG0014133	2	1	1	1	1	6
OG0014134	2	2	0	1	1	6
OG0014135	3	0	1	1	1	6
OG0014136	2	2	0	1	1	6
OG0014137	1	1	2	1	1	6
OG0014138	2	2	0	1	1	6
OG0014139	2	1	1	1	1	6
OG0014140	1	2	1	1	1	6
OG0014141	6	0	0	0	0	6
OG0014142	2	2	0	1	1	6
OG0014143	5	0	0	1	0	6
OG0014144	2	1	1	1	1	6
OG0014145	2	2	0	1	1	6
OG0014146	2	0	1	1	2	6
OG0014147	6	0	0	0	0	6
OG0014148	6	0	0	0	0	6
OG0014149	6	0	0	0	0	6
OG0014150	2	0	3	0	1	6
OG0014151	2	1	0	2	1	6
OG0014152	3	0	1	1	1	6
OG0014153	2	1	1	1	1	6
OG0014154	4	0	1	1	0	6
OG0014155	6	0	0	0	0	6
OG0014156	2	2	0	1	1	6
OG0014157	1	2	1	1	1	6
OG0014158	2	1	1	1	1	6
OG0014159	2	2	0	1	1	6
OG0014160	1	2	1	1	1	6
OG0014161	2	3	0	1	0	6
OG0014162	2	2	0	1	1	6
OG0014163	2	1	1	1	1	6
OG0014164	2	2	1	1	0	6
OG0014165	3	0	3	0	0	6
OG0014166	2	1	1	1	1	6
OG0014167	2	1	1	1	1	6
OG0014168	6	0	0	0	0	6
OG0014169	2	2	0	1	1	6
OG0014170	6	0	0	0	0	6
OG0014171	6	0	0	0	0	6
OG0014172	2	2	0	1	1	6
OG0014173	2	1	1	1	1	6
OG0014174	6	0	0	0	0	6
OG0014175	1	2	1	1	1	6
OG0014176	2	1	1	1	1	6
OG0014177	6	0	0	0	0	6
OG0014178	2	2	0	1	1	6
OG0014179	1	2	1	1	1	6
OG0014180	2	1	1	1	1	6
OG0014181	6	0	0	0	0	6
OG0014182	1	2	1	1	1	6
OG0014183	2	2	1	1	0	6
OG0014184	4	0	0	1	1	6
OG0014185	2	2	1	1	0	6
OG0014186	5	1	0	0	0	6
OG0014187	2	1	1	1	1	6
OG0014188	2	1	1	1	1	6
OG0014189	1	2	1	1	1	6
OG0014190	2	1	1	1	1	6
OG0014191	2	2	0	1	1	6
OG0014192	2	1	1	1	1	6
OG0014193	2	2	1	1	0	6
OG0014194	6	0	0	0	0	6
OG0014195	2	1	1	1	1	6
OG0014196	2	0	1	1	2	6
OG0014197	6	0	0	0	0	6
OG0014198	6	0	0	0	0	6
OG0014199	2	2	0	1	1	6
OG0014200	1	2	1	1	1	6
OG0014201	2	2	0	1	1	6
OG0014202	6	0	0	0	0	6
OG0014203	2	0	2	1	1	6
OG0014204	4	0	1	1	0	6
OG0014205	2	1	1	1	1	6
OG0014206	2	2	0	1	1	6
OG0014207	6	0	0	0	0	6
OG0014208	6	0	0	0	0	6
OG0014209	6	0	0	0	0	6
OG0014210	2	2	0	1	1	6
OG0014211	1	5	0	0	0	6
OG0014212	2	2	0	1	1	6
OG0014213	6	0	0	0	0	6
OG0014214	2	0	1	1	2	6
OG0014215	6	0	0	0	0	6
OG0014216	2	0	2	1	1	6
OG0014217	2	0	1	1	2	6
OG0014218	1	2	1	1	1	6
OG0014219	6	0	0	0	0	6
OG0014220	2	1	1	1	1	6
OG0014221	2	0	1	2	1	6
OG0014222	2	1	1	2	0	6
OG0014223	1	2	1	1	1	6
OG0014224	6	0	0	0	0	6
OG0014225	2	0	1	1	2	6
OG0014226	1	2	1	1	1	6
OG0014227	6	0	0	0	0	6
OG0014228	2	1	1	1	1	6
OG0014229	6	0	0	0	0	6
OG0014230	6	0	0	0	0	6
OG0014231	6	0	0	0	0	6
OG0014232	4	0	0	1	1	6
OG0014233	6	0	0	0	0	6
OG0014234	5	1	0	0	0	6
OG0014235	2	1	1	1	1	6
OG0014236	6	0	0	0	0	6
OG0014237	6	0	0	0	0	6
OG0014238	2	1	1	1	1	6
OG0014239	5	0	0	1	0	6
OG0014240	2	2	0	1	1	6
OG0014241	2	2	0	1	1	6
OG0014242	6	0	0	0	0	6
OG0014243	6	0	0	0	0	6
OG0014244	2	0	1	1	2	6
OG0014245	2	1	1	1	1	6
OG0014246	2	0	0	2	2	6
OG0014247	6	0	0	0	0	6
OG0014248	4	0	1	1	0	6
OG0014249	6	0	0	0	0	6
OG0014250	2	2	0	1	1	6
OG0014251	6	0	0	0	0	6
OG0014252	3	0	0	1	2	6
OG0014253	2	1	1	1	1	6
OG0014254	2	1	1	1	1	6
OG0014255	2	2	0	2	0	6
OG0014256	1	3	0	1	1	6
OG0014257	6	0	0	0	0	6
OG0014258	1	0	5	0	0	6
OG0014259	6	0	0	0	0	6
OG0014260	6	0	0	0	0	6
OG0014261	6	0	0	0	0	6
OG0014262	2	2	0	1	1	6
OG0014263	2	2	0	1	1	6
OG0014264	2	1	1	1	1	6
OG0014265	2	1	1	1	1	6
OG0014266	2	0	1	2	1	6
OG0014267	6	0	0	0	0	6
OG0014268	1	2	3	0	0	6
OG0014269	2	1	1	1	1	6
OG0014270	6	0	0	0	0	6
OG0014271	2	1	1	1	1	6
OG0014272	3	0	1	1	1	6
OG0014273	2	1	1	1	1	6
OG0014274	1	2	1	1	1	6
OG0014275	2	0	1	2	1	6
OG0014276	3	0	1	1	1	6
OG0014277	1	0	2	1	2	6
OG0014278	6	0	0	0	0	6
OG0014279	2	2	1	1	0	6
OG0014280	6	0	0	0	0	6
OG0014281	2	1	1	1	1	6
OG0014282	1	2	1	1	1	6
OG0014283	6	0	0	0	0	6
OG0014284	1	3	0	1	1	6
OG0014285	2	2	0	1	1	6
OG0014286	6	0	0	0	0	6
OG0014287	2	2	0	1	1	6
OG0014288	2	2	0	2	0	6
OG0014289	2	2	0	1	1	6
OG0014290	2	2	0	1	1	6
OG0014291	2	2	1	1	0	6
OG0014292	2	2	0	1	1	6
OG0014293	2	2	0	1	1	6
OG0014294	2	1	1	1	1	6
OG0014295	2	2	0	1	1	6
OG0014296	2	2	0	1	1	6
OG0014297	2	1	1	1	1	6
OG0014298	6	0	0	0	0	6
OG0014299	6	0	0	0	0	6
OG0014300	2	1	1	1	1	6
OG0014301	1	0	2	1	2	6
OG0014302	2	2	0	1	1	6
OG0014303	2	2	0	1	1	6
OG0014304	2	2	1	1	0	6
OG0014305	2	0	1	1	2	6
OG0014306	2	3	0	1	0	6
OG0014307	1	2	1	1	1	6
OG0014308	6	0	0	0	0	6
OG0014309	2	2	0	1	1	6
OG0014310	2	2	0	1	1	6
OG0014311	2	2	1	1	0	6
OG0014312	2	1	1	1	1	6
OG0014313	3	0	1	1	1	6
OG0014314	2	2	0	1	1	6
OG0014315	2	2	1	1	0	6
OG0014316	1	3	0	1	1	6
OG0014317	2	2	1	1	0	6
OG0014318	1	2	1	1	1	6
OG0014319	1	2	1	1	1	6
OG0014320	2	0	2	1	1	6
OG0014321	2	2	1	0	1	6
OG0014322	2	2	0	1	1	6
OG0014323	2	1	1	1	1	6
OG0014324	3	0	1	1	1	6
OG0014325	2	1	1	1	1	6
OG0014326	1	2	1	1	1	6
OG0014327	6	0	0	0	0	6
OG0014328	2	0	2	1	1	6
OG0014329	2	2	1	1	0	6
OG0014330	6	0	0	0	0	6
OG0014331	2	1	1	1	1	6
OG0014332	3	0	1	1	1	6
OG0014333	2	4	0	0	0	6
OG0014334	5	0	1	0	0	6
OG0014335	6	0	0	0	0	6
OG0014336	2	2	0	1	1	6
OG0014337	2	2	0	1	1	6
OG0014338	2	1	1	1	1	6
OG0014339	3	0	1	2	0	6
OG0014340	6	0	0	0	0	6
OG0014341	1	2	1	1	1	6
OG0014342	1	2	1	1	1	6
OG0014343	1	1	4	0	0	6
OG0014344	1	2	1	1	1	6
OG0014345	2	1	2	1	0	6
OG0014346	2	1	0	2	1	6
OG0014347	6	0	0	0	0	6
OG0014348	2	1	1	1	1	6
OG0014349	2	0	2	1	1	6
OG0014350	2	2	0	1	1	6
OG0014351	6	0	0	0	0	6
OG0014352	1	3	1	0	1	6
OG0014353	6	0	0	0	0	6
OG0014354	2	0	1	2	1	6
OG0014355	1	2	1	1	1	6
OG0014356	2	1	1	1	1	6
OG0014357	1	2	1	1	1	6
OG0014358	2	2	1	1	0	6
OG0014359	2	1	1	1	1	6
OG0014360	2	2	1	1	0	6
OG0014361	2	1	1	1	1	6
OG0014362	1	2	1	1	1	6
OG0014363	1	0	2	2	1	6
OG0014364	1	2	1	1	1	6
OG0014365	2	1	1	1	1	6
OG0014366	2	2	1	1	0	6
OG0014367	2	1	1	1	1	6
OG0014368	2	2	0	1	1	6
OG0014369	1	2	1	1	1	6
OG0014370	2	2	0	1	1	6
OG0014371	2	1	1	1	1	6
OG0014372	4	0	0	1	1	6
OG0014373	2	1	1	1	1	6
OG0014374	2	0	2	1	1	6
OG0014375	1	2	1	1	1	6
OG0014376	2	0	2	1	1	6
OG0014377	2	1	1	1	1	6
OG0014378	2	2	1	1	0	6
OG0014379	6	0	0	0	0	6
OG0014380	2	2	0	1	1	6
OG0014381	2	2	0	1	1	6
OG0014382	1	2	1	2	0	6
OG0014383	2	2	1	0	1	6
OG0014384	3	1	0	2	0	6
OG0014385	5	0	0	0	1	6
OG0014386	3	1	0	1	1	6
OG0014387	2	2	0	1	1	6
OG0014388	2	0	1	1	2	6
OG0014389	1	3	0	1	1	6
OG0014390	2	4	0	0	0	6
OG0014391	1	2	1	1	1	6
OG0014392	2	0	2	1	1	6
OG0014393	2	1	1	1	1	6
OG0014394	2	2	1	1	0	6
OG0014395	2	2	1	0	1	6
OG0014396	5	1	0	0	0	6
OG0014397	2	2	0	1	1	6
OG0014398	1	2	0	2	1	6
OG0014399	3	1	0	1	1	6
OG0014400	3	0	1	1	1	6
OG0014401	2	2	0	1	1	6
OG0014402	1	2	1	1	1	6
OG0014403	2	2	0	1	1	6
OG0014404	2	2	0	1	1	6
OG0014405	3	0	1	1	1	6
OG0014406	2	2	0	1	1	6
OG0014407	3	0	1	1	1	6
OG0014408	6	0	0	0	0	6
OG0014409	2	2	1	1	0	6
OG0014410	3	0	1	2	0	6
OG0014411	2	1	0	2	1	6
OG0014412	2	2	1	1	0	6
OG0014413	3	0	1	1	1	6
OG0014414	2	2	1	1	0	6
OG0014415	2	1	0	1	2	6
OG0014416	2	3	0	1	0	6
OG0014417	2	2	0	1	1	6
OG0014418	2	2	1	1	0	6
OG0014419	1	2	1	1	1	6
OG0014420	2	2	0	1	1	6
OG0014421	2	2	0	1	1	6
OG0014422	2	1	1	1	1	6
OG0014423	1	2	1	1	1	6
OG0014424	2	1	1	1	1	6
OG0014425	6	0	0	0	0	6
OG0014426	2	2	0	1	1	6
OG0014427	2	2	0	1	1	6
OG0014428	2	1	1	1	1	6
OG0014429	2	0	1	2	1	6
OG0014430	2	3	0	1	0	6
OG0014431	2	2	0	1	1	6
OG0014432	2	4	0	0	0	6
OG0014433	2	0	1	1	2	6
OG0014434	2	2	1	1	0	6
OG0014435	2	0	1	1	2	6
OG0014436	2	0	1	2	1	6
OG0014437	2	1	1	1	1	6
OG0014438	2	1	1	1	1	6
OG0014439	2	2	0	1	1	6
OG0014440	2	1	1	1	1	6
OG0014441	1	2	1	1	1	6
OG0014442	2	0	1	1	2	6
OG0014443	2	2	0	1	1	6
OG0014444	2	2	0	2	0	6
OG0014445	2	1	1	1	1	6
OG0014446	2	2	1	1	0	6
OG0014447	6	0	0	0	0	6
OG0014448	2	0	2	1	1	6
OG0014449	2	0	1	2	1	6
OG0014450	2	2	0	1	1	6
OG0014451	6	0	0	0	0	6
OG0014452	6	0	0	0	0	6
OG0014453	2	0	2	1	1	6
OG0014454	6	0	0	0	0	6
OG0014455	2	2	1	1	0	6
OG0014456	2	1	1	1	1	6
OG0014457	3	0	2	1	0	6
OG0014458	1	4	0	1	0	6
OG0014459	2	1	1	1	1	6
OG0014460	1	2	1	1	1	6
OG0014461	2	1	1	1	1	6
OG0014462	2	2	0	1	1	6
OG0014463	1	3	0	1	1	6
OG0014464	2	2	1	0	1	6
OG0014465	6	0	0	0	0	6
OG0014466	2	2	1	0	1	6
OG0014467	2	2	1	1	0	6
OG0014468	2	2	0	1	1	6
OG0014469	2	2	1	0	1	6
OG0014470	1	0	2	1	2	6
OG0014471	2	1	1	1	1	6
OG0014472	6	0	0	0	0	6
OG0014473	2	2	0	1	1	6
OG0014474	6	0	0	0	0	6
OG0014475	2	2	1	1	0	6
OG0014476	4	2	0	0	0	6
OG0014477	1	2	1	1	1	6
OG0014478	2	1	1	1	1	6
OG0014479	2	2	0	1	1	6
OG0014480	2	2	0	1	1	6
OG0014481	2	2	0	1	1	6
OG0014482	3	1	0	1	1	6
OG0014483	2	2	0	1	1	6
OG0014484	6	0	0	0	0	6
OG0014485	2	2	0	2	0	6
OG0014486	2	1	1	1	1	6
OG0014487	6	0	0	0	0	6
OG0014488	1	2	1	1	1	6
OG0014489	6	0	0	0	0	6
OG0014490	2	1	1	1	1	6
OG0014491	2	2	0	1	1	6
OG0014492	6	0	0	0	0	6
OG0014493	2	2	0	1	1	6
OG0014494	2	1	1	1	1	6
OG0014495	6	0	0	0	0	6
OG0014496	2	1	1	1	1	6
OG0014497	2	2	0	1	1	6
OG0014498	6	0	0	0	0	6
OG0014499	3	3	0	0	0	6
OG0014500	2	2	0	1	1	6
OG0014501	1	2	1	1	1	6
OG0014502	6	0	0	0	0	6
OG0014503	2	1	1	1	1	6
OG0014504	3	0	1	1	1	6
OG0014505	2	2	1	1	0	6
OG0014506	3	0	1	1	1	6
OG0014507	2	0	0	0	4	6
OG0014508	6	0	0	0	0	6
OG0014509	2	2	0	1	1	6
OG0014510	6	0	0	0	0	6
OG0014511	2	0	0	4	0	6
OG0014512	2	2	0	1	1	6
OG0014513	2	1	1	1	1	6
OG0014514	3	0	1	1	1	6
OG0014515	2	2	0	1	1	6
OG0014516	2	1	1	1	1	6
OG0014517	2	2	1	0	1	6
OG0014518	2	2	0	1	1	6
OG0014519	2	1	3	0	0	6
OG0014520	2	2	0	1	1	6
OG0014521	5	0	0	1	0	6
OG0014522	6	0	0	0	0	6
OG0014523	2	2	0	1	1	6
OG0014524	2	2	1	1	0	6
OG0014525	4	1	1	0	0	6
OG0014526	2	2	1	1	0	6
OG0014527	2	1	1	1	1	6
OG0014528	1	0	2	0	3	6
OG0014529	4	0	0	2	0	6
OG0014530	2	1	1	1	1	6
OG0014531	1	0	2	1	2	6
OG0014532	4	0	0	1	1	6
OG0014533	2	1	1	1	1	6
OG0014534	1	2	1	1	1	6
OG0014535	2	2	0	1	1	6
OG0014536	2	1	1	1	1	6
OG0014537	6	0	0	0	0	6
OG0014538	2	2	1	0	1	6
OG0014539	2	1	1	1	1	6
OG0014540	2	2	1	1	0	6
OG0014541	2	1	1	1	1	6
OG0014542	2	0	0	4	0	6
OG0014543	2	2	0	1	1	6
OG0014544	5	1	0	0	0	6
OG0014545	2	2	0	1	1	6
OG0014546	2	0	2	1	1	6
OG0014547	3	0	1	1	1	6
OG0014548	2	3	0	0	1	6
OG0014549	2	2	0	1	1	6
OG0014550	6	0	0	0	0	6
OG0014551	6	0	0	0	0	6
OG0014552	2	2	0	1	1	6
OG0014553	2	0	1	1	2	6
OG0014554	2	0	2	0	2	6
OG0014555	2	1	1	1	1	6
OG0014556	2	1	1	1	1	6
OG0014557	2	1	1	1	1	6
OG0014558	2	2	1	1	0	6
OG0014559	6	0	0	0	0	6
OG0014560	2	1	1	1	1	6
OG0014561	1	2	1	1	1	6
OG0014562	3	0	1	1	1	6
OG0014563	1	2	1	1	1	6
OG0014564	6	0	0	0	0	6
OG0014565	2	2	0	1	1	6
OG0014566	2	1	1	1	1	6
OG0014567	1	2	1	1	1	6
OG0014568	1	2	1	1	1	6
OG0014569	2	0	1	2	1	6
OG0014570	2	2	1	0	1	6
OG0014571	6	0	0	0	0	6
OG0014572	2	2	1	1	0	6
OG0014573	2	2	0	1	1	6
OG0014574	2	3	0	1	0	6
OG0014575	6	0	0	0	0	6
OG0014576	4	2	0	0	0	6
OG0014577	2	2	1	1	0	6
OG0014578	3	0	1	1	1	6
OG0014579	2	1	1	1	1	6
OG0014580	6	0	0	0	0	6
OG0014581	2	1	1	1	1	6
OG0014582	5	0	0	1	0	6
OG0014583	2	2	1	0	1	6
OG0014584	2	2	0	1	1	6
OG0014585	5	0	0	0	1	6
OG0014586	3	0	1	1	1	6
OG0014587	2	1	1	1	1	6
OG0014588	2	2	0	1	1	6
OG0014589	2	2	0	1	1	6
OG0014590	3	0	0	1	2	6
OG0014591	2	0	2	1	1	6
OG0014592	2	2	0	1	1	6
OG0014593	2	2	1	1	0	6
OG0014594	2	0	3	0	1	6
OG0014595	2	0	2	1	1	6
OG0014596	3	0	1	1	1	6
OG0014597	2	1	1	1	1	6
OG0014598	2	0	2	1	1	6
OG0014599	2	0	2	1	1	6
OG0014600	2	2	1	0	1	6
OG0014601	2	1	1	1	1	6
OG0014602	2	2	1	1	0	6
OG0014603	2	1	1	1	1	6
OG0014604	2	1	1	1	1	6
OG0014605	2	2	0	1	1	6
OG0014606	2	2	0	1	1	6
OG0014607	2	1	1	1	1	6
OG0014608	2	2	0	1	1	6
OG0014609	2	0	1	1	2	6
OG0014610	6	0	0	0	0	6
OG0014611	4	0	0	1	1	6
OG0014612	2	2	0	1	1	6
OG0014613	6	0	0	0	0	6
OG0014614	6	0	0	0	0	6
OG0014615	2	1	1	1	1	6
OG0014616	6	0	0	0	0	6
OG0014617	6	0	0	0	0	6
OG0014618	2	2	1	0	1	6
OG0014619	5	1	0	0	0	6
OG0014620	3	1	0	1	1	6
OG0014621	3	2	0	1	0	6
OG0014622	2	1	1	1	1	6
OG0014623	2	1	1	1	1	6
OG0014624	2	2	0	1	1	6
OG0014625	2	2	1	1	0	6
OG0014626	2	3	0	1	0	6
OG0014627	2	1	1	1	1	6
OG0014628	6	0	0	0	0	6
OG0014629	3	0	1	1	1	6
OG0014630	2	2	1	1	0	6
OG0014631	2	1	1	1	1	6
OG0014632	6	0	0	0	0	6
OG0014633	2	0	1	1	2	6
OG0014634	2	1	1	1	1	6
OG0014635	2	2	0	1	1	6
OG0014636	2	2	0	0	2	6
OG0014637	2	1	1	1	1	6
OG0014638	2	1	1	1	1	6
OG0014639	2	1	1	1	1	6
OG0014640	2	2	1	0	1	6
OG0014641	2	1	1	1	1	6
OG0014642	2	2	0	1	1	6
OG0014643	2	2	1	1	0	6
OG0014644	2	1	1	1	1	6
OG0014645	2	0	1	2	1	6
OG0014646	1	2	1	1	1	6
OG0014647	2	2	0	1	1	6
OG0014648	2	1	1	1	1	6
OG0014649	2	1	1	1	1	6
OG0014650	1	2	1	1	1	6
OG0014651	3	0	1	1	1	6
OG0014652	2	2	1	1	0	6
OG0014653	3	0	1	1	1	6
OG0014654	2	1	1	1	1	6
OG0014655	1	2	1	1	1	6
OG0014656	1	2	1	1	1	6
OG0014657	2	1	1	1	1	6
OG0014658	6	0	0	0	0	6
OG0014659	2	1	1	1	1	6
OG0014660	2	0	2	1	1	6
OG0014661	2	1	1	1	1	6
OG0014662	1	2	1	1	1	6
OG0014663	3	0	1	1	1	6
OG0014664	1	2	1	1	1	6
OG0014665	1	2	1	1	1	6
OG0014666	2	2	0	1	1	6
OG0014667	2	1	1	1	1	6
OG0014668	2	2	1	1	0	6
OG0014669	2	0	1	1	2	6
OG0014670	2	0	2	1	1	6
OG0014671	2	2	0	1	1	6
OG0014672	2	0	1	1	2	6
OG0014673	6	0	0	0	0	6
OG0014674	1	5	0	0	0	6
OG0014675	6	0	0	0	0	6
OG0014676	1	2	1	1	1	6
OG0014677	2	2	0	1	1	6
OG0014678	2	0	2	1	1	6
OG0014679	1	2	1	1	1	6
OG0014680	4	0	1	0	1	6
OG0014681	2	2	0	2	0	6
OG0014682	2	1	0	3	0	6
OG0014683	2	0	2	1	1	6
OG0014684	2	0	2	1	1	6
OG0014685	2	1	0	1	2	6
OG0014686	1	2	1	1	1	6
OG0014687	2	2	1	0	1	6
OG0014688	6	0	0	0	0	6
OG0014689	2	1	1	1	1	6
OG0014690	2	2	0	1	1	6
OG0014691	1	2	1	1	1	6
OG0014692	1	1	1	2	1	6
OG0014693	1	4	0	1	0	6
OG0014694	1	0	1	2	2	6
OG0014695	3	0	1	1	1	6
OG0014696	5	0	0	1	0	6
OG0014697	1	2	1	1	1	6
OG0014698	1	3	0	1	1	6
OG0014699	2	2	1	0	1	6
OG0014700	1	2	1	1	1	6
OG0014701	2	1	1	1	1	6
OG0014702	2	2	1	1	0	6
OG0014703	2	1	0	1	2	6
OG0014704	1	2	1	1	1	6
OG0014705	2	0	1	2	1	6
OG0014706	6	0	0	0	0	6
OG0014707	2	0	1	1	2	6
OG0014708	3	0	0	1	2	6
OG0014709	1	2	1	1	1	6
OG0014710	2	0	2	1	1	6
OG0014711	1	0	2	1	2	6
OG0014712	1	2	1	1	1	6
OG0014713	2	0	1	2	1	6
OG0014714	6	0	0	0	0	6
OG0014715	1	2	1	1	1	6
OG0014716	2	0	1	2	1	6
OG0014717	2	2	0	1	1	6
OG0014718	2	1	1	1	1	6
OG0014719	6	0	0	0	0	6
OG0014720	6	0	0	0	0	6
OG0014721	2	2	0	1	1	6
OG0014722	1	2	1	1	1	6
OG0014723	6	0	0	0	0	6
OG0014724	2	2	1	0	1	6
OG0014725	3	1	0	1	1	6
OG0014726	3	0	1	1	1	6
OG0014727	2	2	0	1	1	6
OG0014728	2	3	0	1	0	6
OG0014729	2	2	0	1	1	6
OG0014730	2	0	2	1	1	6
OG0014731	2	1	1	1	1	6
OG0014732	2	1	1	1	1	6
OG0014733	2	2	0	1	1	6
OG0014734	2	2	0	1	1	6
OG0014735	6	0	0	0	0	6
OG0014736	2	2	1	1	0	6
OG0014737	2	2	0	1	1	6
OG0014738	1	3	0	1	1	6
OG0014739	2	1	1	1	1	6
OG0014740	6	0	0	0	0	6
OG0014741	2	2	0	1	1	6
OG0014742	2	1	1	1	1	6
OG0014743	2	1	1	1	1	6
OG0014744	2	0	2	1	1	6
OG0014745	2	2	1	1	0	6
OG0014746	2	0	1	2	1	6
OG0014747	2	1	1	1	1	6
OG0014748	6	0	0	0	0	6
OG0014749	1	2	1	1	1	6
OG0014750	5	0	1	0	0	6
OG0014751	2	1	1	1	1	6
OG0014752	2	0	2	0	2	6
OG0014753	2	1	1	1	1	6
OG0014754	6	0	0	0	0	6
OG0014755	2	0	0	4	0	6
OG0014756	1	5	0	0	0	6
OG0014757	1	2	1	1	1	6
OG0014758	2	2	0	1	1	6
OG0014759	2	1	1	1	1	6
OG0014760	1	2	1	1	1	6
OG0014761	4	0	0	1	1	6
OG0014762	2	2	0	1	1	6
OG0014763	2	2	0	1	1	6
OG0014764	2	2	1	1	0	6
OG0014765	2	2	1	1	0	6
OG0014766	2	2	0	1	1	6
OG0014767	2	0	1	1	2	6
OG0014768	2	2	0	1	1	6
OG0014769	2	2	1	1	0	6
OG0014770	2	2	1	0	1	6
OG0014771	2	1	1	1	1	6
OG0014772	1	2	1	1	1	6
OG0014773	2	0	0	2	2	6
OG0014774	6	0	0	0	0	6
OG0014775	2	2	0	2	0	6
OG0014776	2	3	0	1	0	6
OG0014777	2	2	0	1	1	6
OG0014778	2	2	0	1	1	6
OG0014779	3	1	1	0	1	6
OG0014780	6	0	0	0	0	6
OG0014781	2	2	0	1	1	6
OG0014782	2	0	1	1	2	6
OG0014783	2	1	1	1	1	6
OG0014784	2	0	1	1	2	6
OG0014785	6	0	0	0	0	6
OG0014786	2	0	2	1	1	6
OG0014787	2	2	0	1	1	6
OG0014788	2	2	0	1	1	6
OG0014789	2	0	2	1	1	6
OG0014790	2	1	1	1	1	6
OG0014791	2	1	1	1	1	6
OG0014792	2	2	0	1	1	6
OG0014793	1	2	1	1	1	6
OG0014794	2	2	1	1	0	6
OG0014795	2	2	1	1	0	6
OG0014796	2	1	1	1	1	6
OG0014797	1	0	2	1	2	6
OG0014798	2	2	0	1	1	6
OG0014799	2	1	1	1	1	6
OG0014800	2	0	1	1	2	6
OG0014801	2	1	1	1	1	6
OG0014802	2	1	1	1	1	6
OG0014803	2	1	1	1	1	6
OG0014804	1	2	1	1	1	6
OG0014805	2	2	0	1	1	6
OG0014806	2	0	0	4	0	6
OG0014807	2	2	0	1	1	6
OG0014808	2	1	1	1	1	6
OG0014809	2	1	1	1	1	6
OG0014810	2	2	0	1	1	6
OG0014811	2	2	0	1	1	6
OG0014812	2	1	1	1	1	6
OG0014813	2	1	1	1	1	6
OG0014814	1	0	2	1	2	6
OG0014815	6	0	0	0	0	6
OG0014816	6	0	0	0	0	6
OG0014817	1	2	1	1	1	6
OG0014818	1	2	1	1	1	6
OG0014819	1	2	1	2	0	6
OG0014820	6	0	0	0	0	6
OG0014821	1	2	1	1	1	6
OG0014822	5	0	1	0	0	6
OG0014823	1	2	1	1	1	6
OG0014824	1	2	1	1	1	6
OG0014825	1	0	1	1	3	6
OG0014826	1	2	1	1	1	6
OG0014827	1	2	1	1	1	6
OG0014828	1	2	1	1	1	6
OG0014829	1	4	0	0	1	6
OG0014830	6	0	0	0	0	6
OG0014831	3	0	1	1	1	6
OG0014832	6	0	0	0	0	6
OG0014833	2	1	1	1	1	6
OG0014834	2	2	0	1	1	6
OG0014835	2	2	0	1	1	6
OG0014836	2	2	0	1	1	6
OG0014837	2	3	0	1	0	6
OG0014838	1	2	1	1	1	6
OG0014839	2	2	0	1	1	6
OG0014840	2	1	1	1	1	6
OG0014841	1	0	2	1	2	6
OG0014842	2	2	0	1	1	6
OG0014843	1	2	1	1	1	6
OG0014844	2	2	1	0	1	6
OG0014845	2	1	1	1	1	6
OG0014846	2	0	1	1	2	6
OG0014847	1	3	0	2	0	6
OG0014848	2	2	0	1	1	6
OG0014849	2	0	0	4	0	6
OG0014850	1	2	1	1	1	6
OG0014851	2	2	0	1	1	6
OG0014852	2	1	1	1	1	6
OG0014853	2	2	0	1	1	6
OG0014854	2	1	1	1	1	6
OG0014855	1	2	1	1	1	6
OG0014856	2	2	0	1	1	6
OG0014857	2	1	1	1	1	6
OG0014858	2	2	0	1	1	6
OG0014859	2	2	1	1	0	6
OG0014860	2	1	1	1	1	6
OG0014861	2	0	1	1	2	6
OG0014862	2	2	0	1	1	6
OG0014863	2	2	1	1	0	6
OG0014864	1	2	1	1	1	6
OG0014865	2	2	0	1	1	6
OG0014866	2	0	2	1	1	6
OG0014867	2	1	1	1	1	6
OG0014868	2	1	1	1	1	6
OG0014869	1	2	1	1	1	6
OG0014870	2	4	0	0	0	6
OG0014871	2	1	1	1	1	6
OG0014872	2	2	0	1	1	6
OG0014873	1	2	1	1	1	6
OG0014874	2	4	0	0	0	6
OG0014875	2	1	1	1	1	6
OG0014876	2	2	1	1	0	6
OG0014877	2	2	0	1	1	6
OG0014878	2	0	2	1	1	6
OG0014879	4	0	1	1	0	6
OG0014880	2	0	2	1	1	6
OG0014881	2	4	0	0	0	6
OG0014882	2	2	0	1	1	6
OG0014883	2	3	0	1	0	6
OG0014884	2	2	1	1	0	6
OG0014885	1	2	1	1	1	6
OG0014886	4	0	0	2	0	6
OG0014887	2	1	1	1	1	6
OG0014888	2	2	0	1	1	6
OG0014889	2	2	0	1	1	6
OG0014890	2	1	1	1	1	6
OG0014891	2	0	2	0	2	6
OG0014892	2	0	3	0	1	6
OG0014893	2	1	1	1	1	6
OG0014894	2	2	0	1	1	6
OG0014895	2	2	1	1	0	6
OG0014896	2	0	0	2	2	6
OG0014897	2	2	1	1	0	6
OG0014898	2	2	0	1	1	6
OG0014899	2	1	1	1	1	6
OG0014900	1	4	0	1	0	6
OG0014901	2	2	0	1	1	6
OG0014902	2	1	1	1	1	6
OG0014903	1	2	1	1	1	6
OG0014904	2	1	1	1	1	6
OG0014905	1	4	0	0	1	6
OG0014906	2	1	1	1	1	6
OG0014907	2	2	0	1	1	6
OG0014908	6	0	0	0	0	6
OG0014909	2	1	1	1	1	6
OG0014910	2	2	0	1	1	6
OG0014911	2	3	0	1	0	6
OG0014912	2	0	1	1	2	6
OG0014913	2	2	0	1	1	6
OG0014914	1	2	0	1	2	6
OG0014915	2	2	0	1	1	6
OG0014916	2	2	1	0	1	6
OG0014917	2	3	0	1	0	6
OG0014918	2	1	1	1	1	6
OG0014919	2	2	0	1	1	6
OG0014920	2	1	1	1	1	6
OG0014921	3	0	1	1	1	6
OG0014922	6	0	0	0	0	6
OG0014923	1	2	1	1	1	6
OG0014924	1	2	1	1	1	6
OG0014925	1	2	1	1	1	6
OG0014926	1	1	1	2	1	6
OG0014927	1	2	1	2	0	6
OG0014928	1	2	1	1	1	6
OG0014929	1	2	1	1	1	6
OG0014930	1	2	1	1	1	6
OG0014931	3	0	1	1	1	6
OG0014932	2	1	1	1	1	6
OG0014933	1	2	1	1	1	6
OG0014934	1	2	1	1	1	6
OG0014935	2	2	1	1	0	6
OG0014936	1	2	1	1	1	6
OG0014937	4	1	0	1	0	6
OG0014938	1	2	3	0	0	6
OG0014939	6	0	0	0	0	6
OG0014940	2	2	1	1	0	6
OG0014941	6	0	0	0	0	6
OG0014942	2	1	1	1	1	6
OG0014943	1	3	0	1	1	6
OG0014944	2	2	0	1	1	6
OG0014945	2	2	0	1	1	6
OG0014946	2	2	1	1	0	6
OG0014947	1	2	1	1	1	6
OG0014948	2	2	0	1	1	6
OG0014949	6	0	0	0	0	6
OG0014950	2	2	1	1	0	6
OG0014951	6	0	0	0	0	6
OG0014952	2	2	1	1	0	6
OG0014953	6	0	0	0	0	6
OG0014954	1	1	1	1	2	6
OG0014955	2	1	1	1	1	6
OG0014956	2	2	0	1	1	6
OG0014957	1	2	1	1	1	6
OG0014958	2	2	1	1	0	6
OG0014959	2	1	1	1	1	6
OG0014960	2	2	0	1	1	6
OG0014961	1	2	1	1	1	6
OG0014962	4	0	2	0	0	6
OG0014963	2	2	0	1	1	6
OG0014964	2	3	0	1	0	6
OG0014965	2	0	2	1	1	6
OG0014966	6	0	0	0	0	6
OG0014967	2	2	0	1	1	6
OG0014968	2	2	0	1	1	6
OG0014969	1	2	1	1	1	6
OG0014970	1	2	1	1	1	6
OG0014971	2	1	0	1	2	6
OG0014972	6	0	0	0	0	6
OG0014973	2	2	0	1	1	6
OG0014974	2	0	1	1	2	6
OG0014975	2	1	1	1	1	6
OG0014976	2	3	0	1	0	6
OG0014977	2	1	0	2	1	6
OG0014978	2	2	0	1	1	6
OG0014979	1	0	0	0	5	6
OG0014980	2	2	0	1	1	6
OG0014981	2	2	0	1	1	6
OG0014982	2	0	1	2	1	6
OG0014983	6	0	0	0	0	6
OG0014984	2	2	0	1	1	6
OG0014985	2	1	0	2	1	6
OG0014986	2	1	1	1	1	6
OG0014987	2	2	0	1	1	6
OG0014988	2	2	0	1	1	6
OG0014989	2	2	0	1	1	6
OG0014990	1	2	1	1	1	6
OG0014991	2	1	1	1	1	6
OG0014992	2	1	1	1	1	6
OG0014993	6	0	0	0	0	6
OG0014994	3	2	1	0	0	6
OG0014995	1	2	0	2	1	6
OG0014996	2	2	1	0	1	6
OG0014997	1	2	1	1	1	6
OG0014998	1	2	1	1	1	6
OG0014999	1	2	1	1	1	6
OG0015000	1	0	4	0	1	6
OG0015001	3	1	1	0	1	6
OG0015002	1	1	1	1	2	6
OG0015003	1	2	1	1	1	6
OG0015004	1	2	1	1	1	6
OG0015005	1	2	1	1	1	6
OG0015006	1	2	1	1	1	6
OG0015007	1	0	2	2	1	6
OG0015008	1	2	1	1	1	6
OG0015009	1	2	1	1	1	6
OG0015010	1	2	1	1	1	6
OG0015011	1	2	1	1	1	6
OG0015012	1	2	1	1	1	6
OG0015013	1	2	1	1	1	6
OG0015014	1	5	0	0	0	6
OG0015015	1	1	1	1	2	6
OG0015016	1	2	1	1	1	6
OG0015017	1	2	1	1	1	6
OG0015018	3	0	1	1	1	6
OG0015019	1	0	2	1	2	6
OG0015020	1	2	1	1	1	6
OG0015021	1	2	1	1	1	6
OG0015022	1	2	1	1	1	6
OG0015023	1	2	1	1	1	6
OG0015024	1	2	1	1	1	6
OG0015025	1	1	2	1	1	6
OG0015026	1	0	3	1	1	6
OG0015027	1	2	1	1	1	6
OG0015028	1	2	1	1	1	6
OG0015029	1	2	1	1	1	6
OG0015030	2	1	1	1	1	6
OG0015031	2	1	1	1	1	6
OG0015032	2	1	1	1	1	6
OG0015033	6	0	0	0	0	6
OG0015034	6	0	0	0	0	6
OG0015035	6	0	0	0	0	6
OG0015036	2	2	0	1	1	6
OG0015037	2	0	2	1	1	6
OG0015038	2	0	1	1	2	6
OG0015039	2	0	1	2	1	6
OG0015040	2	0	1	2	1	6
OG0015041	2	1	1	1	1	6
OG0015042	2	2	1	1	0	6
OG0015043	2	2	1	1	0	6
OG0015044	6	0	0	0	0	6
OG0015045	6	0	0	0	0	6
OG0015046	2	2	1	1	0	6
OG0015047	2	2	0	1	1	6
OG0015048	2	2	0	1	1	6
OG0015049	2	2	1	1	0	6
OG0015050	2	4	0	0	0	6
OG0015051	6	0	0	0	0	6
OG0015052	2	2	0	1	1	6
OG0015053	2	1	1	1	1	6
OG0015054	6	0	0	0	0	6
OG0015055	2	0	1	1	2	6
OG0015056	6	0	0	0	0	6
OG0015057	2	0	1	1	2	6
OG0015058	2	2	1	1	0	6
OG0015059	2	2	1	1	0	6
OG0015060	1	2	1	1	1	6
OG0015061	2	2	1	1	0	6
OG0015062	1	5	0	0	0	6
OG0015063	2	1	1	1	1	6
OG0015064	1	2	1	1	1	6
OG0015065	2	2	0	1	1	6
OG0015066	1	2	1	1	1	6
OG0015067	2	0	1	2	1	6
OG0015068	2	2	0	1	1	6
OG0015069	2	2	0	1	1	6
OG0015070	2	2	1	1	0	6
OG0015071	1	2	1	1	1	6
OG0015072	2	0	2	1	1	6
OG0015073	2	1	1	1	1	6
OG0015074	2	2	0	1	1	6
OG0015075	2	2	0	1	1	6
OG0015076	2	3	0	1	0	6
OG0015077	2	2	0	1	1	6
OG0015078	4	0	1	0	1	6
OG0015079	6	0	0	0	0	6
OG0015080	2	1	1	1	1	6
OG0015081	2	1	1	1	1	6
OG0015082	2	2	0	1	1	6
OG0015083	2	1	1	1	1	6
OG0015084	2	2	1	1	0	6
OG0015085	2	1	1	1	1	6
OG0015086	2	3	0	0	1	6
OG0015087	3	2	0	1	0	6
OG0015088	2	1	1	1	1	6
OG0015089	1	2	1	1	1	6
OG0015090	1	1	0	1	3	6
OG0015091	3	1	1	0	1	6
OG0015092	2	2	1	1	0	6
OG0015093	2	2	0	1	1	6
OG0015094	2	2	1	1	0	6
OG0015095	2	1	1	1	1	6
OG0015096	1	2	1	1	1	6
OG0015097	2	1	1	1	1	6
OG0015098	2	0	2	1	1	6
OG0015099	2	1	1	1	1	6
OG0015100	2	0	2	1	1	6
OG0015101	2	0	1	2	1	6
OG0015102	3	0	1	1	1	6
OG0015103	2	1	1	1	1	6
OG0015104	1	2	1	1	1	6
OG0015105	2	1	1	1	1	6
OG0015106	2	0	1	2	1	6
OG0015107	2	1	1	1	1	6
OG0015108	1	2	1	1	1	6
OG0015109	2	1	1	1	1	6
OG0015110	2	1	1	1	1	6
OG0015111	2	1	1	1	1	6
OG0015112	4	2	0	0	0	6
OG0015113	2	0	1	2	1	6
OG0015114	2	2	1	1	0	6
OG0015115	2	0	1	0	3	6
OG0015116	2	1	1	1	1	6
OG0015117	2	2	0	1	1	6
OG0015118	2	2	0	1	1	6
OG0015119	2	1	0	2	1	6
OG0015120	1	2	1	1	1	6
OG0015121	2	1	1	1	1	6
OG0015122	1	2	1	1	1	6
OG0015123	1	2	1	1	1	6
OG0015124	1	2	0	2	1	6
OG0015125	1	3	0	1	1	6
OG0015126	1	3	0	1	1	6
OG0015127	1	2	1	1	1	6
OG0015128	1	2	1	1	1	6
OG0015129	1	4	0	0	1	6
OG0015130	1	2	1	1	1	6
OG0015131	1	2	1	1	1	6
OG0015132	1	2	0	2	1	6
OG0015133	1	2	1	1	1	6
OG0015134	1	2	1	1	1	6
OG0015135	1	4	0	1	0	6
OG0015136	1	1	1	1	2	6
OG0015137	1	5	0	0	0	6
OG0015138	1	2	1	1	1	6
OG0015139	1	2	1	1	1	6
OG0015140	1	2	1	1	1	6
OG0015141	3	1	0	1	1	6
OG0015142	1	0	0	0	5	6
OG0015143	1	2	1	1	1	6
OG0015144	1	2	1	1	1	6
OG0015145	1	2	1	1	1	6
OG0015146	1	2	1	1	1	6
OG0015147	2	2	0	1	1	6
OG0015148	2	2	0	1	1	6
OG0015149	1	2	1	1	1	6
OG0015150	1	2	1	1	1	6
OG0015151	2	2	1	0	1	6
OG0015152	2	2	0	1	1	6
OG0015153	1	2	1	1	1	6
OG0015154	1	2	1	1	1	6
OG0015155	1	2	1	1	1	6
OG0015156	1	2	0	1	2	6
OG0015157	1	1	1	1	2	6
OG0015158	1	2	1	1	1	6
OG0015159	1	1	0	4	0	6
OG0015160	1	2	1	1	1	6
OG0015161	1	2	1	1	1	6
OG0015162	1	2	1	1	1	6
OG0015163	1	1	1	1	2	6
OG0015164	1	2	1	1	1	6
OG0015165	1	2	1	1	1	6
OG0015166	1	2	1	1	1	6
OG0015167	1	1	1	2	1	6
OG0015168	1	0	0	0	5	6
OG0015169	1	2	1	1	1	6
OG0015170	1	2	1	1	1	6
OG0015171	0	6	0	0	0	6
OG0015172	0	6	0	0	0	6
OG0015173	0	6	0	0	0	6
OG0015174	0	6	0	0	0	6
OG0015175	0	6	0	0	0	6
OG0015176	0	6	0	0	0	6
OG0015177	0	6	0	0	0	6
OG0015178	0	6	0	0	0	6
OG0015179	0	6	0	0	0	6
OG0015180	0	6	0	0	0	6
OG0015181	0	6	0	0	0	6
OG0015182	0	6	0	0	0	6
OG0015183	0	6	0	0	0	6
OG0015184	0	6	0	0	0	6
OG0015185	0	4	0	1	1	6
OG0015186	0	6	0	0	0	6
OG0015187	0	6	0	0	0	6
OG0015188	0	6	0	0	0	6
OG0015189	0	6	0	0	0	6
OG0015190	0	6	0	0	0	6
OG0015191	0	6	0	0	0	6
OG0015192	0	6	0	0	0	6
OG0015193	0	6	0	0	0	6
OG0015194	0	3	1	1	1	6
OG0015195	0	6	0	0	0	6
OG0015196	0	6	0	0	0	6
OG0015197	0	6	0	0	0	6
OG0015198	0	4	2	0	0	6
OG0015199	0	6	0	0	0	6
OG0015200	0	6	0	0	0	6
OG0015201	0	5	1	0	0	6
OG0015202	0	6	0	0	0	6
OG0015203	0	3	1	1	1	6
OG0015204	0	6	0	0	0	6
OG0015205	0	3	1	1	1	6
OG0015206	0	3	1	1	1	6
OG0015207	0	6	0	0	0	6
OG0015208	0	6	0	0	0	6
OG0015209	0	6	0	0	0	6
OG0015210	0	6	0	0	0	6
OG0015211	0	6	0	0	0	6
OG0015212	0	6	0	0	0	6
OG0015213	0	6	0	0	0	6
OG0015214	0	4	2	0	0	6
OG0015215	0	6	0	0	0	6
OG0015216	0	6	0	0	0	6
OG0015217	0	6	0	0	0	6
OG0015218	0	6	0	0	0	6
OG0015219	0	5	1	0	0	6
OG0015220	0	6	0	0	0	6
OG0015221	0	6	0	0	0	6
OG0015222	0	6	0	0	0	6
OG0015223	0	1	4	0	1	6
OG0015224	0	6	0	0	0	6
OG0015225	0	4	0	1	1	6
OG0015226	0	6	0	0	0	6
OG0015227	0	6	0	0	0	6
OG0015228	0	6	0	0	0	6
OG0015229	0	6	0	0	0	6
OG0015230	0	6	0	0	0	6
OG0015231	0	6	0	0	0	6
OG0015232	0	6	0	0	0	6
OG0015233	0	6	0	0	0	6
OG0015234	0	6	0	0	0	6
OG0015235	0	6	0	0	0	6
OG0015236	0	2	0	1	3	6
OG0015237	0	6	0	0	0	6
OG0015238	0	6	0	0	0	6
OG0015239	0	6	0	0	0	6
OG0015240	0	6	0	0	0	6
OG0015241	0	6	0	0	0	6
OG0015242	0	1	2	1	2	6
OG0015243	0	6	0	0	0	6
OG0015244	0	6	0	0	0	6
OG0015245	0	6	0	0	0	6
OG0015246	0	6	0	0	0	6
OG0015247	0	6	0	0	0	6
OG0015248	0	6	0	0	0	6
OG0015249	0	4	0	1	1	6
OG0015250	0	6	0	0	0	6
OG0015251	0	4	1	1	0	6
OG0015252	0	3	2	0	1	6
OG0015253	0	6	0	0	0	6
OG0015254	0	6	0	0	0	6
OG0015255	0	6	0	0	0	6
OG0015256	0	6	0	0	0	6
OG0015257	0	6	0	0	0	6
OG0015258	0	6	0	0	0	6
OG0015259	0	2	3	1	0	6
OG0015260	0	6	0	0	0	6
OG0015261	0	6	0	0	0	6
OG0015262	0	6	0	0	0	6
OG0015263	0	6	0	0	0	6
OG0015264	0	6	0	0	0	6
OG0015265	0	6	0	0	0	6
OG0015266	0	6	0	0	0	6
OG0015267	0	6	0	0	0	6
OG0015268	0	6	0	0	0	6
OG0015269	0	6	0	0	0	6
OG0015270	0	6	0	0	0	6
OG0015271	0	6	0	0	0	6
OG0015272	0	3	1	1	1	6
OG0015273	0	2	1	2	1	6
OG0015274	0	4	1	0	1	6
OG0015275	0	6	0	0	0	6
OG0015276	0	6	0	0	0	6
OG0015277	0	6	0	0	0	6
OG0015278	0	6	0	0	0	6
OG0015279	0	6	0	0	0	6
OG0015280	0	6	0	0	0	6
OG0015281	0	6	0	0	0	6
OG0015282	0	6	0	0	0	6
OG0015283	0	6	0	0	0	6
OG0015284	0	6	0	0	0	6
OG0015285	0	6	0	0	0	6
OG0015286	0	6	0	0	0	6
OG0015287	0	6	0	0	0	6
OG0015288	0	6	0	0	0	6
OG0015289	0	6	0	0	0	6
OG0015290	0	6	0	0	0	6
OG0015291	0	5	1	0	0	6
OG0015292	0	6	0	0	0	6
OG0015293	0	6	0	0	0	6
OG0015294	0	6	0	0	0	6
OG0015295	0	6	0	0	0	6
OG0015296	0	6	0	0	0	6
OG0015297	0	6	0	0	0	6
OG0015298	0	6	0	0	0	6
OG0015299	0	4	1	1	0	6
OG0015300	0	6	0	0	0	6
OG0015301	0	6	0	0	0	6
OG0015302	0	6	0	0	0	6
OG0015303	0	6	0	0	0	6
OG0015304	0	6	0	0	0	6
OG0015305	0	6	0	0	0	6
OG0015306	0	6	0	0	0	6
OG0015307	0	6	0	0	0	6
OG0015308	0	6	0	0	0	6
OG0015309	0	6	0	0	0	6
OG0015310	0	6	0	0	0	6
OG0015311	0	6	0	0	0	6
OG0015312	0	6	0	0	0	6
OG0015313	0	6	0	0	0	6
OG0015314	0	6	0	0	0	6
OG0015315	0	6	0	0	0	6
OG0015316	0	6	0	0	0	6
OG0015317	0	6	0	0	0	6
OG0015318	0	6	0	0	0	6
OG0015319	0	6	0	0	0	6
OG0015320	0	6	0	0	0	6
OG0015321	0	3	1	1	1	6
OG0015322	0	6	0	0	0	6
OG0015323	0	6	0	0	0	6
OG0015324	0	6	0	0	0	6
OG0015325	0	6	0	0	0	6
OG0015326	0	6	0	0	0	6
OG0015327	0	3	1	1	1	6
OG0015328	0	6	0	0	0	6
OG0015329	0	6	0	0	0	6
OG0015330	0	6	0	0	0	6
OG0015331	0	6	0	0	0	6
OG0015332	0	6	0	0	0	6
OG0015333	0	6	0	0	0	6
OG0015334	0	6	0	0	0	6
OG0015335	0	6	0	0	0	6
OG0015336	0	2	2	1	1	6
OG0015337	0	6	0	0	0	6
OG0015338	0	6	0	0	0	6
OG0015339	0	6	0	0	0	6
OG0015340	0	6	0	0	0	6
OG0015341	0	6	0	0	0	6
OG0015342	0	6	0	0	0	6
OG0015343	0	6	0	0	0	6
OG0015344	0	6	0	0	0	6
OG0015345	0	4	0	1	1	6
OG0015346	0	4	1	1	0	6
OG0015347	0	6	0	0	0	6
OG0015348	0	3	1	1	1	6
OG0015349	0	2	1	2	1	6
OG0015350	0	6	0	0	0	6
OG0015351	0	6	0	0	0	6
OG0015352	0	6	0	0	0	6
OG0015353	0	6	0	0	0	6
OG0015354	0	6	0	0	0	6
OG0015355	0	6	0	0	0	6
OG0015356	0	6	0	0	0	6
OG0015357	0	6	0	0	0	6
OG0015358	0	6	0	0	0	6
OG0015359	0	6	0	0	0	6
OG0015360	0	6	0	0	0	6
OG0015361	0	6	0	0	0	6
OG0015362	0	6	0	0	0	6
OG0015363	0	6	0	0	0	6
OG0015364	0	5	0	1	0	6
OG0015365	0	6	0	0	0	6
OG0015366	0	6	0	0	0	6
OG0015367	0	3	1	1	1	6
OG0015368	0	6	0	0	0	6
OG0015369	0	6	0	0	0	6
OG0015370	0	5	1	0	0	6
OG0015371	0	6	0	0	0	6
OG0015372	0	6	0	0	0	6
OG0015373	0	6	0	0	0	6
OG0015374	0	6	0	0	0	6
OG0015375	0	6	0	0	0	6
OG0015376	0	6	0	0	0	6
OG0015377	0	2	1	2	1	6
OG0015378	0	5	1	0	0	6
OG0015379	0	6	0	0	0	6
OG0015380	0	6	0	0	0	6
OG0015381	0	6	0	0	0	6
OG0015382	0	6	0	0	0	6
OG0015383	0	6	0	0	0	6
OG0015384	0	6	0	0	0	6
OG0015385	0	6	0	0	0	6
OG0015386	0	6	0	0	0	6
OG0015387	0	6	0	0	0	6
OG0015388	0	6	0	0	0	6
OG0015389	0	6	0	0	0	6
OG0015390	0	6	0	0	0	6
OG0015391	0	6	0	0	0	6
OG0015392	0	6	0	0	0	6
OG0015393	0	6	0	0	0	6
OG0015394	0	6	0	0	0	6
OG0015395	0	6	0	0	0	6
OG0015396	0	6	0	0	0	6
OG0015397	0	6	0	0	0	6
OG0015398	0	5	0	1	0	6
OG0015399	0	3	1	1	1	6
OG0015400	0	6	0	0	0	6
OG0015401	0	6	0	0	0	6
OG0015402	0	6	0	0	0	6
OG0015403	0	6	0	0	0	6
OG0015404	0	6	0	0	0	6
OG0015405	0	6	0	0	0	6
OG0015406	0	6	0	0	0	6
OG0015407	0	4	0	1	1	6
OG0015408	0	6	0	0	0	6
OG0015409	0	4	0	1	1	6
OG0015410	0	6	0	0	0	6
OG0015411	0	6	0	0	0	6
OG0015412	0	6	0	0	0	6
OG0015413	0	6	0	0	0	6
OG0015414	0	6	0	0	0	6
OG0015415	0	6	0	0	0	6
OG0015416	0	6	0	0	0	6
OG0015417	0	6	0	0	0	6
OG0015418	0	6	0	0	0	6
OG0015419	0	6	0	0	0	6
OG0015420	0	1	1	2	2	6
OG0015421	0	6	0	0	0	6
OG0015422	0	6	0	0	0	6
OG0015423	0	6	0	0	0	6
OG0015424	0	6	0	0	0	6
OG0015425	0	6	0	0	0	6
OG0015426	0	6	0	0	0	6
OG0015427	0	6	0	0	0	6
OG0015428	0	2	1	2	1	6
OG0015429	0	4	1	1	0	6
OG0015430	0	6	0	0	0	6
OG0015431	0	6	0	0	0	6
OG0015432	0	6	0	0	0	6
OG0015433	0	6	0	0	0	6
OG0015434	0	6	0	0	0	6
OG0015435	0	6	0	0	0	6
OG0015436	0	6	0	0	0	6
OG0015437	0	6	0	0	0	6
OG0015438	0	6	0	0	0	6
OG0015439	0	6	0	0	0	6
OG0015440	0	6	0	0	0	6
OG0015441	0	6	0	0	0	6
OG0015442	0	6	0	0	0	6
OG0015443	0	6	0	0	0	6
OG0015444	0	6	0	0	0	6
OG0015445	0	6	0	0	0	6
OG0015446	0	6	0	0	0	6
OG0015447	0	6	0	0	0	6
OG0015448	0	3	1	1	1	6
OG0015449	0	6	0	0	0	6
OG0015450	0	6	0	0	0	6
OG0015451	0	6	0	0	0	6
OG0015452	0	6	0	0	0	6
OG0015453	0	6	0	0	0	6
OG0015454	0	6	0	0	0	6
OG0015455	0	6	0	0	0	6
OG0015456	0	4	1	0	1	6
OG0015457	0	6	0	0	0	6
OG0015458	0	6	0	0	0	6
OG0015459	0	6	0	0	0	6
OG0015460	0	6	0	0	0	6
OG0015461	0	6	0	0	0	6
OG0015462	0	6	0	0	0	6
OG0015463	0	6	0	0	0	6
OG0015464	0	6	0	0	0	6
OG0015465	0	6	0	0	0	6
OG0015466	0	6	0	0	0	6
OG0015467	0	6	0	0	0	6
OG0015468	0	6	0	0	0	6
OG0015469	0	6	0	0	0	6
OG0015470	0	2	1	1	2	6
OG0015471	0	6	0	0	0	6
OG0015472	0	6	0	0	0	6
OG0015473	0	6	0	0	0	6
OG0015474	0	5	1	0	0	6
OG0015475	0	6	0	0	0	6
OG0015476	0	6	0	0	0	6
OG0015477	0	6	0	0	0	6
OG0015478	0	6	0	0	0	6
OG0015479	0	6	0	0	0	6
OG0015480	0	6	0	0	0	6
OG0015481	0	6	0	0	0	6
OG0015482	0	6	0	0	0	6
OG0015483	0	6	0	0	0	6
OG0015484	0	6	0	0	0	6
OG0015485	0	6	0	0	0	6
OG0015486	0	6	0	0	0	6
OG0015487	0	2	1	1	2	6
OG0015488	0	6	0	0	0	6
OG0015489	0	6	0	0	0	6
OG0015490	0	6	0	0	0	6
OG0015491	0	6	0	0	0	6
OG0015492	0	6	0	0	0	6
OG0015493	0	4	0	1	1	6
OG0015494	0	1	2	1	2	6
OG0015495	0	6	0	0	0	6
OG0015496	0	6	0	0	0	6
OG0015497	0	6	0	0	0	6
OG0015498	0	6	0	0	0	6
OG0015499	0	6	0	0	0	6
OG0015500	0	5	0	0	1	6
OG0015501	0	6	0	0	0	6
OG0015502	0	6	0	0	0	6
OG0015503	0	6	0	0	0	6
OG0015504	0	4	2	0	0	6
OG0015505	0	6	0	0	0	6
OG0015506	0	6	0	0	0	6
OG0015507	0	3	1	1	1	6
OG0015508	0	6	0	0	0	6
OG0015509	0	6	0	0	0	6
OG0015510	0	6	0	0	0	6
OG0015511	0	6	0	0	0	6
OG0015512	0	5	1	0	0	6
OG0015513	0	5	0	0	1	6
OG0015514	0	6	0	0	0	6
OG0015515	0	6	0	0	0	6
OG0015516	0	6	0	0	0	6
OG0015517	0	4	0	1	1	6
OG0015518	0	2	2	0	2	6
OG0015519	0	5	1	0	0	6
OG0015520	0	6	0	0	0	6
OG0015521	0	6	0	0	0	6
OG0015522	0	2	2	1	1	6
OG0015523	0	6	0	0	0	6
OG0015524	0	4	1	1	0	6
OG0015525	0	6	0	0	0	6
OG0015526	0	6	0	0	0	6
OG0015527	0	2	1	2	1	6
OG0015528	0	6	0	0	0	6
OG0015529	0	6	0	0	0	6
OG0015530	0	6	0	0	0	6
OG0015531	0	2	1	2	1	6
OG0015532	0	4	0	2	0	6
OG0015533	0	6	0	0	0	6
OG0015534	0	6	0	0	0	6
OG0015535	0	3	1	1	1	6
OG0015536	0	6	0	0	0	6
OG0015537	0	6	0	0	0	6
OG0015538	0	6	0	0	0	6
OG0015539	0	6	0	0	0	6
OG0015540	0	6	0	0	0	6
OG0015541	0	6	0	0	0	6
OG0015542	0	6	0	0	0	6
OG0015543	0	6	0	0	0	6
OG0015544	0	6	0	0	0	6
OG0015545	0	6	0	0	0	6
OG0015546	0	4	0	1	1	6
OG0015547	0	6	0	0	0	6
OG0015548	0	6	0	0	0	6
OG0015549	0	6	0	0	0	6
OG0015550	0	6	0	0	0	6
OG0015551	0	6	0	0	0	6
OG0015552	0	6	0	0	0	6
OG0015553	0	6	0	0	0	6
OG0015554	0	6	0	0	0	6
OG0015555	0	6	0	0	0	6
OG0015556	0	6	0	0	0	6
OG0015557	0	6	0	0	0	6
OG0015558	0	6	0	0	0	6
OG0015559	0	6	0	0	0	6
OG0015560	0	6	0	0	0	6
OG0015561	0	4	1	0	1	6
OG0015562	0	4	1	0	1	6
OG0015563	0	4	0	1	1	6
OG0015564	0	6	0	0	0	6
OG0015565	0	6	0	0	0	6
OG0015566	0	6	0	0	0	6
OG0015567	0	6	0	0	0	6
OG0015568	0	6	0	0	0	6
OG0015569	0	6	0	0	0	6
OG0015570	0	6	0	0	0	6
OG0015571	0	2	1	1	2	6
OG0015572	0	6	0	0	0	6
OG0015573	0	6	0	0	0	6
OG0015574	0	6	0	0	0	6
OG0015575	0	2	2	1	1	6
OG0015576	0	6	0	0	0	6
OG0015577	0	4	2	0	0	6
OG0015578	0	6	0	0	0	6
OG0015579	0	6	0	0	0	6
OG0015580	0	4	0	1	1	6
OG0015581	0	6	0	0	0	6
OG0015582	0	6	0	0	0	6
OG0015583	0	6	0	0	0	6
OG0015584	0	6	0	0	0	6
OG0015585	0	6	0	0	0	6
OG0015586	0	6	0	0	0	6
OG0015587	0	6	0	0	0	6
OG0015588	0	6	0	0	0	6
OG0015589	0	6	0	0	0	6
OG0015590	0	6	0	0	0	6
OG0015591	0	6	0	0	0	6
OG0015592	0	6	0	0	0	6
OG0015593	0	5	0	0	1	6
OG0015594	0	6	0	0	0	6
OG0015595	0	6	0	0	0	6
OG0015596	0	6	0	0	0	6
OG0015597	0	6	0	0	0	6
OG0015598	0	6	0	0	0	6
OG0015599	0	6	0	0	0	6
OG0015600	0	6	0	0	0	6
OG0015601	0	6	0	0	0	6
OG0015602	0	1	3	0	2	6
OG0015603	0	3	1	1	1	6
OG0015604	0	2	1	2	1	6
OG0015605	0	6	0	0	0	6
OG0015606	0	6	0	0	0	6
OG0015607	0	6	0	0	0	6
OG0015608	0	6	0	0	0	6
OG0015609	0	2	1	2	1	6
OG0015610	0	6	0	0	0	6
OG0015611	0	6	0	0	0	6
OG0015612	0	6	0	0	0	6
OG0015613	0	6	0	0	0	6
OG0015614	0	2	4	0	0	6
OG0015615	0	5	1	0	0	6
OG0015616	0	6	0	0	0	6
OG0015617	0	5	0	1	0	6
OG0015618	0	5	1	0	0	6
OG0015619	0	6	0	0	0	6
OG0015620	0	6	0	0	0	6
OG0015621	0	6	0	0	0	6
OG0015622	0	6	0	0	0	6
OG0015623	0	6	0	0	0	6
OG0015624	0	6	0	0	0	6
OG0015625	0	6	0	0	0	6
OG0015626	0	6	0	0	0	6
OG0015627	0	6	0	0	0	6
OG0015628	0	6	0	0	0	6
OG0015629	0	3	1	1	1	6
OG0015630	0	6	0	0	0	6
OG0015631	0	6	0	0	0	6
OG0015632	0	6	0	0	0	6
OG0015633	0	6	0	0	0	6
OG0015634	0	6	0	0	0	6
OG0015635	0	6	0	0	0	6
OG0015636	0	6	0	0	0	6
OG0015637	0	6	0	0	0	6
OG0015638	0	2	3	1	0	6
OG0015639	0	6	0	0	0	6
OG0015640	0	6	0	0	0	6
OG0015641	0	6	0	0	0	6
OG0015642	0	6	0	0	0	6
OG0015643	0	6	0	0	0	6
OG0015644	0	6	0	0	0	6
OG0015645	0	6	0	0	0	6
OG0015646	0	6	0	0	0	6
OG0015647	0	6	0	0	0	6
OG0015648	0	6	0	0	0	6
OG0015649	0	6	0	0	0	6
OG0015650	0	6	0	0	0	6
OG0015651	0	6	0	0	0	6
OG0015652	0	6	0	0	0	6
OG0015653	0	6	0	0	0	6
OG0015654	0	6	0	0	0	6
OG0015655	0	2	1	2	1	6
OG0015656	0	5	0	1	0	6
OG0015657	0	4	0	2	0	6
OG0015658	0	6	0	0	0	6
OG0015659	0	6	0	0	0	6
OG0015660	0	4	0	2	0	6
OG0015661	0	2	1	1	2	6
OG0015662	0	1	5	0	0	6
OG0015663	0	2	1	1	2	6
OG0015664	0	6	0	0	0	6
OG0015665	0	6	0	0	0	6
OG0015666	0	5	1	0	0	6
OG0015667	0	6	0	0	0	6
OG0015668	0	6	0	0	0	6
OG0015669	0	6	0	0	0	6
OG0015670	0	3	1	1	1	6
OG0015671	0	4	0	1	1	6
OG0015672	0	6	0	0	0	6
OG0015673	0	3	1	1	1	6
OG0015674	0	6	0	0	0	6
OG0015675	0	6	0	0	0	6
OG0015676	0	6	0	0	0	6
OG0015677	0	6	0	0	0	6
OG0015678	0	6	0	0	0	6
OG0015679	0	2	1	1	2	6
OG0015680	0	5	0	1	0	6
OG0015681	0	6	0	0	0	6
OG0015682	0	6	0	0	0	6
OG0015683	0	6	0	0	0	6
OG0015684	0	6	0	0	0	6
OG0015685	0	6	0	0	0	6
OG0015686	0	6	0	0	0	6
OG0015687	0	2	2	1	1	6
OG0015688	0	2	2	1	1	6
OG0015689	0	6	0	0	0	6
OG0015690	0	6	0	0	0	6
OG0015691	0	6	0	0	0	6
OG0015692	0	6	0	0	0	6
OG0015693	0	6	0	0	0	6
OG0015694	0	6	0	0	0	6
OG0015695	0	6	0	0	0	6
OG0015696	0	6	0	0	0	6
OG0015697	0	3	1	1	1	6
OG0015698	0	6	0	0	0	6
OG0015699	0	6	0	0	0	6
OG0015700	0	4	0	1	1	6
OG0015701	0	5	0	1	0	6
OG0015702	0	6	0	0	0	6
OG0015703	0	6	0	0	0	6
OG0015704	0	6	0	0	0	6
OG0015705	0	6	0	0	0	6
OG0015706	0	6	0	0	0	6
OG0015707	0	5	0	1	0	6
OG0015708	0	6	0	0	0	6
OG0015709	0	6	0	0	0	6
OG0015710	0	6	0	0	0	6
OG0015711	0	6	0	0	0	6
OG0015712	0	2	2	1	1	6
OG0015713	0	6	0	0	0	6
OG0015714	0	6	0	0	0	6
OG0015715	0	6	0	0	0	6
OG0015716	0	6	0	0	0	6
OG0015717	0	6	0	0	0	6
OG0015718	0	6	0	0	0	6
OG0015719	0	2	2	0	2	6
OG0015720	0	6	0	0	0	6
OG0015721	0	6	0	0	0	6
OG0015722	0	6	0	0	0	6
OG0015723	0	6	0	0	0	6
OG0015724	0	6	0	0	0	6
OG0015725	0	6	0	0	0	6
OG0015726	0	6	0	0	0	6
OG0015727	0	6	0	0	0	6
OG0015728	0	2	2	1	1	6
OG0015729	0	6	0	0	0	6
OG0015730	0	6	0	0	0	6
OG0015731	0	6	0	0	0	6
OG0015732	0	4	1	1	0	6
OG0015733	0	6	0	0	0	6
OG0015734	0	6	0	0	0	6
OG0015735	0	5	0	0	1	6
OG0015736	0	3	1	1	1	6
OG0015737	0	6	0	0	0	6
OG0015738	0	6	0	0	0	6
OG0015739	0	2	1	1	2	6
OG0015740	0	6	0	0	0	6
OG0015741	0	6	0	0	0	6
OG0015742	0	6	0	0	0	6
OG0015743	0	2	1	1	2	6
OG0015744	0	6	0	0	0	6
OG0015745	0	6	0	0	0	6
OG0015746	0	6	0	0	0	6
OG0015747	0	6	0	0	0	6
OG0015748	0	6	0	0	0	6
OG0015749	0	6	0	0	0	6
OG0015750	0	6	0	0	0	6
OG0015751	0	5	0	1	0	6
OG0015752	0	4	1	0	1	6
OG0015753	0	6	0	0	0	6
OG0015754	0	5	0	0	1	6
OG0015755	0	3	1	1	1	6
OG0015756	0	6	0	0	0	6
OG0015757	0	2	1	2	1	6
OG0015758	0	6	0	0	0	6
OG0015759	0	6	0	0	0	6
OG0015760	0	6	0	0	0	6
OG0015761	0	2	1	1	2	6
OG0015762	0	6	0	0	0	6
OG0015763	0	6	0	0	0	6
OG0015764	0	6	0	0	0	6
OG0015765	0	5	0	1	0	6
OG0015766	0	6	0	0	0	6
OG0015767	0	6	0	0	0	6
OG0015768	0	6	0	0	0	6
OG0015769	0	6	0	0	0	6
OG0015770	0	6	0	0	0	6
OG0015771	0	6	0	0	0	6
OG0015772	0	6	0	0	0	6
OG0015773	0	6	0	0	0	6
OG0015774	0	6	0	0	0	6
OG0015775	0	6	0	0	0	6
OG0015776	0	2	2	1	1	6
OG0015777	0	6	0	0	0	6
OG0015778	0	6	0	0	0	6
OG0015779	0	6	0	0	0	6
OG0015780	0	6	0	0	0	6
OG0015781	0	6	0	0	0	6
OG0015782	0	6	0	0	0	6
OG0015783	0	6	0	0	0	6
OG0015784	0	6	0	0	0	6
OG0015785	0	2	1	2	1	6
OG0015786	0	4	1	0	1	6
OG0015787	0	6	0	0	0	6
OG0015788	0	6	0	0	0	6
OG0015789	0	6	0	0	0	6
OG0015790	0	6	0	0	0	6
OG0015791	0	6	0	0	0	6
OG0015792	0	2	2	1	1	6
OG0015793	0	6	0	0	0	6
OG0015794	0	6	0	0	0	6
OG0015795	0	6	0	0	0	6
OG0015796	0	6	0	0	0	6
OG0015797	0	5	0	1	0	6
OG0015798	0	6	0	0	0	6
OG0015799	0	6	0	0	0	6
OG0015800	0	6	0	0	0	6
OG0015801	0	3	1	1	1	6
OG0015802	0	2	1	1	2	6
OG0015803	0	2	1	2	1	6
OG0015804	0	6	0	0	0	6
OG0015805	0	6	0	0	0	6
OG0015806	0	5	0	1	0	6
OG0015807	0	6	0	0	0	6
OG0015808	0	6	0	0	0	6
OG0015809	0	5	0	1	0	6
OG0015810	0	4	1	0	1	6
OG0015811	0	2	1	1	2	6
OG0015812	0	2	2	2	0	6
OG0015813	0	6	0	0	0	6
OG0015814	0	6	0	0	0	6
OG0015815	0	2	1	2	1	6
OG0015816	0	6	0	0	0	6
OG0015817	0	6	0	0	0	6
OG0015818	0	3	1	1	1	6
OG0015819	0	6	0	0	0	6
OG0015820	0	4	1	0	1	6
OG0015821	0	6	0	0	0	6
OG0015822	0	2	1	2	1	6
OG0015823	0	6	0	0	0	6
OG0015824	0	6	0	0	0	6
OG0015825	0	2	1	2	1	6
OG0015826	0	3	1	1	1	6
OG0015827	0	2	2	1	1	6
OG0015828	0	6	0	0	0	6
OG0015829	0	6	0	0	0	6
OG0015830	0	2	4	0	0	6
OG0015831	0	6	0	0	0	6
OG0015832	0	6	0	0	0	6
OG0015833	0	6	0	0	0	6
OG0015834	0	4	0	1	1	6
OG0015835	0	6	0	0	0	6
OG0015836	0	2	2	1	1	6
OG0015837	0	6	0	0	0	6
OG0015838	0	6	0	0	0	6
OG0015839	0	6	0	0	0	6
OG0015840	0	3	1	1	1	6
OG0015841	0	3	1	1	1	6
OG0015842	0	2	1	1	2	6
OG0015843	0	6	0	0	0	6
OG0015844	0	6	0	0	0	6
OG0015845	0	6	0	0	0	6
OG0015846	0	6	0	0	0	6
OG0015847	0	5	0	1	0	6
OG0015848	0	6	0	0	0	6
OG0015849	0	6	0	0	0	6
OG0015850	0	6	0	0	0	6
OG0015851	0	6	0	0	0	6
OG0015852	0	6	0	0	0	6
OG0015853	0	2	2	0	2	6
OG0015854	0	6	0	0	0	6
OG0015855	0	3	0	1	2	6
OG0015856	0	6	0	0	0	6
OG0015857	0	6	0	0	0	6
OG0015858	0	2	1	1	2	6
OG0015859	0	6	0	0	0	6
OG0015860	0	3	1	1	1	6
OG0015861	0	6	0	0	0	6
OG0015862	0	3	1	1	1	6
OG0015863	0	2	1	2	1	6
OG0015864	0	2	2	1	1	6
OG0015865	0	2	1	2	1	6
OG0015866	0	6	0	0	0	6
OG0015867	0	5	0	1	0	6
OG0015868	0	3	1	1	1	6
OG0015869	0	6	0	0	0	6
OG0015870	0	3	1	1	1	6
OG0015871	0	6	0	0	0	6
OG0015872	0	6	0	0	0	6
OG0015873	0	6	0	0	0	6
OG0015874	0	6	0	0	0	6
OG0015875	0	4	1	1	0	6
OG0015876	0	2	1	2	1	6
OG0015877	0	1	1	2	2	6
OG0015878	0	4	0	2	0	6
OG0015879	0	2	2	1	1	6
OG0015880	0	2	2	2	0	6
OG0015881	0	4	1	1	0	6
OG0015882	0	6	0	0	0	6
OG0015883	0	2	2	1	1	6
OG0015884	0	4	1	0	1	6
OG0015885	0	4	0	2	0	6
OG0015886	0	2	1	1	2	6
OG0015887	0	6	0	0	0	6
OG0015888	0	2	2	1	1	6
OG0015889	0	3	1	1	1	6
OG0015890	0	3	0	3	0	6
OG0015891	0	2	2	1	1	6
OG0015892	0	3	1	1	1	6
OG0015893	0	3	1	1	1	6
OG0015894	0	1	4	1	0	6
OG0015895	0	6	0	0	0	6
OG0015896	0	1	3	1	1	6
OG0015897	0	3	1	1	1	6
OG0015898	0	1	1	3	1	6
OG0015899	0	2	2	1	1	6
OG0015900	0	2	2	1	1	6
OG0015901	0	2	1	0	3	6
OG0015902	0	3	1	1	1	6
OG0015903	0	2	4	0	0	6
OG0015904	0	6	0	0	0	6
OG0015905	0	2	1	1	2	6
OG0015906	0	1	2	1	2	6
OG0015907	0	0	5	0	1	6
OG0015908	0	0	5	0	1	6
OG0015909	0	0	2	0	4	6
OG0015910	0	0	4	0	2	6
OG0015911	0	0	2	0	4	6
OG0015912	0	0	2	0	4	6
OG0015913	0	0	5	0	1	6
OG0015914	0	0	2	0	4	6
OG0015915	0	0	5	0	1	6
OG0015916	0	0	2	2	2	6
OG0015917	0	0	4	0	2	6
OG0015918	0	0	6	0	0	6
OG0015919	0	0	3	0	3	6
OG0015920	0	0	6	0	0	6
OG0015921	0	0	5	0	1	6
OG0015922	0	0	6	0	0	6
OG0015923	0	0	5	0	1	6
OG0015924	0	0	3	0	3	6
OG0015925	0	0	6	0	0	6
OG0015926	0	0	5	0	1	6
OG0015927	0	0	6	0	0	6
OG0015928	0	0	5	1	0	6
OG0015929	0	0	1	5	0	6
OG0015930	0	0	6	0	0	6
OG0015931	0	0	5	1	0	6
OG0015932	0	0	6	0	0	6
OG0015933	0	0	4	0	2	6
OG0015934	0	0	3	0	3	6
OG0015935	0	0	5	0	1	6
OG0015936	0	0	4	0	2	6
OG0015937	0	0	3	0	3	6
OG0015938	0	0	1	0	5	6
OG0015939	0	0	2	1	3	6
OG0015940	0	0	6	0	0	6
OG0015941	0	0	4	0	2	6
OG0015942	0	0	6	0	0	6
OG0015943	0	0	6	0	0	6
OG0015944	0	0	6	0	0	6
OG0015945	0	0	1	0	5	6
OG0015946	0	0	5	0	1	6
OG0015947	0	0	6	0	0	6
OG0015948	0	0	3	0	3	6
OG0015949	0	0	5	0	1	6
OG0015950	0	0	5	0	1	6
OG0015951	0	0	2	3	1	6
OG0015952	0	0	5	0	1	6
OG0015953	0	0	4	0	2	6
OG0015954	0	0	6	0	0	6
OG0015955	0	0	6	0	0	6
OG0015956	0	0	6	0	0	6
OG0015957	0	0	4	0	2	6
OG0015958	0	0	2	4	0	6
OG0015959	0	0	1	5	0	6
OG0015960	0	0	5	0	1	6
OG0015961	0	0	3	0	3	6
OG0015962	0	0	3	0	3	6
OG0015963	0	0	6	0	0	6
OG0015964	0	0	5	0	1	6
OG0015965	0	0	6	0	0	6
OG0015966	0	0	2	0	4	6
OG0015967	0	0	6	0	0	6
OG0015968	0	0	2	1	3	6
OG0015969	0	0	1	0	5	6
OG0015970	0	0	1	1	4	6
OG0015971	0	0	5	0	1	6
OG0015972	0	0	3	1	2	6
OG0015973	0	0	5	0	1	6
OG0015974	0	0	2	2	2	6
OG0015975	0	0	1	0	5	6
OG0015976	0	0	2	0	4	6
OG0015977	0	0	5	0	1	6
OG0015978	0	0	4	0	2	6
OG0015979	0	0	5	0	1	6
OG0015980	0	0	4	0	2	6
OG0015981	0	0	6	0	0	6
OG0015982	0	0	3	0	3	6
OG0015983	0	0	1	0	5	6
OG0015984	0	0	1	5	0	6
OG0015985	0	0	5	0	1	6
OG0015986	0	0	6	0	0	6
OG0015987	0	0	1	2	3	6
OG0015988	0	0	2	0	4	6
OG0015989	0	0	5	0	1	6
OG0015990	0	0	5	0	1	6
OG0015991	0	0	2	0	4	6
OG0015992	0	0	5	0	1	6
OG0015993	0	0	6	0	0	6
OG0015994	0	0	6	0	0	6
OG0015995	0	0	5	0	1	6
OG0015996	0	0	3	1	2	6
OG0015997	0	0	2	0	4	6
OG0015998	0	0	5	0	1	6
OG0015999	0	0	1	4	1	6
OG0016000	0	0	2	3	1	6
OG0016001	0	0	5	0	1	6
OG0016002	0	0	6	0	0	6
OG0016003	0	0	3	0	3	6
OG0016004	0	0	4	0	2	6
OG0016005	0	0	5	0	1	6
OG0016006	0	0	4	1	1	6
OG0016007	0	0	1	0	5	6
OG0016008	0	0	3	0	3	6
OG0016009	0	0	4	1	1	6
OG0016010	0	0	2	0	4	6
OG0016011	0	0	5	0	1	6
OG0016012	0	0	3	1	2	6
OG0016013	0	0	1	0	5	6
OG0016014	0	0	6	0	0	6
OG0016015	0	0	4	0	2	6
OG0016016	0	0	1	0	5	6
OG0016017	0	0	2	2	2	6
OG0016018	0	0	4	2	0	6
OG0016019	0	0	4	1	1	6
OG0016020	0	0	1	0	5	6
OG0016021	0	0	2	0	4	6
OG0016022	0	0	1	2	3	6
OG0016023	0	0	6	0	0	6
OG0016024	0	0	1	0	5	6
OG0016025	0	0	0	6	0	6
OG0016026	0	0	0	6	0	6
OG0016027	0	0	0	6	0	6
OG0016028	0	0	0	6	0	6
OG0016029	0	0	0	6	0	6
OG0016030	0	0	0	6	0	6
OG0016031	0	0	0	6	0	6
OG0016032	0	0	0	6	0	6
OG0016033	0	0	0	6	0	6
OG0016034	0	0	0	6	0	6
OG0016035	0	0	0	6	0	6
OG0016036	0	0	0	6	0	6
OG0016037	0	0	0	6	0	6
OG0016038	0	0	0	6	0	6
OG0016039	0	0	0	6	0	6
OG0016040	0	0	0	5	1	6
OG0016041	0	0	0	6	0	6
OG0016042	0	0	0	6	0	6
OG0016043	0	0	0	6	0	6
OG0016044	0	0	0	5	1	6
OG0016045	0	0	0	6	0	6
OG0016046	0	0	0	6	0	6
OG0016047	0	0	0	6	0	6
OG0016048	0	0	0	6	0	6
OG0016049	0	0	0	6	0	6
OG0016050	0	0	0	6	0	6
OG0016051	0	0	0	6	0	6
OG0016052	0	0	0	6	0	6
OG0016053	0	0	0	6	0	6
OG0016054	0	0	0	6	0	6
OG0016055	0	0	0	1	5	6
OG0016056	0	0	0	6	0	6
OG0016057	0	0	0	6	0	6
OG0016058	0	0	0	6	0	6
OG0016059	0	0	0	6	0	6
OG0016060	0	0	0	6	0	6
OG0016061	0	0	0	4	2	6
OG0016062	0	0	0	0	6	6
OG0016063	0	0	0	0	6	6
OG0016064	0	0	0	0	6	6
OG0016065	0	0	0	0	6	6
OG0016066	0	0	0	0	6	6
OG0016067	0	0	0	0	6	6
OG0016068	0	0	0	0	6	6
OG0016069	0	0	0	0	6	6
OG0016070	0	0	0	0	6	6
OG0016071	0	0	0	0	6	6
OG0016072	0	0	0	0	6	6
OG0016073	0	0	0	0	6	6
OG0016074	0	0	0	0	6	6
OG0016075	0	0	0	0	6	6
OG0016076	0	0	0	0	6	6
OG0016077	0	0	0	0	6	6
OG0016078	0	0	0	0	6	6
OG0016079	0	0	0	0	6	6
OG0016080	0	0	0	0	6	6
OG0016081	0	0	0	0	6	6
OG0016082	0	0	0	0	6	6
OG0016083	0	0	0	0	6	6
OG0016084	0	0	0	0	6	6
OG0016085	0	0	0	0	6	6
OG0016086	0	0	0	0	6	6
OG0016087	0	0	0	0	6	6
OG0016088	0	0	0	0	6	6
OG0016089	0	0	0	0	6	6
OG0016090	0	0	0	0	6	6
OG0016091	0	0	0	0	6	6
OG0016092	0	0	0	0	6	6
OG0016093	0	0	0	0	6	6
OG0016094	0	0	0	0	6	6
OG0016095	0	0	0	0	6	6
OG0016096	0	0	0	0	6	6
OG0016097	0	0	0	0	6	6
OG0016098	0	0	0	0	6	6
OG0016099	0	0	0	0	6	6
OG0016100	0	0	0	0	6	6
OG0016101	0	0	0	0	6	6
OG0016102	0	0	0	0	6	6
OG0016103	0	0	0	0	6	6
OG0016104	0	0	0	0	6	6
OG0016105	0	0	0	0	6	6
OG0016106	0	0	0	0	6	6
OG0016107	0	0	0	0	6	6
OG0016108	0	0	0	0	6	6
OG0016109	0	0	0	0	6	6
OG0016110	0	0	0	0	6	6
OG0016111	0	0	0	0	6	6
OG0016112	0	0	0	0	6	6
OG0016113	5	0	0	0	0	5
OG0016114	5	0	0	0	0	5
OG0016115	2	2	0	1	0	5
OG0016116	5	0	0	0	0	5
OG0016117	5	0	0	0	0	5
OG0016118	2	0	1	1	1	5
OG0016119	5	0	0	0	0	5
OG0016120	5	0	0	0	0	5
OG0016121	2	2	0	0	1	5
OG0016122	5	0	0	0	0	5
OG0016123	5	0	0	0	0	5
OG0016124	5	0	0	0	0	5
OG0016125	5	0	0	0	0	5
OG0016126	2	0	1	1	1	5
OG0016127	2	0	1	1	1	5
OG0016128	5	0	0	0	0	5
OG0016129	5	0	0	0	0	5
OG0016130	5	0	0	0	0	5
OG0016131	5	0	0	0	0	5
OG0016132	5	0	0	0	0	5
OG0016133	5	0	0	0	0	5
OG0016134	5	0	0	0	0	5
OG0016135	4	0	0	1	0	5
OG0016136	2	2	0	1	0	5
OG0016137	5	0	0	0	0	5
OG0016138	1	1	1	1	1	5
OG0016139	3	2	0	0	0	5
OG0016140	5	0	0	0	0	5
OG0016141	3	0	0	1	1	5
OG0016142	2	0	1	1	1	5
OG0016143	5	0	0	0	0	5
OG0016144	1	1	1	1	1	5
OG0016145	2	1	0	1	1	5
OG0016146	5	0	0	0	0	5
OG0016147	4	0	0	1	0	5
OG0016148	2	0	1	1	1	5
OG0016149	5	0	0	0	0	5
OG0016150	1	1	1	1	1	5
OG0016151	4	1	0	0	0	5
OG0016152	2	0	1	1	1	5
OG0016153	5	0	0	0	0	5
OG0016154	5	0	0	0	0	5
OG0016155	2	0	1	1	1	5
OG0016156	1	0	1	2	1	5
OG0016157	4	0	0	1	0	5
OG0016158	4	0	0	1	0	5
OG0016159	2	2	0	0	1	5
OG0016160	2	0	1	1	1	5
OG0016161	5	0	0	0	0	5
OG0016162	5	0	0	0	0	5
OG0016163	5	0	0	0	0	5
OG0016164	5	0	0	0	0	5
OG0016165	5	0	0	0	0	5
OG0016166	5	0	0	0	0	5
OG0016167	1	2	0	1	1	5
OG0016168	5	0	0	0	0	5
OG0016169	5	0	0	0	0	5
OG0016170	1	0	1	1	2	5
OG0016171	5	0	0	0	0	5
OG0016172	2	2	1	0	0	5
OG0016173	5	0	0	0	0	5
OG0016174	2	0	1	1	1	5
OG0016175	5	0	0	0	0	5
OG0016176	5	0	0	0	0	5
OG0016177	2	0	1	1	1	5
OG0016178	5	0	0	0	0	5
OG0016179	2	0	1	1	1	5
OG0016180	5	0	0	0	0	5
OG0016181	5	0	0	0	0	5
OG0016182	2	1	0	1	1	5
OG0016183	5	0	0	0	0	5
OG0016184	4	0	0	1	0	5
OG0016185	4	0	0	1	0	5
OG0016186	4	0	0	1	0	5
OG0016187	5	0	0	0	0	5
OG0016188	4	0	0	1	0	5
OG0016189	5	0	0	0	0	5
OG0016190	2	0	1	1	1	5
OG0016191	4	0	0	1	0	5
OG0016192	1	1	1	1	1	5
OG0016193	2	0	1	1	1	5
OG0016194	1	2	0	1	1	5
OG0016195	2	2	0	1	0	5
OG0016196	3	0	0	1	1	5
OG0016197	2	0	1	0	2	5
OG0016198	5	0	0	0	0	5
OG0016199	5	0	0	0	0	5
OG0016200	5	0	0	0	0	5
OG0016201	5	0	0	0	0	5
OG0016202	4	0	0	1	0	5
OG0016203	4	0	0	1	0	5
OG0016204	5	0	0	0	0	5
OG0016205	5	0	0	0	0	5
OG0016206	4	1	0	0	0	5
OG0016207	2	0	0	0	3	5
OG0016208	4	0	0	0	1	5
OG0016209	4	0	1	0	0	5
OG0016210	5	0	0	0	0	5
OG0016211	3	1	1	0	0	5
OG0016212	5	0	0	0	0	5
OG0016213	2	0	1	1	1	5
OG0016214	5	0	0	0	0	5
OG0016215	2	0	1	1	1	5
OG0016216	5	0	0	0	0	5
OG0016217	2	0	1	1	1	5
OG0016218	2	0	1	1	1	5
OG0016219	5	0	0	0	0	5
OG0016220	5	0	0	0	0	5
OG0016221	5	0	0	0	0	5
OG0016222	5	0	0	0	0	5
OG0016223	3	0	0	1	1	5
OG0016224	5	0	0	0	0	5
OG0016225	5	0	0	0	0	5
OG0016226	3	0	1	0	1	5
OG0016227	5	0	0	0	0	5
OG0016228	2	1	0	1	1	5
OG0016229	5	0	0	0	0	5
OG0016230	2	0	1	1	1	5
OG0016231	1	3	0	1	0	5
OG0016232	2	0	1	1	1	5
OG0016233	2	0	1	1	1	5
OG0016234	5	0	0	0	0	5
OG0016235	2	0	1	1	1	5
OG0016236	5	0	0	0	0	5
OG0016237	2	0	1	1	1	5
OG0016238	5	0	0	0	0	5
OG0016239	5	0	0	0	0	5
OG0016240	5	0	0	0	0	5
OG0016241	5	0	0	0	0	5
OG0016242	1	2	1	0	1	5
OG0016243	5	0	0	0	0	5
OG0016244	5	0	0	0	0	5
OG0016245	2	0	1	1	1	5
OG0016246	1	2	0	1	1	5
OG0016247	5	0	0	0	0	5
OG0016248	5	0	0	0	0	5
OG0016249	2	0	1	1	1	5
OG0016250	5	0	0	0	0	5
OG0016251	2	2	0	1	0	5
OG0016252	2	0	1	1	1	5
OG0016253	2	0	0	0	3	5
OG0016254	2	1	0	1	1	5
OG0016255	4	0	1	0	0	5
OG0016256	5	0	0	0	0	5
OG0016257	4	0	1	0	0	5
OG0016258	1	1	1	1	1	5
OG0016259	5	0	0	0	0	5
OG0016260	5	0	0	0	0	5
OG0016261	2	2	0	1	0	5
OG0016262	1	2	0	1	1	5
OG0016263	5	0	0	0	0	5
OG0016264	5	0	0	0	0	5
OG0016265	2	0	1	1	1	5
OG0016266	5	0	0	0	0	5
OG0016267	5	0	0	0	0	5
OG0016268	2	0	1	1	1	5
OG0016269	4	0	0	1	0	5
OG0016270	5	0	0	0	0	5
OG0016271	1	0	4	0	0	5
OG0016272	2	0	1	1	1	5
OG0016273	2	0	1	1	1	5
OG0016274	2	2	0	1	0	5
OG0016275	2	1	0	1	1	5
OG0016276	5	0	0	0	0	5
OG0016277	2	0	1	1	1	5
OG0016278	5	0	0	0	0	5
OG0016279	4	1	0	0	0	5
OG0016280	5	0	0	0	0	5
OG0016281	5	0	0	0	0	5
OG0016282	5	0	0	0	0	5
OG0016283	4	0	0	1	0	5
OG0016284	5	0	0	0	0	5
OG0016285	2	1	0	1	1	5
OG0016286	2	0	1	1	1	5
OG0016287	5	0	0	0	0	5
OG0016288	2	0	1	1	1	5
OG0016289	2	0	1	1	1	5
OG0016290	5	0	0	0	0	5
OG0016291	5	0	0	0	0	5
OG0016292	1	1	1	1	1	5
OG0016293	5	0	0	0	0	5
OG0016294	5	0	0	0	0	5
OG0016295	5	0	0	0	0	5
OG0016296	5	0	0	0	0	5
OG0016297	5	0	0	0	0	5
OG0016298	2	0	1	1	1	5
OG0016299	2	0	1	1	1	5
OG0016300	2	2	0	1	0	5
OG0016301	3	0	0	1	1	5
OG0016302	1	2	0	1	1	5
OG0016303	2	0	1	1	1	5
OG0016304	2	3	0	0	0	5
OG0016305	2	0	1	1	1	5
OG0016306	5	0	0	0	0	5
OG0016307	2	0	1	1	1	5
OG0016308	1	2	0	1	1	5
OG0016309	2	0	1	1	1	5
OG0016310	5	0	0	0	0	5
OG0016311	5	0	0	0	0	5
OG0016312	5	0	0	0	0	5
OG0016313	2	2	0	1	0	5
OG0016314	2	0	1	1	1	5
OG0016315	2	1	0	1	1	5
OG0016316	2	0	1	0	2	5
OG0016317	5	0	0	0	0	5
OG0016318	2	0	1	1	1	5
OG0016319	1	3	1	0	0	5
OG0016320	2	2	0	1	0	5
OG0016321	5	0	0	0	0	5
OG0016322	2	0	1	1	1	5
OG0016323	2	0	1	1	1	5
OG0016324	2	0	1	1	1	5
OG0016325	5	0	0	0	0	5
OG0016326	1	1	1	1	1	5
OG0016327	2	0	1	1	1	5
OG0016328	1	0	1	3	0	5
OG0016329	2	0	1	1	1	5
OG0016330	5	0	0	0	0	5
OG0016331	3	1	0	1	0	5
OG0016332	2	1	0	1	1	5
OG0016333	2	0	1	1	1	5
OG0016334	4	0	0	1	0	5
OG0016335	2	0	1	1	1	5
OG0016336	2	1	0	1	1	5
OG0016337	2	1	0	1	1	5
OG0016338	5	0	0	0	0	5
OG0016339	2	0	1	1	1	5
OG0016340	2	0	1	1	1	5
OG0016341	5	0	0	0	0	5
OG0016342	1	2	1	1	0	5
OG0016343	5	0	0	0	0	5
OG0016344	5	0	0	0	0	5
OG0016345	5	0	0	0	0	5
OG0016346	4	0	0	1	0	5
OG0016347	2	2	0	1	0	5
OG0016348	5	0	0	0	0	5
OG0016349	2	2	0	1	0	5
OG0016350	1	0	2	0	2	5
OG0016351	1	1	1	1	1	5
OG0016352	5	0	0	0	0	5
OG0016353	5	0	0	0	0	5
OG0016354	2	0	0	1	2	5
OG0016355	2	0	1	1	1	5
OG0016356	2	0	1	1	1	5
OG0016357	4	0	1	0	0	5
OG0016358	2	0	1	1	1	5
OG0016359	3	0	1	1	0	5
OG0016360	5	0	0	0	0	5
OG0016361	2	1	0	1	1	5
OG0016362	2	2	0	1	0	5
OG0016363	5	0	0	0	0	5
OG0016364	2	0	1	1	1	5
OG0016365	5	0	0	0	0	5
OG0016366	1	1	0	2	1	5
OG0016367	5	0	0	0	0	5
OG0016368	5	0	0	0	0	5
OG0016369	5	0	0	0	0	5
OG0016370	4	0	0	1	0	5
OG0016371	2	0	1	1	1	5
OG0016372	5	0	0	0	0	5
OG0016373	1	1	1	1	1	5
OG0016374	4	0	0	1	0	5
OG0016375	5	0	0	0	0	5
OG0016376	5	0	0	0	0	5
OG0016377	5	0	0	0	0	5
OG0016378	5	0	0	0	0	5
OG0016379	1	1	1	1	1	5
OG0016380	2	1	0	1	1	5
OG0016381	5	0	0	0	0	5
OG0016382	2	0	1	1	1	5
OG0016383	5	0	0	0	0	5
OG0016384	5	0	0	0	0	5
OG0016385	5	0	0	0	0	5
OG0016386	2	0	0	3	0	5
OG0016387	4	0	0	1	0	5
OG0016388	2	0	1	1	1	5
OG0016389	2	3	0	0	0	5
OG0016390	5	0	0	0	0	5
OG0016391	5	0	0	0	0	5
OG0016392	2	1	0	1	1	5
OG0016393	2	0	1	1	1	5
OG0016394	2	0	1	1	1	5
OG0016395	5	0	0	0	0	5
OG0016396	2	2	0	1	0	5
OG0016397	1	0	2	2	0	5
OG0016398	5	0	0	0	0	5
OG0016399	5	0	0	0	0	5
OG0016400	2	1	0	1	1	5
OG0016401	2	0	1	1	1	5
OG0016402	3	0	2	0	0	5
OG0016403	2	0	1	1	1	5
OG0016404	2	0	1	1	1	5
OG0016405	2	0	1	1	1	5
OG0016406	5	0	0	0	0	5
OG0016407	5	0	0	0	0	5
OG0016408	5	0	0	0	0	5
OG0016409	5	0	0	0	0	5
OG0016410	1	1	1	1	1	5
OG0016411	1	1	1	1	1	5
OG0016412	5	0	0	0	0	5
OG0016413	2	0	1	1	1	5
OG0016414	3	0	1	0	1	5
OG0016415	2	0	1	1	1	5
OG0016416	2	0	1	1	1	5
OG0016417	2	0	1	1	1	5
OG0016418	5	0	0	0	0	5
OG0016419	1	0	1	2	1	5
OG0016420	2	1	0	1	1	5
OG0016421	2	0	1	1	1	5
OG0016422	5	0	0	0	0	5
OG0016423	3	0	1	0	1	5
OG0016424	2	0	1	1	1	5
OG0016425	2	0	1	1	1	5
OG0016426	2	0	1	1	1	5
OG0016427	5	0	0	0	0	5
OG0016428	2	0	1	1	1	5
OG0016429	4	0	0	0	1	5
OG0016430	4	0	0	1	0	5
OG0016431	2	0	1	1	1	5
OG0016432	5	0	0	0	0	5
OG0016433	1	2	0	1	1	5
OG0016434	1	2	0	1	1	5
OG0016435	2	0	1	1	1	5
OG0016436	3	1	0	1	0	5
OG0016437	5	0	0	0	0	5
OG0016438	2	0	1	1	1	5
OG0016439	5	0	0	0	0	5
OG0016440	4	0	0	1	0	5
OG0016441	5	0	0	0	0	5
OG0016442	5	0	0	0	0	5
OG0016443	2	0	1	1	1	5
OG0016444	5	0	0	0	0	5
OG0016445	1	1	1	1	1	5
OG0016446	2	0	1	1	1	5
OG0016447	2	1	0	1	1	5
OG0016448	2	0	1	1	1	5
OG0016449	2	2	0	1	0	5
OG0016450	2	0	1	1	1	5
OG0016451	2	0	1	1	1	5
OG0016452	2	0	2	0	1	5
OG0016453	2	0	1	1	1	5
OG0016454	2	2	0	1	0	5
OG0016455	2	0	1	1	1	5
OG0016456	5	0	0	0	0	5
OG0016457	5	0	0	0	0	5
OG0016458	4	0	0	1	0	5
OG0016459	2	0	1	1	1	5
OG0016460	5	0	0	0	0	5
OG0016461	4	1	0	0	0	5
OG0016462	2	0	1	1	1	5
OG0016463	2	0	1	1	1	5
OG0016464	2	1	0	1	1	5
OG0016465	5	0	0	0	0	5
OG0016466	4	0	0	1	0	5
OG0016467	2	0	1	1	1	5
OG0016468	2	0	1	1	1	5
OG0016469	2	0	1	1	1	5
OG0016470	2	0	1	1	1	5
OG0016471	2	0	0	3	0	5
OG0016472	2	0	1	1	1	5
OG0016473	2	2	0	1	0	5
OG0016474	2	0	1	1	1	5
OG0016475	2	0	1	1	1	5
OG0016476	2	2	0	1	0	5
OG0016477	2	0	1	1	1	5
OG0016478	2	0	1	1	1	5
OG0016479	2	0	1	1	1	5
OG0016480	2	2	0	0	1	5
OG0016481	5	0	0	0	0	5
OG0016482	1	1	1	1	1	5
OG0016483	2	0	1	1	1	5
OG0016484	2	0	1	1	1	5
OG0016485	2	0	1	1	1	5
OG0016486	2	0	0	2	1	5
OG0016487	2	0	1	1	1	5
OG0016488	3	0	1	1	0	5
OG0016489	2	0	1	1	1	5
OG0016490	2	0	1	1	1	5
OG0016491	2	1	1	0	1	5
OG0016492	1	1	1	0	2	5
OG0016493	2	0	1	1	1	5
OG0016494	4	1	0	0	0	5
OG0016495	1	3	0	0	1	5
OG0016496	2	2	0	1	0	5
OG0016497	2	0	1	1	1	5
OG0016498	2	1	0	1	1	5
OG0016499	2	0	1	1	1	5
OG0016500	2	0	1	1	1	5
OG0016501	2	0	0	3	0	5
OG0016502	2	1	0	1	1	5
OG0016503	5	0	0	0	0	5
OG0016504	2	1	0	1	1	5
OG0016505	2	0	0	1	2	5
OG0016506	2	0	1	1	1	5
OG0016507	2	1	1	1	0	5
OG0016508	5	0	0	0	0	5
OG0016509	2	0	1	1	1	5
OG0016510	2	0	1	1	1	5
OG0016511	2	0	2	1	0	5
OG0016512	2	0	1	1	1	5
OG0016513	3	0	1	0	1	5
OG0016514	1	2	1	1	0	5
OG0016515	2	0	1	1	1	5
OG0016516	2	2	0	1	0	5
OG0016517	4	0	0	1	0	5
OG0016518	2	0	1	1	1	5
OG0016519	4	0	0	1	0	5
OG0016520	5	0	0	0	0	5
OG0016521	5	0	0	0	0	5
OG0016522	5	0	0	0	0	5
OG0016523	2	0	0	2	1	5
OG0016524	2	0	2	0	1	5
OG0016525	2	0	1	1	1	5
OG0016526	2	0	1	1	1	5
OG0016527	1	4	0	0	0	5
OG0016528	5	0	0	0	0	5
OG0016529	2	0	1	1	1	5
OG0016530	1	2	0	1	1	5
OG0016531	5	0	0	0	0	5
OG0016532	2	0	1	1	1	5
OG0016533	4	1	0	0	0	5
OG0016534	2	0	2	0	1	5
OG0016535	4	0	0	1	0	5
OG0016536	3	0	0	1	1	5
OG0016537	2	0	1	1	1	5
OG0016538	2	0	1	1	1	5
OG0016539	2	0	1	1	1	5
OG0016540	5	0	0	0	0	5
OG0016541	5	0	0	0	0	5
OG0016542	2	0	1	1	1	5
OG0016543	4	1	0	0	0	5
OG0016544	1	1	1	1	1	5
OG0016545	1	0	0	0	4	5
OG0016546	2	0	1	1	1	5
OG0016547	2	0	1	1	1	5
OG0016548	2	0	0	3	0	5
OG0016549	1	1	1	1	1	5
OG0016550	2	2	0	1	0	5
OG0016551	1	1	1	1	1	5
OG0016552	2	0	0	1	2	5
OG0016553	2	2	0	1	0	5
OG0016554	1	1	1	1	1	5
OG0016555	5	0	0	0	0	5
OG0016556	4	0	0	1	0	5
OG0016557	2	0	1	1	1	5
OG0016558	3	0	1	0	1	5
OG0016559	5	0	0	0	0	5
OG0016560	2	3	0	0	0	5
OG0016561	2	0	1	1	1	5
OG0016562	2	1	0	1	1	5
OG0016563	2	0	1	1	1	5
OG0016564	2	0	1	1	1	5
OG0016565	2	0	1	1	1	5
OG0016566	2	0	1	1	1	5
OG0016567	5	0	0	0	0	5
OG0016568	1	0	1	1	2	5
OG0016569	2	2	0	1	0	5
OG0016570	5	0	0	0	0	5
OG0016571	2	1	1	1	0	5
OG0016572	5	0	0	0	0	5
OG0016573	4	0	0	0	1	5
OG0016574	2	0	1	1	1	5
OG0016575	2	0	1	1	1	5
OG0016576	5	0	0	0	0	5
OG0016577	2	0	1	1	1	5
OG0016578	2	0	1	1	1	5
OG0016579	2	0	1	1	1	5
OG0016580	4	0	0	1	0	5
OG0016581	2	2	0	1	0	5
OG0016582	4	0	0	1	0	5
OG0016583	1	0	1	2	1	5
OG0016584	5	0	0	0	0	5
OG0016585	1	0	4	0	0	5
OG0016586	2	0	1	1	1	5
OG0016587	2	0	1	1	1	5
OG0016588	2	0	1	1	1	5
OG0016589	2	0	1	1	1	5
OG0016590	2	2	0	1	0	5
OG0016591	2	2	0	1	0	5
OG0016592	2	0	1	1	1	5
OG0016593	2	0	1	1	1	5
OG0016594	2	0	1	1	1	5
OG0016595	2	0	1	1	1	5
OG0016596	2	0	1	1	1	5
OG0016597	2	0	1	1	1	5
OG0016598	2	0	1	1	1	5
OG0016599	2	1	2	0	0	5
OG0016600	2	0	1	1	1	5
OG0016601	4	0	0	0	1	5
OG0016602	5	0	0	0	0	5
OG0016603	1	2	1	1	0	5
OG0016604	5	0	0	0	0	5
OG0016605	5	0	0	0	0	5
OG0016606	4	0	0	1	0	5
OG0016607	5	0	0	0	0	5
OG0016608	5	0	0	0	0	5
OG0016609	2	0	1	1	1	5
OG0016610	2	1	0	1	1	5
OG0016611	1	1	1	1	1	5
OG0016612	2	0	1	1	1	5
OG0016613	2	0	1	1	1	5
OG0016614	2	2	0	1	0	5
OG0016615	5	0	0	0	0	5
OG0016616	2	2	0	1	0	5
OG0016617	4	0	0	0	1	5
OG0016618	2	2	0	1	0	5
OG0016619	2	0	1	1	1	5
OG0016620	5	0	0	0	0	5
OG0016621	5	0	0	0	0	5
OG0016622	5	0	0	0	0	5
OG0016623	5	0	0	0	0	5
OG0016624	2	0	1	1	1	5
OG0016625	2	0	1	1	1	5
OG0016626	2	2	0	1	0	5
OG0016627	2	0	1	1	1	5
OG0016628	1	2	1	1	0	5
OG0016629	2	0	1	1	1	5
OG0016630	5	0	0	0	0	5
OG0016631	5	0	0	0	0	5
OG0016632	3	2	0	0	0	5
OG0016633	2	0	1	1	1	5
OG0016634	2	0	1	1	1	5
OG0016635	2	1	0	1	1	5
OG0016636	2	0	1	1	1	5
OG0016637	2	0	1	1	1	5
OG0016638	2	2	0	1	0	5
OG0016639	4	0	0	1	0	5
OG0016640	5	0	0	0	0	5
OG0016641	1	1	1	1	1	5
OG0016642	2	0	1	1	1	5
OG0016643	2	0	1	1	1	5
OG0016644	2	0	1	1	1	5
OG0016645	5	0	0	0	0	5
OG0016646	2	0	1	1	1	5
OG0016647	2	0	1	1	1	5
OG0016648	2	1	1	1	0	5
OG0016649	2	0	1	1	1	5
OG0016650	5	0	0	0	0	5
OG0016651	3	0	1	0	1	5
OG0016652	2	0	1	0	2	5
OG0016653	5	0	0	0	0	5
OG0016654	2	0	1	1	1	5
OG0016655	5	0	0	0	0	5
OG0016656	5	0	0	0	0	5
OG0016657	2	0	1	1	1	5
OG0016658	2	0	1	1	1	5
OG0016659	3	2	0	0	0	5
OG0016660	2	0	1	1	1	5
OG0016661	5	0	0	0	0	5
OG0016662	2	0	1	1	1	5
OG0016663	5	0	0	0	0	5
OG0016664	5	0	0	0	0	5
OG0016665	5	0	0	0	0	5
OG0016666	2	0	1	1	1	5
OG0016667	2	2	0	1	0	5
OG0016668	2	0	1	1	1	5
OG0016669	2	1	0	1	1	5
OG0016670	2	0	1	1	1	5
OG0016671	4	0	0	1	0	5
OG0016672	2	0	1	1	1	5
OG0016673	2	2	0	1	0	5
OG0016674	2	1	1	1	0	5
OG0016675	2	0	1	1	1	5
OG0016676	5	0	0	0	0	5
OG0016677	2	1	0	1	1	5
OG0016678	2	0	1	1	1	5
OG0016679	5	0	0	0	0	5
OG0016680	5	0	0	0	0	5
OG0016681	2	0	1	1	1	5
OG0016682	2	2	1	0	0	5
OG0016683	2	0	1	1	1	5
OG0016684	1	2	0	1	1	5
OG0016685	2	0	1	1	1	5
OG0016686	1	1	1	1	1	5
OG0016687	2	1	0	1	1	5
OG0016688	5	0	0	0	0	5
OG0016689	2	0	1	1	1	5
OG0016690	4	1	0	0	0	5
OG0016691	2	2	0	1	0	5
OG0016692	2	0	1	1	1	5
OG0016693	2	0	1	1	1	5
OG0016694	2	0	1	1	1	5
OG0016695	2	1	0	1	1	5
OG0016696	2	0	1	1	1	5
OG0016697	2	0	1	1	1	5
OG0016698	2	0	0	2	1	5
OG0016699	2	1	0	1	1	5
OG0016700	2	2	0	1	0	5
OG0016701	2	0	1	1	1	5
OG0016702	2	0	1	1	1	5
OG0016703	2	0	1	1	1	5
OG0016704	2	1	0	1	1	5
OG0016705	2	0	1	1	1	5
OG0016706	4	0	0	1	0	5
OG0016707	2	0	1	1	1	5
OG0016708	2	0	1	1	1	5
OG0016709	2	0	1	1	1	5
OG0016710	2	0	1	1	1	5
OG0016711	5	0	0	0	0	5
OG0016712	1	0	1	1	2	5
OG0016713	3	0	2	0	0	5
OG0016714	2	2	0	1	0	5
OG0016715	2	0	1	1	1	5
OG0016716	5	0	0	0	0	5
OG0016717	1	2	1	1	0	5
OG0016718	2	0	1	1	1	5
OG0016719	5	0	0	0	0	5
OG0016720	1	3	0	1	0	5
OG0016721	2	0	1	1	1	5
OG0016722	1	2	1	1	0	5
OG0016723	2	0	1	1	1	5
OG0016724	2	2	0	1	0	5
OG0016725	2	1	0	1	1	5
OG0016726	2	0	1	1	1	5
OG0016727	2	2	0	1	0	5
OG0016728	2	0	1	2	0	5
OG0016729	5	0	0	0	0	5
OG0016730	1	1	1	1	1	5
OG0016731	2	0	1	1	1	5
OG0016732	2	0	1	1	1	5
OG0016733	2	0	1	1	1	5
OG0016734	2	2	0	1	0	5
OG0016735	2	0	1	1	1	5
OG0016736	2	0	1	1	1	5
OG0016737	2	0	1	1	1	5
OG0016738	2	0	2	1	0	5
OG0016739	2	0	1	1	1	5
OG0016740	1	0	2	1	1	5
OG0016741	5	0	0	0	0	5
OG0016742	2	0	1	1	1	5
OG0016743	2	2	0	1	0	5
OG0016744	2	0	1	1	1	5
OG0016745	2	3	0	0	0	5
OG0016746	2	0	1	1	1	5
OG0016747	2	1	1	1	0	5
OG0016748	5	0	0	0	0	5
OG0016749	2	2	0	1	0	5
OG0016750	2	2	0	1	0	5
OG0016751	2	0	1	1	1	5
OG0016752	2	0	1	1	1	5
OG0016753	2	0	2	0	1	5
OG0016754	4	0	1	0	0	5
OG0016755	2	1	0	1	1	5
OG0016756	5	0	0	0	0	5
OG0016757	2	0	1	1	1	5
OG0016758	5	0	0	0	0	5
OG0016759	1	2	0	1	1	5
OG0016760	5	0	0	0	0	5
OG0016761	1	2	0	1	1	5
OG0016762	5	0	0	0	0	5
OG0016763	4	0	0	1	0	5
OG0016764	2	2	0	1	0	5
OG0016765	2	0	1	1	1	5
OG0016766	2	2	0	1	0	5
OG0016767	2	2	0	1	0	5
OG0016768	1	0	1	2	1	5
OG0016769	2	0	1	1	1	5
OG0016770	2	1	0	1	1	5
OG0016771	2	0	1	1	1	5
OG0016772	1	1	1	1	1	5
OG0016773	2	0	1	1	1	5
OG0016774	2	0	1	1	1	5
OG0016775	2	0	1	1	1	5
OG0016776	5	0	0	0	0	5
OG0016777	2	2	0	1	0	5
OG0016778	2	0	1	1	1	5
OG0016779	2	2	0	0	1	5
OG0016780	2	0	1	1	1	5
OG0016781	2	2	0	1	0	5
OG0016782	4	0	0	1	0	5
OG0016783	2	1	1	1	0	5
OG0016784	2	0	1	1	1	5
OG0016785	2	2	0	1	0	5
OG0016786	4	0	0	1	0	5
OG0016787	2	0	1	1	1	5
OG0016788	1	1	1	1	1	5
OG0016789	2	2	0	1	0	5
OG0016790	2	0	1	1	1	5
OG0016791	1	0	1	1	2	5
OG0016792	2	0	1	1	1	5
OG0016793	2	0	1	1	1	5
OG0016794	4	0	0	1	0	5
OG0016795	2	0	0	3	0	5
OG0016796	3	0	1	0	1	5
OG0016797	2	0	1	1	1	5
OG0016798	2	2	0	1	0	5
OG0016799	4	0	0	0	1	5
OG0016800	2	0	1	1	1	5
OG0016801	2	0	2	1	0	5
OG0016802	2	0	1	1	1	5
OG0016803	2	0	1	1	1	5
OG0016804	2	0	1	1	1	5
OG0016805	4	0	0	1	0	5
OG0016806	1	1	1	1	1	5
OG0016807	5	0	0	0	0	5
OG0016808	2	0	1	1	1	5
OG0016809	2	0	0	1	2	5
OG0016810	2	0	1	1	1	5
OG0016811	2	0	1	1	1	5
OG0016812	2	0	1	1	1	5
OG0016813	4	1	0	0	0	5
OG0016814	1	2	0	1	1	5
OG0016815	1	0	3	0	1	5
OG0016816	5	0	0	0	0	5
OG0016817	1	1	1	1	1	5
OG0016818	1	4	0	0	0	5
OG0016819	1	2	1	1	0	5
OG0016820	2	0	3	0	0	5
OG0016821	1	2	0	1	1	5
OG0016822	1	2	0	1	1	5
OG0016823	5	0	0	0	0	5
OG0016824	5	0	0	0	0	5
OG0016825	1	4	0	0	0	5
OG0016826	2	1	0	1	1	5
OG0016827	1	1	1	1	1	5
OG0016828	2	0	1	1	1	5
OG0016829	5	0	0	0	0	5
OG0016830	2	0	1	1	1	5
OG0016831	2	2	0	1	0	5
OG0016832	5	0	0	0	0	5
OG0016833	2	3	0	0	0	5
OG0016834	2	2	0	1	0	5
OG0016835	3	0	0	0	2	5
OG0016836	2	0	1	1	1	5
OG0016837	2	0	1	1	1	5
OG0016838	2	2	1	0	0	5
OG0016839	2	0	1	1	1	5
OG0016840	2	1	1	0	1	5
OG0016841	2	0	1	1	1	5
OG0016842	2	0	0	1	2	5
OG0016843	4	1	0	0	0	5
OG0016844	3	0	1	0	1	5
OG0016845	2	0	0	1	2	5
OG0016846	2	0	1	1	1	5
OG0016847	2	0	1	1	1	5
OG0016848	1	0	1	1	2	5
OG0016849	3	2	0	0	0	5
OG0016850	2	0	1	1	1	5
OG0016851	2	0	1	1	1	5
OG0016852	2	0	1	1	1	5
OG0016853	2	3	0	0	0	5
OG0016854	2	0	1	1	1	5
OG0016855	2	0	1	1	1	5
OG0016856	2	2	0	1	0	5
OG0016857	2	0	3	0	0	5
OG0016858	5	0	0	0	0	5
OG0016859	2	0	1	1	1	5
OG0016860	5	0	0	0	0	5
OG0016861	3	0	1	0	1	5
OG0016862	2	2	0	1	0	5
OG0016863	2	2	0	0	1	5
OG0016864	1	0	4	0	0	5
OG0016865	2	0	1	1	1	5
OG0016866	5	0	0	0	0	5
OG0016867	2	0	1	1	1	5
OG0016868	2	0	1	1	1	5
OG0016869	1	1	1	1	1	5
OG0016870	1	2	1	1	0	5
OG0016871	2	0	1	1	1	5
OG0016872	2	2	0	1	0	5
OG0016873	2	2	0	1	0	5
OG0016874	1	2	0	1	1	5
OG0016875	2	2	0	1	0	5
OG0016876	5	0	0	0	0	5
OG0016877	2	2	0	0	1	5
OG0016878	1	1	1	1	1	5
OG0016879	2	0	0	3	0	5
OG0016880	2	0	1	1	1	5
OG0016881	3	1	0	1	0	5
OG0016882	2	0	1	1	1	5
OG0016883	2	0	1	1	1	5
OG0016884	3	0	1	1	0	5
OG0016885	2	2	0	1	0	5
OG0016886	2	0	1	1	1	5
OG0016887	2	0	1	1	1	5
OG0016888	1	2	1	1	0	5
OG0016889	5	0	0	0	0	5
OG0016890	2	1	0	1	1	5
OG0016891	2	2	1	0	0	5
OG0016892	2	2	0	1	0	5
OG0016893	2	0	1	1	1	5
OG0016894	2	0	1	1	1	5
OG0016895	1	3	0	1	0	5
OG0016896	2	0	1	1	1	5
OG0016897	2	1	0	1	1	5
OG0016898	1	0	2	1	1	5
OG0016899	2	1	0	1	1	5
OG0016900	4	0	0	1	0	5
OG0016901	3	0	1	0	1	5
OG0016902	2	0	1	1	1	5
OG0016903	1	0	3	0	1	5
OG0016904	2	0	1	1	1	5
OG0016905	2	0	1	1	1	5
OG0016906	2	0	1	1	1	5
OG0016907	2	2	0	0	1	5
OG0016908	2	2	0	1	0	5
OG0016909	2	0	1	1	1	5
OG0016910	2	2	0	1	0	5
OG0016911	2	0	1	1	1	5
OG0016912	2	2	0	1	0	5
OG0016913	2	0	1	1	1	5
OG0016914	2	0	1	1	1	5
OG0016915	1	2	0	1	1	5
OG0016916	1	2	1	1	0	5
OG0016917	5	0	0	0	0	5
OG0016918	1	2	0	1	1	5
OG0016919	5	0	0	0	0	5
OG0016920	1	2	0	1	1	5
OG0016921	1	2	0	1	1	5
OG0016922	1	0	0	4	0	5
OG0016923	1	1	1	1	1	5
OG0016924	1	3	0	1	0	5
OG0016925	1	0	2	0	2	5
OG0016926	2	2	0	1	0	5
OG0016927	2	0	1	1	1	5
OG0016928	5	0	0	0	0	5
OG0016929	5	0	0	0	0	5
OG0016930	1	1	0	2	1	5
OG0016931	2	0	1	1	1	5
OG0016932	2	0	1	1	1	5
OG0016933	5	0	0	0	0	5
OG0016934	2	0	1	1	1	5
OG0016935	2	0	1	1	1	5
OG0016936	2	1	0	1	1	5
OG0016937	1	0	1	1	2	5
OG0016938	2	0	1	1	1	5
OG0016939	2	0	1	1	1	5
OG0016940	2	0	1	1	1	5
OG0016941	1	2	0	1	1	5
OG0016942	2	0	0	2	1	5
OG0016943	2	0	1	1	1	5
OG0016944	2	0	1	1	1	5
OG0016945	2	0	1	1	1	5
OG0016946	1	0	3	0	1	5
OG0016947	2	0	1	1	1	5
OG0016948	5	0	0	0	0	5
OG0016949	5	0	0	0	0	5
OG0016950	2	0	3	0	0	5
OG0016951	2	0	1	1	1	5
OG0016952	1	2	0	1	1	5
OG0016953	2	0	1	1	1	5
OG0016954	2	0	1	1	1	5
OG0016955	2	1	1	0	1	5
OG0016956	2	0	1	1	1	5
OG0016957	2	0	1	1	1	5
OG0016958	2	0	1	1	1	5
OG0016959	2	0	1	1	1	5
OG0016960	2	1	0	1	1	5
OG0016961	2	0	1	1	1	5
OG0016962	1	1	1	1	1	5
OG0016963	2	2	0	1	0	5
OG0016964	1	1	1	1	1	5
OG0016965	3	0	1	1	0	5
OG0016966	2	0	1	1	1	5
OG0016967	2	2	0	1	0	5
OG0016968	1	2	0	1	1	5
OG0016969	3	0	0	1	1	5
OG0016970	1	4	0	0	0	5
OG0016971	1	1	1	1	1	5
OG0016972	1	2	0	1	1	5
OG0016973	1	1	0	1	2	5
OG0016974	5	0	0	0	0	5
OG0016975	1	2	0	1	1	5
OG0016976	1	0	2	1	1	5
OG0016977	1	0	1	1	2	5
OG0016978	1	3	0	1	0	5
OG0016979	4	1	0	0	0	5
OG0016980	5	0	0	0	0	5
OG0016981	3	0	0	1	1	5
OG0016982	2	2	0	1	0	5
OG0016983	5	0	0	0	0	5
OG0016984	2	0	1	1	1	5
OG0016985	2	0	1	1	1	5
OG0016986	2	0	1	1	1	5
OG0016987	2	1	0	1	1	5
OG0016988	2	0	1	1	1	5
OG0016989	2	0	1	1	1	5
OG0016990	5	0	0	0	0	5
OG0016991	5	0	0	0	0	5
OG0016992	2	2	0	1	0	5
OG0016993	2	0	1	1	1	5
OG0016994	2	0	1	1	1	5
OG0016995	5	0	0	0	0	5
OG0016996	2	0	1	1	1	5
OG0016997	5	0	0	0	0	5
OG0016998	2	1	0	1	1	5
OG0016999	5	0	0	0	0	5
OG0017000	1	1	1	1	1	5
OG0017001	2	0	1	1	1	5
OG0017002	2	1	0	1	1	5
OG0017003	2	0	1	1	1	5
OG0017004	5	0	0	0	0	5
OG0017005	4	1	0	0	0	5
OG0017006	2	0	1	1	1	5
OG0017007	1	0	2	0	2	5
OG0017008	2	0	0	1	2	5
OG0017009	3	0	0	2	0	5
OG0017010	2	0	1	1	1	5
OG0017011	2	0	1	1	1	5
OG0017012	1	0	0	4	0	5
OG0017013	1	1	1	1	1	5
OG0017014	2	2	0	1	0	5
OG0017015	2	1	0	1	1	5
OG0017016	2	2	0	1	0	5
OG0017017	5	0	0	0	0	5
OG0017018	2	0	1	1	1	5
OG0017019	2	0	1	1	1	5
OG0017020	2	2	0	1	0	5
OG0017021	2	0	1	1	1	5
OG0017022	2	0	1	1	1	5
OG0017023	1	0	0	2	2	5
OG0017024	2	0	1	1	1	5
OG0017025	2	1	1	1	0	5
OG0017026	5	0	0	0	0	5
OG0017027	3	0	0	1	1	5
OG0017028	2	0	1	1	1	5
OG0017029	1	2	0	1	1	5
OG0017030	1	2	0	1	1	5
OG0017031	5	0	0	0	0	5
OG0017032	4	0	0	0	1	5
OG0017033	1	0	1	1	2	5
OG0017034	1	1	1	1	1	5
OG0017035	1	3	1	0	0	5
OG0017036	1	2	1	1	0	5
OG0017037	1	4	0	0	0	5
OG0017038	1	0	1	1	2	5
OG0017039	1	2	0	1	1	5
OG0017040	1	0	2	1	1	5
OG0017041	1	2	0	1	1	5
OG0017042	1	1	1	1	1	5
OG0017043	1	2	1	0	1	5
OG0017044	1	1	1	1	1	5
OG0017045	1	1	1	1	1	5
OG0017046	1	1	1	1	1	5
OG0017047	1	1	1	1	1	5
OG0017048	1	0	3	0	1	5
OG0017049	1	2	0	1	1	5
OG0017050	1	2	0	1	1	5
OG0017051	1	2	2	0	0	5
OG0017052	1	1	1	1	1	5
OG0017053	1	2	0	1	1	5
OG0017054	1	2	1	1	0	5
OG0017055	4	0	0	1	0	5
OG0017056	1	2	0	1	1	5
OG0017057	2	0	1	1	1	5
OG0017058	1	0	4	0	0	5
OG0017059	1	1	1	1	1	5
OG0017060	1	2	1	1	0	5
OG0017061	2	0	1	1	1	5
OG0017062	1	0	0	4	0	5
OG0017063	1	0	2	1	1	5
OG0017064	1	0	1	1	2	5
OG0017065	1	0	1	1	2	5
OG0017066	1	0	4	0	0	5
OG0017067	1	1	1	1	1	5
OG0017068	1	2	1	1	0	5
OG0017069	1	1	1	1	1	5
OG0017070	0	5	0	0	0	5
OG0017071	0	2	1	1	1	5
OG0017072	0	5	0	0	0	5
OG0017073	0	5	0	0	0	5
OG0017074	0	5	0	0	0	5
OG0017075	0	5	0	0	0	5
OG0017076	0	4	0	0	1	5
OG0017077	0	5	0	0	0	5
OG0017078	0	5	0	0	0	5
OG0017079	0	5	0	0	0	5
OG0017080	0	5	0	0	0	5
OG0017081	0	5	0	0	0	5
OG0017082	0	2	1	1	1	5
OG0017083	0	5	0	0	0	5
OG0017084	0	5	0	0	0	5
OG0017085	0	5	0	0	0	5
OG0017086	0	4	0	1	0	5
OG0017087	0	5	0	0	0	5
OG0017088	0	5	0	0	0	5
OG0017089	0	5	0	0	0	5
OG0017090	0	5	0	0	0	5
OG0017091	0	3	0	1	1	5
OG0017092	0	5	0	0	0	5
OG0017093	0	5	0	0	0	5
OG0017094	0	5	0	0	0	5
OG0017095	0	5	0	0	0	5
OG0017096	0	5	0	0	0	5
OG0017097	0	5	0	0	0	5
OG0017098	0	2	1	1	1	5
OG0017099	0	5	0	0	0	5
OG0017100	0	5	0	0	0	5
OG0017101	0	5	0	0	0	5
OG0017102	0	5	0	0	0	5
OG0017103	0	5	0	0	0	5
OG0017104	0	5	0	0	0	5
OG0017105	0	5	0	0	0	5
OG0017106	0	5	0	0	0	5
OG0017107	0	5	0	0	0	5
OG0017108	0	5	0	0	0	5
OG0017109	0	5	0	0	0	5
OG0017110	0	5	0	0	0	5
OG0017111	0	5	0	0	0	5
OG0017112	0	5	0	0	0	5
OG0017113	0	5	0	0	0	5
OG0017114	0	2	1	1	1	5
OG0017115	0	5	0	0	0	5
OG0017116	0	2	1	1	1	5
OG0017117	0	5	0	0	0	5
OG0017118	0	5	0	0	0	5
OG0017119	0	5	0	0	0	5
OG0017120	0	5	0	0	0	5
OG0017121	0	5	0	0	0	5
OG0017122	0	5	0	0	0	5
OG0017123	0	5	0	0	0	5
OG0017124	0	5	0	0	0	5
OG0017125	0	2	3	0	0	5
OG0017126	0	5	0	0	0	5
OG0017127	0	5	0	0	0	5
OG0017128	0	5	0	0	0	5
OG0017129	0	2	2	0	1	5
OG0017130	0	5	0	0	0	5
OG0017131	0	5	0	0	0	5
OG0017132	0	5	0	0	0	5
OG0017133	0	5	0	0	0	5
OG0017134	0	5	0	0	0	5
OG0017135	0	5	0	0	0	5
OG0017136	0	5	0	0	0	5
OG0017137	0	5	0	0	0	5
OG0017138	0	5	0	0	0	5
OG0017139	0	2	1	1	1	5
OG0017140	0	5	0	0	0	5
OG0017141	0	5	0	0	0	5
OG0017142	0	3	0	1	1	5
OG0017143	0	5	0	0	0	5
OG0017144	0	5	0	0	0	5
OG0017145	0	5	0	0	0	5
OG0017146	0	5	0	0	0	5
OG0017147	0	5	0	0	0	5
OG0017148	0	4	1	0	0	5
OG0017149	0	5	0	0	0	5
OG0017150	0	5	0	0	0	5
OG0017151	0	5	0	0	0	5
OG0017152	0	3	1	1	0	5
OG0017153	0	2	1	1	1	5
OG0017154	0	5	0	0	0	5
OG0017155	0	5	0	0	0	5
OG0017156	0	5	0	0	0	5
OG0017157	0	5	0	0	0	5
OG0017158	0	5	0	0	0	5
OG0017159	0	2	1	1	1	5
OG0017160	0	5	0	0	0	5
OG0017161	0	5	0	0	0	5
OG0017162	0	5	0	0	0	5
OG0017163	0	5	0	0	0	5
OG0017164	0	5	0	0	0	5
OG0017165	0	5	0	0	0	5
OG0017166	0	5	0	0	0	5
OG0017167	0	5	0	0	0	5
OG0017168	0	5	0	0	0	5
OG0017169	0	5	0	0	0	5
OG0017170	0	5	0	0	0	5
OG0017171	0	5	0	0	0	5
OG0017172	0	5	0	0	0	5
OG0017173	0	5	0	0	0	5
OG0017174	0	4	0	1	0	5
OG0017175	0	5	0	0	0	5
OG0017176	0	5	0	0	0	5
OG0017177	0	5	0	0	0	5
OG0017178	0	5	0	0	0	5
OG0017179	0	5	0	0	0	5
OG0017180	0	5	0	0	0	5
OG0017181	0	5	0	0	0	5
OG0017182	0	5	0	0	0	5
OG0017183	0	2	1	1	1	5
OG0017184	0	5	0	0	0	5
OG0017185	0	5	0	0	0	5
OG0017186	0	5	0	0	0	5
OG0017187	0	5	0	0	0	5
OG0017188	0	5	0	0	0	5
OG0017189	0	5	0	0	0	5
OG0017190	0	5	0	0	0	5
OG0017191	0	5	0	0	0	5
OG0017192	0	4	0	1	0	5
OG0017193	0	5	0	0	0	5
OG0017194	0	1	3	0	1	5
OG0017195	0	1	2	1	1	5
OG0017196	0	2	0	1	2	5
OG0017197	0	5	0	0	0	5
OG0017198	0	5	0	0	0	5
OG0017199	0	5	0	0	0	5
OG0017200	0	2	2	0	1	5
OG0017201	0	5	0	0	0	5
OG0017202	0	5	0	0	0	5
OG0017203	0	5	0	0	0	5
OG0017204	0	5	0	0	0	5
OG0017205	0	4	0	1	0	5
OG0017206	0	4	0	1	0	5
OG0017207	0	5	0	0	0	5
OG0017208	0	4	0	1	0	5
OG0017209	0	4	0	0	1	5
OG0017210	0	5	0	0	0	5
OG0017211	0	5	0	0	0	5
OG0017212	0	5	0	0	0	5
OG0017213	0	5	0	0	0	5
OG0017214	0	2	1	1	1	5
OG0017215	0	5	0	0	0	5
OG0017216	0	5	0	0	0	5
OG0017217	0	4	1	0	0	5
OG0017218	0	5	0	0	0	5
OG0017219	0	5	0	0	0	5
OG0017220	0	5	0	0	0	5
OG0017221	0	2	1	1	1	5
OG0017222	0	2	1	1	1	5
OG0017223	0	5	0	0	0	5
OG0017224	0	5	0	0	0	5
OG0017225	0	2	1	1	1	5
OG0017226	0	5	0	0	0	5
OG0017227	0	5	0	0	0	5
OG0017228	0	5	0	0	0	5
OG0017229	0	5	0	0	0	5
OG0017230	0	2	1	1	1	5
OG0017231	0	5	0	0	0	5
OG0017232	0	2	1	1	1	5
OG0017233	0	4	0	1	0	5
OG0017234	0	5	0	0	0	5
OG0017235	0	5	0	0	0	5
OG0017236	0	5	0	0	0	5
OG0017237	0	5	0	0	0	5
OG0017238	0	5	0	0	0	5
OG0017239	0	5	0	0	0	5
OG0017240	0	5	0	0	0	5
OG0017241	0	5	0	0	0	5
OG0017242	0	5	0	0	0	5
OG0017243	0	5	0	0	0	5
OG0017244	0	5	0	0	0	5
OG0017245	0	5	0	0	0	5
OG0017246	0	5	0	0	0	5
OG0017247	0	5	0	0	0	5
OG0017248	0	5	0	0	0	5
OG0017249	0	5	0	0	0	5
OG0017250	0	5	0	0	0	5
OG0017251	0	5	0	0	0	5
OG0017252	0	5	0	0	0	5
OG0017253	0	5	0	0	0	5
OG0017254	0	4	0	1	0	5
OG0017255	0	5	0	0	0	5
OG0017256	0	5	0	0	0	5
OG0017257	0	2	1	1	1	5
OG0017258	0	5	0	0	0	5
OG0017259	0	5	0	0	0	5
OG0017260	0	5	0	0	0	5
OG0017261	0	5	0	0	0	5
OG0017262	0	5	0	0	0	5
OG0017263	0	2	1	1	1	5
OG0017264	0	5	0	0	0	5
OG0017265	0	5	0	0	0	5
OG0017266	0	5	0	0	0	5
OG0017267	0	5	0	0	0	5
OG0017268	0	5	0	0	0	5
OG0017269	0	2	1	1	1	5
OG0017270	0	4	0	1	0	5
OG0017271	0	5	0	0	0	5
OG0017272	0	5	0	0	0	5
OG0017273	0	5	0	0	0	5
OG0017274	0	5	0	0	0	5
OG0017275	0	4	0	1	0	5
OG0017276	0	5	0	0	0	5
OG0017277	0	5	0	0	0	5
OG0017278	0	5	0	0	0	5
OG0017279	0	5	0	0	0	5
OG0017280	0	5	0	0	0	5
OG0017281	0	4	1	0	0	5
OG0017282	0	2	1	1	1	5
OG0017283	0	5	0	0	0	5
OG0017284	0	5	0	0	0	5
OG0017285	0	3	1	1	0	5
OG0017286	0	5	0	0	0	5
OG0017287	0	5	0	0	0	5
OG0017288	0	5	0	0	0	5
OG0017289	0	5	0	0	0	5
OG0017290	0	5	0	0	0	5
OG0017291	0	5	0	0	0	5
OG0017292	0	5	0	0	0	5
OG0017293	0	5	0	0	0	5
OG0017294	0	4	1	0	0	5
OG0017295	0	5	0	0	0	5
OG0017296	0	5	0	0	0	5
OG0017297	0	5	0	0	0	5
OG0017298	0	5	0	0	0	5
OG0017299	0	5	0	0	0	5
OG0017300	0	5	0	0	0	5
OG0017301	0	5	0	0	0	5
OG0017302	0	5	0	0	0	5
OG0017303	0	4	0	0	1	5
OG0017304	0	5	0	0	0	5
OG0017305	0	5	0	0	0	5
OG0017306	0	1	2	1	1	5
OG0017307	0	5	0	0	0	5
OG0017308	0	5	0	0	0	5
OG0017309	0	5	0	0	0	5
OG0017310	0	5	0	0	0	5
OG0017311	0	5	0	0	0	5
OG0017312	0	5	0	0	0	5
OG0017313	0	5	0	0	0	5
OG0017314	0	3	0	1	1	5
OG0017315	0	5	0	0	0	5
OG0017316	0	5	0	0	0	5
OG0017317	0	5	0	0	0	5
OG0017318	0	5	0	0	0	5
OG0017319	0	5	0	0	0	5
OG0017320	0	5	0	0	0	5
OG0017321	0	5	0	0	0	5
OG0017322	0	5	0	0	0	5
OG0017323	0	5	0	0	0	5
OG0017324	0	5	0	0	0	5
OG0017325	0	5	0	0	0	5
OG0017326	0	5	0	0	0	5
OG0017327	0	2	1	1	1	5
OG0017328	0	5	0	0	0	5
OG0017329	0	5	0	0	0	5
OG0017330	0	5	0	0	0	5
OG0017331	0	2	1	1	1	5
OG0017332	0	5	0	0	0	5
OG0017333	0	5	0	0	0	5
OG0017334	0	2	1	1	1	5
OG0017335	0	3	0	1	1	5
OG0017336	0	5	0	0	0	5
OG0017337	0	2	1	1	1	5
OG0017338	0	5	0	0	0	5
OG0017339	0	2	1	1	1	5
OG0017340	0	4	0	1	0	5
OG0017341	0	5	0	0	0	5
OG0017342	0	2	1	1	1	5
OG0017343	0	5	0	0	0	5
OG0017344	0	5	0	0	0	5
OG0017345	0	5	0	0	0	5
OG0017346	0	5	0	0	0	5
OG0017347	0	2	1	1	1	5
OG0017348	0	5	0	0	0	5
OG0017349	0	2	1	1	1	5
OG0017350	0	5	0	0	0	5
OG0017351	0	5	0	0	0	5
OG0017352	0	2	1	1	1	5
OG0017353	0	5	0	0	0	5
OG0017354	0	5	0	0	0	5
OG0017355	0	5	0	0	0	5
OG0017356	0	5	0	0	0	5
OG0017357	0	5	0	0	0	5
OG0017358	0	5	0	0	0	5
OG0017359	0	5	0	0	0	5
OG0017360	0	5	0	0	0	5
OG0017361	0	1	1	2	1	5
OG0017362	0	5	0	0	0	5
OG0017363	0	5	0	0	0	5
OG0017364	0	5	0	0	0	5
OG0017365	0	5	0	0	0	5
OG0017366	0	5	0	0	0	5
OG0017367	0	5	0	0	0	5
OG0017368	0	5	0	0	0	5
OG0017369	0	2	1	1	1	5
OG0017370	0	5	0	0	0	5
OG0017371	0	5	0	0	0	5
OG0017372	0	5	0	0	0	5
OG0017373	0	3	1	0	1	5
OG0017374	0	5	0	0	0	5
OG0017375	0	5	0	0	0	5
OG0017376	0	5	0	0	0	5
OG0017377	0	5	0	0	0	5
OG0017378	0	5	0	0	0	5
OG0017379	0	5	0	0	0	5
OG0017380	0	4	0	1	0	5
OG0017381	0	2	1	1	1	5
OG0017382	0	5	0	0	0	5
OG0017383	0	5	0	0	0	5
OG0017384	0	5	0	0	0	5
OG0017385	0	2	1	1	1	5
OG0017386	0	5	0	0	0	5
OG0017387	0	5	0	0	0	5
OG0017388	0	5	0	0	0	5
OG0017389	0	5	0	0	0	5
OG0017390	0	5	0	0	0	5
OG0017391	0	5	0	0	0	5
OG0017392	0	2	1	1	1	5
OG0017393	0	4	1	0	0	5
OG0017394	0	5	0	0	0	5
OG0017395	0	5	0	0	0	5
OG0017396	0	2	1	1	1	5
OG0017397	0	5	0	0	0	5
OG0017398	0	5	0	0	0	5
OG0017399	0	5	0	0	0	5
OG0017400	0	4	0	1	0	5
OG0017401	0	5	0	0	0	5
OG0017402	0	2	1	1	1	5
OG0017403	0	5	0	0	0	5
OG0017404	0	2	1	1	1	5
OG0017405	0	5	0	0	0	5
OG0017406	0	5	0	0	0	5
OG0017407	0	5	0	0	0	5
OG0017408	0	5	0	0	0	5
OG0017409	0	5	0	0	0	5
OG0017410	0	5	0	0	0	5
OG0017411	0	5	0	0	0	5
OG0017412	0	5	0	0	0	5
OG0017413	0	2	0	0	3	5
OG0017414	0	5	0	0	0	5
OG0017415	0	5	0	0	0	5
OG0017416	0	5	0	0	0	5
OG0017417	0	1	3	0	1	5
OG0017418	0	3	0	1	1	5
OG0017419	0	5	0	0	0	5
OG0017420	0	5	0	0	0	5
OG0017421	0	5	0	0	0	5
OG0017422	0	5	0	0	0	5
OG0017423	0	3	0	1	1	5
OG0017424	0	5	0	0	0	5
OG0017425	0	5	0	0	0	5
OG0017426	0	5	0	0	0	5
OG0017427	0	5	0	0	0	5
OG0017428	0	5	0	0	0	5
OG0017429	0	5	0	0	0	5
OG0017430	0	4	0	1	0	5
OG0017431	0	5	0	0	0	5
OG0017432	0	5	0	0	0	5
OG0017433	0	2	0	2	1	5
OG0017434	0	3	0	0	2	5
OG0017435	0	5	0	0	0	5
OG0017436	0	5	0	0	0	5
OG0017437	0	2	1	1	1	5
OG0017438	0	2	0	1	2	5
OG0017439	0	5	0	0	0	5
OG0017440	0	1	4	0	0	5
OG0017441	0	5	0	0	0	5
OG0017442	0	2	1	1	1	5
OG0017443	0	2	1	1	1	5
OG0017444	0	5	0	0	0	5
OG0017445	0	5	0	0	0	5
OG0017446	0	5	0	0	0	5
OG0017447	0	5	0	0	0	5
OG0017448	0	2	1	1	1	5
OG0017449	0	5	0	0	0	5
OG0017450	0	5	0	0	0	5
OG0017451	0	5	0	0	0	5
OG0017452	0	5	0	0	0	5
OG0017453	0	5	0	0	0	5
OG0017454	0	5	0	0	0	5
OG0017455	0	5	0	0	0	5
OG0017456	0	5	0	0	0	5
OG0017457	0	2	1	1	1	5
OG0017458	0	5	0	0	0	5
OG0017459	0	5	0	0	0	5
OG0017460	0	5	0	0	0	5
OG0017461	0	5	0	0	0	5
OG0017462	0	2	1	1	1	5
OG0017463	0	5	0	0	0	5
OG0017464	0	5	0	0	0	5
OG0017465	0	5	0	0	0	5
OG0017466	0	3	1	0	1	5
OG0017467	0	5	0	0	0	5
OG0017468	0	5	0	0	0	5
OG0017469	0	5	0	0	0	5
OG0017470	0	2	2	0	1	5
OG0017471	0	5	0	0	0	5
OG0017472	0	5	0	0	0	5
OG0017473	0	5	0	0	0	5
OG0017474	0	2	1	1	1	5
OG0017475	0	5	0	0	0	5
OG0017476	0	5	0	0	0	5
OG0017477	0	5	0	0	0	5
OG0017478	0	5	0	0	0	5
OG0017479	0	5	0	0	0	5
OG0017480	0	5	0	0	0	5
OG0017481	0	5	0	0	0	5
OG0017482	0	5	0	0	0	5
OG0017483	0	5	0	0	0	5
OG0017484	0	2	1	2	0	5
OG0017485	0	5	0	0	0	5
OG0017486	0	2	1	1	1	5
OG0017487	0	5	0	0	0	5
OG0017488	0	5	0	0	0	5
OG0017489	0	2	2	0	1	5
OG0017490	0	2	1	1	1	5
OG0017491	0	2	1	1	1	5
OG0017492	0	4	1	0	0	5
OG0017493	0	5	0	0	0	5
OG0017494	0	5	0	0	0	5
OG0017495	0	5	0	0	0	5
OG0017496	0	5	0	0	0	5
OG0017497	0	4	1	0	0	5
OG0017498	0	5	0	0	0	5
OG0017499	0	5	0	0	0	5
OG0017500	0	2	0	2	1	5
OG0017501	0	5	0	0	0	5
OG0017502	0	5	0	0	0	5
OG0017503	0	5	0	0	0	5
OG0017504	0	5	0	0	0	5
OG0017505	0	2	1	1	1	5
OG0017506	0	5	0	0	0	5
OG0017507	0	5	0	0	0	5
OG0017508	0	2	1	1	1	5
OG0017509	0	5	0	0	0	5
OG0017510	0	5	0	0	0	5
OG0017511	0	4	1	0	0	5
OG0017512	0	5	0	0	0	5
OG0017513	0	5	0	0	0	5
OG0017514	0	5	0	0	0	5
OG0017515	0	5	0	0	0	5
OG0017516	0	5	0	0	0	5
OG0017517	0	5	0	0	0	5
OG0017518	0	5	0	0	0	5
OG0017519	0	5	0	0	0	5
OG0017520	0	5	0	0	0	5
OG0017521	0	5	0	0	0	5
OG0017522	0	5	0	0	0	5
OG0017523	0	5	0	0	0	5
OG0017524	0	2	1	1	1	5
OG0017525	0	5	0	0	0	5
OG0017526	0	5	0	0	0	5
OG0017527	0	4	0	0	1	5
OG0017528	0	5	0	0	0	5
OG0017529	0	5	0	0	0	5
OG0017530	0	2	1	1	1	5
OG0017531	0	5	0	0	0	5
OG0017532	0	5	0	0	0	5
OG0017533	0	5	0	0	0	5
OG0017534	0	5	0	0	0	5
OG0017535	0	4	0	1	0	5
OG0017536	0	5	0	0	0	5
OG0017537	0	2	1	1	1	5
OG0017538	0	2	1	1	1	5
OG0017539	0	5	0	0	0	5
OG0017540	0	5	0	0	0	5
OG0017541	0	5	0	0	0	5
OG0017542	0	2	1	1	1	5
OG0017543	0	5	0	0	0	5
OG0017544	0	5	0	0	0	5
OG0017545	0	4	1	0	0	5
OG0017546	0	5	0	0	0	5
OG0017547	0	5	0	0	0	5
OG0017548	0	5	0	0	0	5
OG0017549	0	2	1	1	1	5
OG0017550	0	5	0	0	0	5
OG0017551	0	2	1	1	1	5
OG0017552	0	2	1	1	1	5
OG0017553	0	2	2	1	0	5
OG0017554	0	5	0	0	0	5
OG0017555	0	5	0	0	0	5
OG0017556	0	5	0	0	0	5
OG0017557	0	4	1	0	0	5
OG0017558	0	5	0	0	0	5
OG0017559	0	5	0	0	0	5
OG0017560	0	5	0	0	0	5
OG0017561	0	5	0	0	0	5
OG0017562	0	5	0	0	0	5
OG0017563	0	2	1	1	1	5
OG0017564	0	2	1	1	1	5
OG0017565	0	5	0	0	0	5
OG0017566	0	4	0	1	0	5
OG0017567	0	2	1	1	1	5
OG0017568	0	5	0	0	0	5
OG0017569	0	5	0	0	0	5
OG0017570	0	5	0	0	0	5
OG0017571	0	5	0	0	0	5
OG0017572	0	5	0	0	0	5
OG0017573	0	1	2	1	1	5
OG0017574	0	3	0	1	1	5
OG0017575	0	5	0	0	0	5
OG0017576	0	5	0	0	0	5
OG0017577	0	5	0	0	0	5
OG0017578	0	5	0	0	0	5
OG0017579	0	5	0	0	0	5
OG0017580	0	5	0	0	0	5
OG0017581	0	5	0	0	0	5
OG0017582	0	4	1	0	0	5
OG0017583	0	5	0	0	0	5
OG0017584	0	5	0	0	0	5
OG0017585	0	5	0	0	0	5
OG0017586	0	4	1	0	0	5
OG0017587	0	5	0	0	0	5
OG0017588	0	5	0	0	0	5
OG0017589	0	5	0	0	0	5
OG0017590	0	5	0	0	0	5
OG0017591	0	5	0	0	0	5
OG0017592	0	4	0	1	0	5
OG0017593	0	4	0	0	1	5
OG0017594	0	5	0	0	0	5
OG0017595	0	2	1	1	1	5
OG0017596	0	4	0	0	1	5
OG0017597	0	2	1	1	1	5
OG0017598	0	5	0	0	0	5
OG0017599	0	5	0	0	0	5
OG0017600	0	5	0	0	0	5
OG0017601	0	5	0	0	0	5
OG0017602	0	4	0	1	0	5
OG0017603	0	2	1	1	1	5
OG0017604	0	2	1	1	1	5
OG0017605	0	5	0	0	0	5
OG0017606	0	2	1	1	1	5
OG0017607	0	5	0	0	0	5
OG0017608	0	5	0	0	0	5
OG0017609	0	5	0	0	0	5
OG0017610	0	5	0	0	0	5
OG0017611	0	5	0	0	0	5
OG0017612	0	5	0	0	0	5
OG0017613	0	5	0	0	0	5
OG0017614	0	5	0	0	0	5
OG0017615	0	5	0	0	0	5
OG0017616	0	5	0	0	0	5
OG0017617	0	5	0	0	0	5
OG0017618	0	2	1	1	1	5
OG0017619	0	2	1	1	1	5
OG0017620	0	5	0	0	0	5
OG0017621	0	2	1	1	1	5
OG0017622	0	5	0	0	0	5
OG0017623	0	5	0	0	0	5
OG0017624	0	5	0	0	0	5
OG0017625	0	5	0	0	0	5
OG0017626	0	5	0	0	0	5
OG0017627	0	2	2	0	1	5
OG0017628	0	2	1	1	1	5
OG0017629	0	5	0	0	0	5
OG0017630	0	2	1	1	1	5
OG0017631	0	2	1	1	1	5
OG0017632	0	3	1	1	0	5
OG0017633	0	5	0	0	0	5
OG0017634	0	5	0	0	0	5
OG0017635	0	5	0	0	0	5
OG0017636	0	3	1	1	0	5
OG0017637	0	2	1	1	1	5
OG0017638	0	5	0	0	0	5
OG0017639	0	5	0	0	0	5
OG0017640	0	3	1	0	1	5
OG0017641	0	5	0	0	0	5
OG0017642	0	4	0	1	0	5
OG0017643	0	5	0	0	0	5
OG0017644	0	5	0	0	0	5
OG0017645	0	2	1	1	1	5
OG0017646	0	5	0	0	0	5
OG0017647	0	5	0	0	0	5
OG0017648	0	5	0	0	0	5
OG0017649	0	2	1	1	1	5
OG0017650	0	5	0	0	0	5
OG0017651	0	2	1	1	1	5
OG0017652	0	5	0	0	0	5
OG0017653	0	4	1	0	0	5
OG0017654	0	5	0	0	0	5
OG0017655	0	2	1	1	1	5
OG0017656	0	5	0	0	0	5
OG0017657	0	5	0	0	0	5
OG0017658	0	5	0	0	0	5
OG0017659	0	1	1	3	0	5
OG0017660	0	3	2	0	0	5
OG0017661	0	2	1	1	1	5
OG0017662	0	2	1	1	1	5
OG0017663	0	4	1	0	0	5
OG0017664	0	5	0	0	0	5
OG0017665	0	5	0	0	0	5
OG0017666	0	2	1	1	1	5
OG0017667	0	5	0	0	0	5
OG0017668	0	5	0	0	0	5
OG0017669	0	5	0	0	0	5
OG0017670	0	5	0	0	0	5
OG0017671	0	2	1	1	1	5
OG0017672	0	5	0	0	0	5
OG0017673	0	2	1	1	1	5
OG0017674	0	5	0	0	0	5
OG0017675	0	5	0	0	0	5
OG0017676	0	5	0	0	0	5
OG0017677	0	5	0	0	0	5
OG0017678	0	2	1	1	1	5
OG0017679	0	2	1	1	1	5
OG0017680	0	2	3	0	0	5
OG0017681	0	5	0	0	0	5
OG0017682	0	5	0	0	0	5
OG0017683	0	5	0	0	0	5
OG0017684	0	5	0	0	0	5
OG0017685	0	5	0	0	0	5
OG0017686	0	2	1	1	1	5
OG0017687	0	5	0	0	0	5
OG0017688	0	2	1	2	0	5
OG0017689	0	5	0	0	0	5
OG0017690	0	2	1	1	1	5
OG0017691	0	5	0	0	0	5
OG0017692	0	2	1	1	1	5
OG0017693	0	5	0	0	0	5
OG0017694	0	5	0	0	0	5
OG0017695	0	2	1	1	1	5
OG0017696	0	2	1	1	1	5
OG0017697	0	5	0	0	0	5
OG0017698	0	5	0	0	0	5
OG0017699	0	2	0	2	1	5
OG0017700	0	2	1	1	1	5
OG0017701	0	5	0	0	0	5
OG0017702	0	5	0	0	0	5
OG0017703	0	2	1	1	1	5
OG0017704	0	5	0	0	0	5
OG0017705	0	5	0	0	0	5
OG0017706	0	5	0	0	0	5
OG0017707	0	3	0	1	1	5
OG0017708	0	5	0	0	0	5
OG0017709	0	5	0	0	0	5
OG0017710	0	5	0	0	0	5
OG0017711	0	5	0	0	0	5
OG0017712	0	4	0	1	0	5
OG0017713	0	5	0	0	0	5
OG0017714	0	4	0	0	1	5
OG0017715	0	2	1	1	1	5
OG0017716	0	5	0	0	0	5
OG0017717	0	5	0	0	0	5
OG0017718	0	5	0	0	0	5
OG0017719	0	5	0	0	0	5
OG0017720	0	5	0	0	0	5
OG0017721	0	5	0	0	0	5
OG0017722	0	5	0	0	0	5
OG0017723	0	2	1	1	1	5
OG0017724	0	5	0	0	0	5
OG0017725	0	5	0	0	0	5
OG0017726	0	4	0	1	0	5
OG0017727	0	5	0	0	0	5
OG0017728	0	5	0	0	0	5
OG0017729	0	5	0	0	0	5
OG0017730	0	4	0	1	0	5
OG0017731	0	5	0	0	0	5
OG0017732	0	5	0	0	0	5
OG0017733	0	5	0	0	0	5
OG0017734	0	2	1	1	1	5
OG0017735	0	5	0	0	0	5
OG0017736	0	2	1	1	1	5
OG0017737	0	5	0	0	0	5
OG0017738	0	5	0	0	0	5
OG0017739	0	4	0	1	0	5
OG0017740	0	5	0	0	0	5
OG0017741	0	5	0	0	0	5
OG0017742	0	5	0	0	0	5
OG0017743	0	1	1	2	1	5
OG0017744	0	5	0	0	0	5
OG0017745	0	2	0	2	1	5
OG0017746	0	3	1	1	0	5
OG0017747	0	2	1	1	1	5
OG0017748	0	2	1	1	1	5
OG0017749	0	2	1	1	1	5
OG0017750	0	2	1	1	1	5
OG0017751	0	4	0	1	0	5
OG0017752	0	5	0	0	0	5
OG0017753	0	5	0	0	0	5
OG0017754	0	5	0	0	0	5
OG0017755	0	2	1	2	0	5
OG0017756	0	5	0	0	0	5
OG0017757	0	5	0	0	0	5
OG0017758	0	5	0	0	0	5
OG0017759	0	4	0	1	0	5
OG0017760	0	4	1	0	0	5
OG0017761	0	4	0	1	0	5
OG0017762	0	4	0	1	0	5
OG0017763	0	5	0	0	0	5
OG0017764	0	2	1	1	1	5
OG0017765	0	2	1	1	1	5
OG0017766	0	5	0	0	0	5
OG0017767	0	2	1	1	1	5
OG0017768	0	5	0	0	0	5
OG0017769	0	2	0	1	2	5
OG0017770	0	5	0	0	0	5
OG0017771	0	5	0	0	0	5
OG0017772	0	2	1	1	1	5
OG0017773	0	5	0	0	0	5
OG0017774	0	2	1	1	1	5
OG0017775	0	5	0	0	0	5
OG0017776	0	2	1	1	1	5
OG0017777	0	5	0	0	0	5
OG0017778	0	5	0	0	0	5
OG0017779	0	4	0	1	0	5
OG0017780	0	2	0	2	1	5
OG0017781	0	1	0	0	4	5
OG0017782	0	5	0	0	0	5
OG0017783	0	5	0	0	0	5
OG0017784	0	1	3	0	1	5
OG0017785	0	2	1	1	1	5
OG0017786	0	2	1	1	1	5
OG0017787	0	5	0	0	0	5
OG0017788	0	5	0	0	0	5
OG0017789	0	5	0	0	0	5
OG0017790	0	5	0	0	0	5
OG0017791	0	5	0	0	0	5
OG0017792	0	5	0	0	0	5
OG0017793	0	5	0	0	0	5
OG0017794	0	2	1	1	1	5
OG0017795	0	2	1	1	1	5
OG0017796	0	5	0	0	0	5
OG0017797	0	5	0	0	0	5
OG0017798	0	5	0	0	0	5
OG0017799	0	5	0	0	0	5
OG0017800	0	5	0	0	0	5
OG0017801	0	3	0	1	1	5
OG0017802	0	5	0	0	0	5
OG0017803	0	5	0	0	0	5
OG0017804	0	2	2	1	0	5
OG0017805	0	5	0	0	0	5
OG0017806	0	2	1	1	1	5
OG0017807	0	2	1	1	1	5
OG0017808	0	5	0	0	0	5
OG0017809	0	5	0	0	0	5
OG0017810	0	2	1	1	1	5
OG0017811	0	5	0	0	0	5
OG0017812	0	5	0	0	0	5
OG0017813	0	5	0	0	0	5
OG0017814	0	5	0	0	0	5
OG0017815	0	2	0	2	1	5
OG0017816	0	5	0	0	0	5
OG0017817	0	2	1	1	1	5
OG0017818	0	5	0	0	0	5
OG0017819	0	5	0	0	0	5
OG0017820	0	5	0	0	0	5
OG0017821	0	5	0	0	0	5
OG0017822	0	2	1	1	1	5
OG0017823	0	2	1	1	1	5
OG0017824	0	5	0	0	0	5
OG0017825	0	5	0	0	0	5
OG0017826	0	5	0	0	0	5
OG0017827	0	2	1	1	1	5
OG0017828	0	5	0	0	0	5
OG0017829	0	5	0	0	0	5
OG0017830	0	2	1	1	1	5
OG0017831	0	2	1	1	1	5
OG0017832	0	5	0	0	0	5
OG0017833	0	5	0	0	0	5
OG0017834	0	5	0	0	0	5
OG0017835	0	3	1	0	1	5
OG0017836	0	3	1	1	0	5
OG0017837	0	5	0	0	0	5
OG0017838	0	4	0	1	0	5
OG0017839	0	5	0	0	0	5
OG0017840	0	5	0	0	0	5
OG0017841	0	5	0	0	0	5
OG0017842	0	5	0	0	0	5
OG0017843	0	2	1	1	1	5
OG0017844	0	2	1	1	1	5
OG0017845	0	5	0	0	0	5
OG0017846	0	2	1	1	1	5
OG0017847	0	5	0	0	0	5
OG0017848	0	2	1	1	1	5
OG0017849	0	5	0	0	0	5
OG0017850	0	5	0	0	0	5
OG0017851	0	5	0	0	0	5
OG0017852	0	5	0	0	0	5
OG0017853	0	5	0	0	0	5
OG0017854	0	4	0	0	1	5
OG0017855	0	2	1	1	1	5
OG0017856	0	5	0	0	0	5
OG0017857	0	5	0	0	0	5
OG0017858	0	5	0	0	0	5
OG0017859	0	4	0	1	0	5
OG0017860	0	2	1	1	1	5
OG0017861	0	1	1	2	1	5
OG0017862	0	2	1	1	1	5
OG0017863	0	2	2	1	0	5
OG0017864	0	1	1	2	1	5
OG0017865	0	5	0	0	0	5
OG0017866	0	5	0	0	0	5
OG0017867	0	4	1	0	0	5
OG0017868	0	4	0	1	0	5
OG0017869	0	2	1	2	0	5
OG0017870	0	5	0	0	0	5
OG0017871	0	2	1	1	1	5
OG0017872	0	2	1	1	1	5
OG0017873	0	2	1	1	1	5
OG0017874	0	2	1	1	1	5
OG0017875	0	2	1	1	1	5
OG0017876	0	1	1	0	3	5
OG0017877	0	5	0	0	0	5
OG0017878	0	4	0	0	1	5
OG0017879	0	2	1	1	1	5
OG0017880	0	2	1	1	1	5
OG0017881	0	5	0	0	0	5
OG0017882	0	5	0	0	0	5
OG0017883	0	5	0	0	0	5
OG0017884	0	2	0	3	0	5
OG0017885	0	5	0	0	0	5
OG0017886	0	2	1	1	1	5
OG0017887	0	5	0	0	0	5
OG0017888	0	5	0	0	0	5
OG0017889	0	5	0	0	0	5
OG0017890	0	5	0	0	0	5
OG0017891	0	5	0	0	0	5
OG0017892	0	5	0	0	0	5
OG0017893	0	5	0	0	0	5
OG0017894	0	5	0	0	0	5
OG0017895	0	5	0	0	0	5
OG0017896	0	5	0	0	0	5
OG0017897	0	4	1	0	0	5
OG0017898	0	2	1	1	1	5
OG0017899	0	2	1	1	1	5
OG0017900	0	5	0	0	0	5
OG0017901	0	5	0	0	0	5
OG0017902	0	5	0	0	0	5
OG0017903	0	2	1	1	1	5
OG0017904	0	2	1	1	1	5
OG0017905	0	5	0	0	0	5
OG0017906	0	2	1	1	1	5
OG0017907	0	5	0	0	0	5
OG0017908	0	3	1	0	1	5
OG0017909	0	5	0	0	0	5
OG0017910	0	2	1	1	1	5
OG0017911	0	2	1	1	1	5
OG0017912	0	5	0	0	0	5
OG0017913	0	2	1	1	1	5
OG0017914	0	5	0	0	0	5
OG0017915	0	2	1	1	1	5
OG0017916	0	2	1	1	1	5
OG0017917	0	5	0	0	0	5
OG0017918	0	1	2	1	1	5
OG0017919	0	1	0	2	2	5
OG0017920	0	2	1	2	0	5
OG0017921	0	2	1	1	1	5
OG0017922	0	5	0	0	0	5
OG0017923	0	2	1	1	1	5
OG0017924	0	5	0	0	0	5
OG0017925	0	1	0	4	0	5
OG0017926	0	5	0	0	0	5
OG0017927	0	2	1	1	1	5
OG0017928	0	3	1	1	0	5
OG0017929	0	3	0	1	1	5
OG0017930	0	5	0	0	0	5
OG0017931	0	2	1	1	1	5
OG0017932	0	2	1	1	1	5
OG0017933	0	2	1	1	1	5
OG0017934	0	2	1	1	1	5
OG0017935	0	2	1	1	1	5
OG0017936	0	2	1	1	1	5
OG0017937	0	5	0	0	0	5
OG0017938	0	5	0	0	0	5
OG0017939	0	5	0	0	0	5
OG0017940	0	5	0	0	0	5
OG0017941	0	5	0	0	0	5
OG0017942	0	5	0	0	0	5
OG0017943	0	5	0	0	0	5
OG0017944	0	2	1	1	1	5
OG0017945	0	2	1	1	1	5
OG0017946	0	3	0	1	1	5
OG0017947	0	5	0	0	0	5
OG0017948	0	5	0	0	0	5
OG0017949	0	2	1	1	1	5
OG0017950	0	5	0	0	0	5
OG0017951	0	5	0	0	0	5
OG0017952	0	5	0	0	0	5
OG0017953	0	1	2	0	2	5
OG0017954	0	2	1	1	1	5
OG0017955	0	2	1	1	1	5
OG0017956	0	3	1	1	0	5
OG0017957	0	2	1	1	1	5
OG0017958	0	2	1	1	1	5
OG0017959	0	5	0	0	0	5
OG0017960	0	2	1	1	1	5
OG0017961	0	2	1	1	1	5
OG0017962	0	2	1	1	1	5
OG0017963	0	1	1	0	3	5
OG0017964	0	5	0	0	0	5
OG0017965	0	2	1	1	1	5
OG0017966	0	2	1	1	1	5
OG0017967	0	2	1	1	1	5
OG0017968	0	1	2	1	1	5
OG0017969	0	2	1	1	1	5
OG0017970	0	2	1	1	1	5
OG0017971	0	1	1	2	1	5
OG0017972	0	2	1	1	1	5
OG0017973	0	5	0	0	0	5
OG0017974	0	3	2	0	0	5
OG0017975	0	1	1	2	1	5
OG0017976	0	3	2	0	0	5
OG0017977	0	3	0	2	0	5
OG0017978	0	5	0	0	0	5
OG0017979	0	2	1	1	1	5
OG0017980	0	2	0	3	0	5
OG0017981	0	2	1	1	1	5
OG0017982	0	1	4	0	0	5
OG0017983	0	2	1	1	1	5
OG0017984	0	1	2	1	1	5
OG0017985	0	2	1	1	1	5
OG0017986	0	2	1	1	1	5
OG0017987	0	2	2	1	0	5
OG0017988	0	2	1	1	1	5
OG0017989	0	2	1	1	1	5
OG0017990	0	1	0	0	4	5
OG0017991	0	0	3	1	1	5
OG0017992	0	0	2	0	3	5
OG0017993	0	0	2	0	3	5
OG0017994	0	0	2	1	2	5
OG0017995	0	0	5	0	0	5
OG0017996	0	0	4	0	1	5
OG0017997	0	0	5	0	0	5
OG0017998	0	0	4	0	1	5
OG0017999	0	0	3	0	2	5
OG0018000	0	0	4	0	1	5
OG0018001	0	0	3	0	2	5
OG0018002	0	0	4	0	1	5
OG0018003	0	0	5	0	0	5
OG0018004	0	0	1	0	4	5
OG0018005	0	0	4	0	1	5
OG0018006	0	0	3	0	2	5
OG0018007	0	0	2	1	2	5
OG0018008	0	0	4	0	1	5
OG0018009	0	0	4	0	1	5
OG0018010	0	0	5	0	0	5
OG0018011	0	0	5	0	0	5
OG0018012	0	0	4	0	1	5
OG0018013	0	0	1	0	4	5
OG0018014	0	0	2	0	3	5
OG0018015	0	0	2	1	2	5
OG0018016	0	0	4	0	1	5
OG0018017	0	0	5	0	0	5
OG0018018	0	0	1	0	4	5
OG0018019	0	0	4	0	1	5
OG0018020	0	0	1	3	1	5
OG0018021	0	0	3	0	2	5
OG0018022	0	0	2	0	3	5
OG0018023	0	0	2	1	2	5
OG0018024	0	0	5	0	0	5
OG0018025	0	0	1	0	4	5
OG0018026	0	0	3	0	2	5
OG0018027	0	0	2	0	3	5
OG0018028	0	0	1	3	1	5
OG0018029	0	0	5	0	0	5
OG0018030	0	0	1	1	3	5
OG0018031	0	0	2	1	2	5
OG0018032	0	0	5	0	0	5
OG0018033	0	0	4	0	1	5
OG0018034	0	0	3	0	2	5
OG0018035	0	0	5	0	0	5
OG0018036	0	0	2	1	2	5
OG0018037	0	0	4	0	1	5
OG0018038	0	0	4	0	1	5
OG0018039	0	0	1	0	4	5
OG0018040	0	0	5	0	0	5
OG0018041	0	0	2	1	2	5
OG0018042	0	0	2	0	3	5
OG0018043	0	0	5	0	0	5
OG0018044	0	0	2	0	3	5
OG0018045	0	0	5	0	0	5
OG0018046	0	0	5	0	0	5
OG0018047	0	0	4	0	1	5
OG0018048	0	0	2	1	2	5
OG0018049	0	0	5	0	0	5
OG0018050	0	0	4	0	1	5
OG0018051	0	0	5	0	0	5
OG0018052	0	0	5	0	0	5
OG0018053	0	0	5	0	0	5
OG0018054	0	0	2	1	2	5
OG0018055	0	0	3	0	2	5
OG0018056	0	0	4	1	0	5
OG0018057	0	0	2	0	3	5
OG0018058	0	0	2	0	3	5
OG0018059	0	0	2	0	3	5
OG0018060	0	0	5	0	0	5
OG0018061	0	0	5	0	0	5
OG0018062	0	0	2	3	0	5
OG0018063	0	0	5	0	0	5
OG0018064	0	0	1	4	0	5
OG0018065	0	0	3	1	1	5
OG0018066	0	0	1	3	1	5
OG0018067	0	0	1	1	3	5
OG0018068	0	0	5	0	0	5
OG0018069	0	0	3	1	1	5
OG0018070	0	0	5	0	0	5
OG0018071	0	0	4	0	1	5
OG0018072	0	0	5	0	0	5
OG0018073	0	0	5	0	0	5
OG0018074	0	0	5	0	0	5
OG0018075	0	0	1	4	0	5
OG0018076	0	0	5	0	0	5
OG0018077	0	0	2	1	2	5
OG0018078	0	0	3	0	2	5
OG0018079	0	0	2	1	2	5
OG0018080	0	0	1	0	4	5
OG0018081	0	0	1	0	4	5
OG0018082	0	0	3	0	2	5
OG0018083	0	0	5	0	0	5
OG0018084	0	0	4	0	1	5
OG0018085	0	0	5	0	0	5
OG0018086	0	0	5	0	0	5
OG0018087	0	0	2	3	0	5
OG0018088	0	0	1	0	4	5
OG0018089	0	0	3	1	1	5
OG0018090	0	0	2	2	1	5
OG0018091	0	0	1	3	1	5
OG0018092	0	0	3	0	2	5
OG0018093	0	0	4	0	1	5
OG0018094	0	0	4	0	1	5
OG0018095	0	0	1	0	4	5
OG0018096	0	0	1	0	4	5
OG0018097	0	0	3	0	2	5
OG0018098	0	0	2	2	1	5
OG0018099	0	0	2	1	2	5
OG0018100	0	0	2	1	2	5
OG0018101	0	0	4	0	1	5
OG0018102	0	0	3	0	2	5
OG0018103	0	0	1	3	1	5
OG0018104	0	0	1	0	4	5
OG0018105	0	0	1	0	4	5
OG0018106	0	0	2	0	3	5
OG0018107	0	0	1	0	4	5
OG0018108	0	0	4	0	1	5
OG0018109	0	0	2	1	2	5
OG0018110	0	0	1	1	3	5
OG0018111	0	0	2	1	2	5
OG0018112	0	0	4	1	0	5
OG0018113	0	0	2	2	1	5
OG0018114	0	0	5	0	0	5
OG0018115	0	0	2	1	2	5
OG0018116	0	0	4	0	1	5
OG0018117	0	0	3	0	2	5
OG0018118	0	0	1	2	2	5
OG0018119	0	0	4	0	1	5
OG0018120	0	0	4	0	1	5
OG0018121	0	0	2	1	2	5
OG0018122	0	0	5	0	0	5
OG0018123	0	0	3	0	2	5
OG0018124	0	0	2	2	1	5
OG0018125	0	0	3	2	0	5
OG0018126	0	0	5	0	0	5
OG0018127	0	0	2	1	2	5
OG0018128	0	0	3	0	2	5
OG0018129	0	0	1	0	4	5
OG0018130	0	0	1	0	4	5
OG0018131	0	0	2	1	2	5
OG0018132	0	0	2	2	1	5
OG0018133	0	0	4	0	1	5
OG0018134	0	0	2	1	2	5
OG0018135	0	0	3	0	2	5
OG0018136	0	0	1	2	2	5
OG0018137	0	0	2	1	2	5
OG0018138	0	0	1	1	3	5
OG0018139	0	0	5	0	0	5
OG0018140	0	0	1	3	1	5
OG0018141	0	0	3	0	2	5
OG0018142	0	0	2	0	3	5
OG0018143	0	0	2	1	2	5
OG0018144	0	0	3	0	2	5
OG0018145	0	0	1	0	4	5
OG0018146	0	0	3	1	1	5
OG0018147	0	0	1	0	4	5
OG0018148	0	0	2	1	2	5
OG0018149	0	0	1	0	4	5
OG0018150	0	0	1	2	2	5
OG0018151	0	0	2	1	2	5
OG0018152	0	0	2	1	2	5
OG0018153	0	0	1	0	4	5
OG0018154	0	0	2	0	3	5
OG0018155	0	0	1	0	4	5
OG0018156	0	0	1	0	4	5
OG0018157	0	0	0	5	0	5
OG0018158	0	0	0	5	0	5
OG0018159	0	0	0	5	0	5
OG0018160	0	0	0	5	0	5
OG0018161	0	0	0	5	0	5
OG0018162	0	0	0	5	0	5
OG0018163	0	0	0	5	0	5
OG0018164	0	0	0	5	0	5
OG0018165	0	0	0	5	0	5
OG0018166	0	0	0	5	0	5
OG0018167	0	0	0	5	0	5
OG0018168	0	0	0	5	0	5
OG0018169	0	0	0	5	0	5
OG0018170	0	0	0	5	0	5
OG0018171	0	0	0	5	0	5
OG0018172	0	0	0	5	0	5
OG0018173	0	0	0	5	0	5
OG0018174	0	0	0	5	0	5
OG0018175	0	0	0	5	0	5
OG0018176	0	0	0	5	0	5
OG0018177	0	0	0	5	0	5
OG0018178	0	0	0	5	0	5
OG0018179	0	0	0	5	0	5
OG0018180	0	0	0	5	0	5
OG0018181	0	0	0	3	2	5
OG0018182	0	0	0	5	0	5
OG0018183	0	0	0	5	0	5
OG0018184	0	0	0	5	0	5
OG0018185	0	0	0	5	0	5
OG0018186	0	0	0	5	0	5
OG0018187	0	0	0	5	0	5
OG0018188	0	0	0	5	0	5
OG0018189	0	0	0	5	0	5
OG0018190	0	0	0	5	0	5
OG0018191	0	0	0	5	0	5
OG0018192	0	0	0	1	4	5
OG0018193	0	0	0	5	0	5
OG0018194	0	0	0	1	4	5
OG0018195	0	0	0	5	0	5
OG0018196	0	0	0	5	0	5
OG0018197	0	0	0	5	0	5
OG0018198	0	0	0	5	0	5
OG0018199	0	0	0	5	0	5
OG0018200	0	0	0	1	4	5
OG0018201	0	0	0	5	0	5
OG0018202	0	0	0	5	0	5
OG0018203	0	0	0	5	0	5
OG0018204	0	0	0	5	0	5
OG0018205	0	0	0	5	0	5
OG0018206	0	0	0	5	0	5
OG0018207	0	0	0	5	0	5
OG0018208	0	0	0	0	5	5
OG0018209	0	0	0	0	5	5
OG0018210	0	0	0	0	5	5
OG0018211	0	0	0	0	5	5
OG0018212	0	0	0	0	5	5
OG0018213	0	0	0	0	5	5
OG0018214	0	0	0	0	5	5
OG0018215	0	0	0	0	5	5
OG0018216	0	0	0	0	5	5
OG0018217	0	0	0	0	5	5
OG0018218	0	0	0	0	5	5
OG0018219	0	0	0	0	5	5
OG0018220	0	0	0	0	5	5
OG0018221	0	0	0	0	5	5
OG0018222	0	0	0	0	5	5
OG0018223	0	0	0	0	5	5
OG0018224	0	0	0	0	5	5
OG0018225	0	0	0	0	5	5
OG0018226	0	0	0	0	5	5
OG0018227	0	0	0	0	5	5
OG0018228	0	0	0	0	5	5
OG0018229	0	0	0	0	5	5
OG0018230	0	0	0	0	5	5
OG0018231	0	0	0	0	5	5
OG0018232	0	0	0	0	5	5
OG0018233	0	0	0	0	5	5
OG0018234	0	0	0	0	5	5
OG0018235	0	0	0	0	5	5
OG0018236	0	0	0	0	5	5
OG0018237	0	0	0	0	5	5
OG0018238	0	0	0	0	5	5
OG0018239	0	0	0	0	5	5
OG0018240	0	0	0	0	5	5
OG0018241	0	0	0	0	5	5
OG0018242	0	0	0	0	5	5
OG0018243	0	0	0	0	5	5
OG0018244	0	0	0	0	5	5
OG0018245	0	0	0	0	5	5
OG0018246	0	0	0	0	5	5
OG0018247	0	0	0	0	5	5
OG0018248	0	0	0	0	5	5
OG0018249	0	0	0	0	5	5
OG0018250	0	0	0	0	5	5
OG0018251	0	0	0	0	5	5
OG0018252	0	0	0	0	5	5
OG0018253	0	0	0	0	5	5
OG0018254	0	0	0	0	5	5
OG0018255	0	0	0	0	5	5
OG0018256	0	0	0	0	5	5
OG0018257	0	0	0	0	5	5
OG0018258	0	0	0	0	5	5
OG0018259	0	0	0	0	5	5
OG0018260	0	0	0	0	5	5
OG0018261	0	0	0	0	5	5
OG0018262	0	0	0	0	5	5
OG0018263	0	0	0	0	5	5
OG0018264	0	0	0	0	5	5
OG0018265	0	0	0	0	5	5
OG0018266	0	0	0	0	5	5
OG0018267	0	0	0	0	5	5
OG0018268	0	0	0	0	5	5
OG0018269	0	0	0	0	5	5
OG0018270	0	0	0	0	5	5
OG0018271	0	0	0	0	5	5
OG0018272	0	0	0	0	5	5
OG0018273	0	0	0	0	5	5
OG0018274	4	0	0	0	0	4
OG0018275	3	1	0	0	0	4
OG0018276	4	0	0	0	0	4
OG0018277	3	0	1	0	0	4
OG0018278	4	0	0	0	0	4
OG0018279	4	0	0	0	0	4
OG0018280	3	1	0	0	0	4
OG0018281	4	0	0	0	0	4
OG0018282	2	1	0	1	0	4
OG0018283	4	0	0	0	0	4
OG0018284	2	0	0	2	0	4
OG0018285	4	0	0	0	0	4
OG0018286	3	0	0	1	0	4
OG0018287	4	0	0	0	0	4
OG0018288	4	0	0	0	0	4
OG0018289	4	0	0	0	0	4
OG0018290	4	0	0	0	0	4
OG0018291	4	0	0	0	0	4
OG0018292	4	0	0	0	0	4
OG0018293	3	0	0	1	0	4
OG0018294	2	0	1	1	0	4
OG0018295	4	0	0	0	0	4
OG0018296	4	0	0	0	0	4
OG0018297	4	0	0	0	0	4
OG0018298	2	0	1	1	0	4
OG0018299	4	0	0	0	0	4
OG0018300	3	0	1	0	0	4
OG0018301	4	0	0	0	0	4
OG0018302	4	0	0	0	0	4
OG0018303	4	0	0	0	0	4
OG0018304	4	0	0	0	0	4
OG0018305	2	1	0	1	0	4
OG0018306	4	0	0	0	0	4
OG0018307	4	0	0	0	0	4
OG0018308	3	0	0	0	1	4
OG0018309	4	0	0	0	0	4
OG0018310	4	0	0	0	0	4
OG0018311	3	0	0	1	0	4
OG0018312	3	0	0	1	0	4
OG0018313	4	0	0	0	0	4
OG0018314	4	0	0	0	0	4
OG0018315	2	0	0	2	0	4
OG0018316	4	0	0	0	0	4
OG0018317	4	0	0	0	0	4
OG0018318	4	0	0	0	0	4
OG0018319	3	0	0	1	0	4
OG0018320	2	0	2	0	0	4
OG0018321	4	0	0	0	0	4
OG0018322	4	0	0	0	0	4
OG0018323	4	0	0	0	0	4
OG0018324	4	0	0	0	0	4
OG0018325	4	0	0	0	0	4
OG0018326	3	0	0	1	0	4
OG0018327	4	0	0	0	0	4
OG0018328	2	0	1	0	1	4
OG0018329	4	0	0	0	0	4
OG0018330	2	0	0	0	2	4
OG0018331	4	0	0	0	0	4
OG0018332	4	0	0	0	0	4
OG0018333	1	0	1	1	1	4
OG0018334	3	1	0	0	0	4
OG0018335	4	0	0	0	0	4
OG0018336	4	0	0	0	0	4
OG0018337	4	0	0	0	0	4
OG0018338	4	0	0	0	0	4
OG0018339	4	0	0	0	0	4
OG0018340	4	0	0	0	0	4
OG0018341	1	2	1	0	0	4
OG0018342	4	0	0	0	0	4
OG0018343	4	0	0	0	0	4
OG0018344	4	0	0	0	0	4
OG0018345	4	0	0	0	0	4
OG0018346	2	0	0	1	1	4
OG0018347	4	0	0	0	0	4
OG0018348	3	0	1	0	0	4
OG0018349	4	0	0	0	0	4
OG0018350	4	0	0	0	0	4
OG0018351	4	0	0	0	0	4
OG0018352	4	0	0	0	0	4
OG0018353	4	0	0	0	0	4
OG0018354	3	0	1	0	0	4
OG0018355	4	0	0	0	0	4
OG0018356	4	0	0	0	0	4
OG0018357	3	0	1	0	0	4
OG0018358	3	1	0	0	0	4
OG0018359	4	0	0	0	0	4
OG0018360	4	0	0	0	0	4
OG0018361	3	1	0	0	0	4
OG0018362	3	0	0	0	1	4
OG0018363	4	0	0	0	0	4
OG0018364	3	0	0	0	1	4
OG0018365	4	0	0	0	0	4
OG0018366	1	0	3	0	0	4
OG0018367	3	0	0	1	0	4
OG0018368	2	0	1	0	1	4
OG0018369	4	0	0	0	0	4
OG0018370	3	0	1	0	0	4
OG0018371	4	0	0	0	0	4
OG0018372	3	0	0	1	0	4
OG0018373	4	0	0	0	0	4
OG0018374	4	0	0	0	0	4
OG0018375	4	0	0	0	0	4
OG0018376	4	0	0	0	0	4
OG0018377	4	0	0	0	0	4
OG0018378	2	2	0	0	0	4
OG0018379	1	2	1	0	0	4
OG0018380	3	1	0	0	0	4
OG0018381	2	0	1	0	1	4
OG0018382	4	0	0	0	0	4
OG0018383	4	0	0	0	0	4
OG0018384	4	0	0	0	0	4
OG0018385	4	0	0	0	0	4
OG0018386	4	0	0	0	0	4
OG0018387	4	0	0	0	0	4
OG0018388	3	1	0	0	0	4
OG0018389	2	0	0	1	1	4
OG0018390	4	0	0	0	0	4
OG0018391	4	0	0	0	0	4
OG0018392	1	0	1	1	1	4
OG0018393	2	0	0	1	1	4
OG0018394	4	0	0	0	0	4
OG0018395	4	0	0	0	0	4
OG0018396	4	0	0	0	0	4
OG0018397	4	0	0	0	0	4
OG0018398	2	0	0	2	0	4
OG0018399	1	0	1	1	1	4
OG0018400	4	0	0	0	0	4
OG0018401	4	0	0	0	0	4
OG0018402	4	0	0	0	0	4
OG0018403	4	0	0	0	0	4
OG0018404	2	2	0	0	0	4
OG0018405	3	1	0	0	0	4
OG0018406	4	0	0	0	0	4
OG0018407	1	0	1	1	1	4
OG0018408	1	3	0	0	0	4
OG0018409	4	0	0	0	0	4
OG0018410	4	0	0	0	0	4
OG0018411	4	0	0	0	0	4
OG0018412	2	0	0	1	1	4
OG0018413	4	0	0	0	0	4
OG0018414	4	0	0	0	0	4
OG0018415	4	0	0	0	0	4
OG0018416	4	0	0	0	0	4
OG0018417	4	0	0	0	0	4
OG0018418	2	0	0	1	1	4
OG0018419	4	0	0	0	0	4
OG0018420	3	0	0	1	0	4
OG0018421	3	0	0	1	0	4
OG0018422	2	0	0	1	1	4
OG0018423	4	0	0	0	0	4
OG0018424	4	0	0	0	0	4
OG0018425	2	0	1	1	0	4
OG0018426	4	0	0	0	0	4
OG0018427	1	0	1	0	2	4
OG0018428	4	0	0	0	0	4
OG0018429	2	0	0	1	1	4
OG0018430	4	0	0	0	0	4
OG0018431	4	0	0	0	0	4
OG0018432	2	0	0	2	0	4
OG0018433	2	0	0	1	1	4
OG0018434	2	1	0	0	1	4
OG0018435	4	0	0	0	0	4
OG0018436	4	0	0	0	0	4
OG0018437	4	0	0	0	0	4
OG0018438	3	0	0	1	0	4
OG0018439	1	0	1	1	1	4
OG0018440	2	0	0	2	0	4
OG0018441	3	0	0	0	1	4
OG0018442	4	0	0	0	0	4
OG0018443	1	0	0	3	0	4
OG0018444	2	1	0	1	0	4
OG0018445	2	0	0	1	1	4
OG0018446	2	0	0	1	1	4
OG0018447	4	0	0	0	0	4
OG0018448	2	0	0	1	1	4
OG0018449	2	0	1	1	0	4
OG0018450	4	0	0	0	0	4
OG0018451	2	0	0	2	0	4
OG0018452	4	0	0	0	0	4
OG0018453	4	0	0	0	0	4
OG0018454	4	0	0	0	0	4
OG0018455	4	0	0	0	0	4
OG0018456	4	0	0	0	0	4
OG0018457	4	0	0	0	0	4
OG0018458	4	0	0	0	0	4
OG0018459	1	0	1	1	1	4
OG0018460	4	0	0	0	0	4
OG0018461	4	0	0	0	0	4
OG0018462	4	0	0	0	0	4
OG0018463	4	0	0	0	0	4
OG0018464	4	0	0	0	0	4
OG0018465	4	0	0	0	0	4
OG0018466	4	0	0	0	0	4
OG0018467	4	0	0	0	0	4
OG0018468	4	0	0	0	0	4
OG0018469	4	0	0	0	0	4
OG0018470	1	0	1	1	1	4
OG0018471	4	0	0	0	0	4
OG0018472	4	0	0	0	0	4
OG0018473	4	0	0	0	0	4
OG0018474	4	0	0	0	0	4
OG0018475	4	0	0	0	0	4
OG0018476	4	0	0	0	0	4
OG0018477	4	0	0	0	0	4
OG0018478	1	3	0	0	0	4
OG0018479	4	0	0	0	0	4
OG0018480	4	0	0	0	0	4
OG0018481	2	0	0	1	1	4
OG0018482	4	0	0	0	0	4
OG0018483	2	0	2	0	0	4
OG0018484	4	0	0	0	0	4
OG0018485	4	0	0	0	0	4
OG0018486	4	0	0	0	0	4
OG0018487	4	0	0	0	0	4
OG0018488	4	0	0	0	0	4
OG0018489	4	0	0	0	0	4
OG0018490	4	0	0	0	0	4
OG0018491	4	0	0	0	0	4
OG0018492	4	0	0	0	0	4
OG0018493	4	0	0	0	0	4
OG0018494	3	0	1	0	0	4
OG0018495	4	0	0	0	0	4
OG0018496	4	0	0	0	0	4
OG0018497	4	0	0	0	0	4
OG0018498	1	0	1	1	1	4
OG0018499	4	0	0	0	0	4
OG0018500	2	0	1	1	0	4
OG0018501	4	0	0	0	0	4
OG0018502	4	0	0	0	0	4
OG0018503	2	2	0	0	0	4
OG0018504	4	0	0	0	0	4
OG0018505	4	0	0	0	0	4
OG0018506	4	0	0	0	0	4
OG0018507	4	0	0	0	0	4
OG0018508	2	0	0	1	1	4
OG0018509	4	0	0	0	0	4
OG0018510	4	0	0	0	0	4
OG0018511	4	0	0	0	0	4
OG0018512	4	0	0	0	0	4
OG0018513	4	0	0	0	0	4
OG0018514	4	0	0	0	0	4
OG0018515	2	0	1	0	1	4
OG0018516	4	0	0	0	0	4
OG0018517	2	0	1	0	1	4
OG0018518	4	0	0	0	0	4
OG0018519	4	0	0	0	0	4
OG0018520	1	0	1	2	0	4
OG0018521	4	0	0	0	0	4
OG0018522	2	1	0	1	0	4
OG0018523	4	0	0	0	0	4
OG0018524	4	0	0	0	0	4
OG0018525	4	0	0	0	0	4
OG0018526	4	0	0	0	0	4
OG0018527	4	0	0	0	0	4
OG0018528	4	0	0	0	0	4
OG0018529	4	0	0	0	0	4
OG0018530	4	0	0	0	0	4
OG0018531	2	0	0	1	1	4
OG0018532	4	0	0	0	0	4
OG0018533	4	0	0	0	0	4
OG0018534	4	0	0	0	0	4
OG0018535	4	0	0	0	0	4
OG0018536	4	0	0	0	0	4
OG0018537	2	1	0	1	0	4
OG0018538	1	1	1	1	0	4
OG0018539	1	0	1	1	1	4
OG0018540	4	0	0	0	0	4
OG0018541	1	1	2	0	0	4
OG0018542	1	0	1	1	1	4
OG0018543	4	0	0	0	0	4
OG0018544	4	0	0	0	0	4
OG0018545	4	0	0	0	0	4
OG0018546	4	0	0	0	0	4
OG0018547	4	0	0	0	0	4
OG0018548	4	0	0	0	0	4
OG0018549	4	0	0	0	0	4
OG0018550	1	0	1	1	1	4
OG0018551	4	0	0	0	0	4
OG0018552	1	0	1	1	1	4
OG0018553	3	0	0	1	0	4
OG0018554	4	0	0	0	0	4
OG0018555	4	0	0	0	0	4
OG0018556	3	0	1	0	0	4
OG0018557	2	2	0	0	0	4
OG0018558	4	0	0	0	0	4
OG0018559	2	0	0	1	1	4
OG0018560	4	0	0	0	0	4
OG0018561	4	0	0	0	0	4
OG0018562	4	0	0	0	0	4
OG0018563	4	0	0	0	0	4
OG0018564	4	0	0	0	0	4
OG0018565	4	0	0	0	0	4
OG0018566	4	0	0	0	0	4
OG0018567	4	0	0	0	0	4
OG0018568	4	0	0	0	0	4
OG0018569	4	0	0	0	0	4
OG0018570	4	0	0	0	0	4
OG0018571	2	0	0	1	1	4
OG0018572	2	0	1	1	0	4
OG0018573	4	0	0	0	0	4
OG0018574	4	0	0	0	0	4
OG0018575	2	0	2	0	0	4
OG0018576	4	0	0	0	0	4
OG0018577	4	0	0	0	0	4
OG0018578	4	0	0	0	0	4
OG0018579	2	2	0	0	0	4
OG0018580	3	0	0	1	0	4
OG0018581	4	0	0	0	0	4
OG0018582	4	0	0	0	0	4
OG0018583	4	0	0	0	0	4
OG0018584	4	0	0	0	0	4
OG0018585	4	0	0	0	0	4
OG0018586	4	0	0	0	0	4
OG0018587	4	0	0	0	0	4
OG0018588	4	0	0	0	0	4
OG0018589	4	0	0	0	0	4
OG0018590	1	0	1	1	1	4
OG0018591	1	1	1	0	1	4
OG0018592	4	0	0	0	0	4
OG0018593	4	0	0	0	0	4
OG0018594	4	0	0	0	0	4
OG0018595	2	0	0	1	1	4
OG0018596	4	0	0	0	0	4
OG0018597	4	0	0	0	0	4
OG0018598	2	0	1	0	1	4
OG0018599	2	0	1	0	1	4
OG0018600	2	0	0	1	1	4
OG0018601	2	0	1	1	0	4
OG0018602	2	0	0	1	1	4
OG0018603	4	0	0	0	0	4
OG0018604	2	0	1	0	1	4
OG0018605	2	0	1	1	0	4
OG0018606	4	0	0	0	0	4
OG0018607	4	0	0	0	0	4
OG0018608	2	0	0	1	1	4
OG0018609	4	0	0	0	0	4
OG0018610	3	0	0	1	0	4
OG0018611	4	0	0	0	0	4
OG0018612	2	1	0	0	1	4
OG0018613	1	1	1	0	1	4
OG0018614	2	1	0	1	0	4
OG0018615	3	0	0	1	0	4
OG0018616	1	1	1	0	1	4
OG0018617	4	0	0	0	0	4
OG0018618	4	0	0	0	0	4
OG0018619	4	0	0	0	0	4
OG0018620	1	0	1	0	2	4
OG0018621	1	0	1	1	1	4
OG0018622	4	0	0	0	0	4
OG0018623	3	0	0	1	0	4
OG0018624	2	0	1	0	1	4
OG0018625	4	0	0	0	0	4
OG0018626	4	0	0	0	0	4
OG0018627	4	0	0	0	0	4
OG0018628	1	0	1	1	1	4
OG0018629	2	0	0	2	0	4
OG0018630	1	0	1	1	1	4
OG0018631	2	0	1	0	1	4
OG0018632	4	0	0	0	0	4
OG0018633	1	0	1	1	1	4
OG0018634	4	0	0	0	0	4
OG0018635	4	0	0	0	0	4
OG0018636	1	0	1	1	1	4
OG0018637	4	0	0	0	0	4
OG0018638	4	0	0	0	0	4
OG0018639	4	0	0	0	0	4
OG0018640	4	0	0	0	0	4
OG0018641	4	0	0	0	0	4
OG0018642	2	0	1	1	0	4
OG0018643	1	1	1	1	0	4
OG0018644	2	0	1	0	1	4
OG0018645	3	0	1	0	0	4
OG0018646	4	0	0	0	0	4
OG0018647	2	1	0	1	0	4
OG0018648	4	0	0	0	0	4
OG0018649	4	0	0	0	0	4
OG0018650	2	0	0	1	1	4
OG0018651	4	0	0	0	0	4
OG0018652	2	0	0	1	1	4
OG0018653	4	0	0	0	0	4
OG0018654	2	1	0	1	0	4
OG0018655	4	0	0	0	0	4
OG0018656	2	0	1	1	0	4
OG0018657	4	0	0	0	0	4
OG0018658	2	0	1	1	0	4
OG0018659	2	0	1	1	0	4
OG0018660	2	0	0	1	1	4
OG0018661	2	0	0	1	1	4
OG0018662	4	0	0	0	0	4
OG0018663	4	0	0	0	0	4
OG0018664	4	0	0	0	0	4
OG0018665	2	1	0	1	0	4
OG0018666	4	0	0	0	0	4
OG0018667	4	0	0	0	0	4
OG0018668	3	0	0	1	0	4
OG0018669	4	0	0	0	0	4
OG0018670	3	0	0	1	0	4
OG0018671	4	0	0	0	0	4
OG0018672	4	0	0	0	0	4
OG0018673	4	0	0	0	0	4
OG0018674	4	0	0	0	0	4
OG0018675	2	0	1	1	0	4
OG0018676	4	0	0	0	0	4
OG0018677	3	1	0	0	0	4
OG0018678	4	0	0	0	0	4
OG0018679	4	0	0	0	0	4
OG0018680	2	0	0	1	1	4
OG0018681	2	0	0	1	1	4
OG0018682	4	0	0	0	0	4
OG0018683	2	0	1	0	1	4
OG0018684	2	0	1	0	1	4
OG0018685	4	0	0	0	0	4
OG0018686	2	0	0	1	1	4
OG0018687	3	0	1	0	0	4
OG0018688	2	0	2	0	0	4
OG0018689	3	0	0	1	0	4
OG0018690	2	0	0	1	1	4
OG0018691	4	0	0	0	0	4
OG0018692	1	0	3	0	0	4
OG0018693	4	0	0	0	0	4
OG0018694	4	0	0	0	0	4
OG0018695	3	0	0	1	0	4
OG0018696	1	0	1	0	2	4
OG0018697	4	0	0	0	0	4
OG0018698	4	0	0	0	0	4
OG0018699	4	0	0	0	0	4
OG0018700	2	0	0	2	0	4
OG0018701	4	0	0	0	0	4
OG0018702	1	1	2	0	0	4
OG0018703	2	0	0	1	1	4
OG0018704	2	1	0	1	0	4
OG0018705	4	0	0	0	0	4
OG0018706	4	0	0	0	0	4
OG0018707	4	0	0	0	0	4
OG0018708	4	0	0	0	0	4
OG0018709	2	0	0	1	1	4
OG0018710	2	1	0	0	1	4
OG0018711	4	0	0	0	0	4
OG0018712	4	0	0	0	0	4
OG0018713	4	0	0	0	0	4
OG0018714	4	0	0	0	0	4
OG0018715	4	0	0	0	0	4
OG0018716	4	0	0	0	0	4
OG0018717	4	0	0	0	0	4
OG0018718	4	0	0	0	0	4
OG0018719	4	0	0	0	0	4
OG0018720	2	0	0	1	1	4
OG0018721	4	0	0	0	0	4
OG0018722	2	0	1	1	0	4
OG0018723	4	0	0	0	0	4
OG0018724	4	0	0	0	0	4
OG0018725	2	0	1	0	1	4
OG0018726	4	0	0	0	0	4
OG0018727	2	0	0	2	0	4
OG0018728	2	0	0	1	1	4
OG0018729	2	2	0	0	0	4
OG0018730	4	0	0	0	0	4
OG0018731	2	0	1	0	1	4
OG0018732	4	0	0	0	0	4
OG0018733	3	1	0	0	0	4
OG0018734	4	0	0	0	0	4
OG0018735	4	0	0	0	0	4
OG0018736	2	2	0	0	0	4
OG0018737	2	0	0	1	1	4
OG0018738	2	0	1	1	0	4
OG0018739	4	0	0	0	0	4
OG0018740	1	2	1	0	0	4
OG0018741	4	0	0	0	0	4
OG0018742	3	0	0	1	0	4
OG0018743	2	0	1	1	0	4
OG0018744	4	0	0	0	0	4
OG0018745	4	0	0	0	0	4
OG0018746	4	0	0	0	0	4
OG0018747	2	0	1	0	1	4
OG0018748	4	0	0	0	0	4
OG0018749	2	0	2	0	0	4
OG0018750	4	0	0	0	0	4
OG0018751	4	0	0	0	0	4
OG0018752	2	0	1	1	0	4
OG0018753	2	0	1	1	0	4
OG0018754	1	0	1	0	2	4
OG0018755	3	0	0	0	1	4
OG0018756	4	0	0	0	0	4
OG0018757	1	0	1	1	1	4
OG0018758	3	0	1	0	0	4
OG0018759	2	0	0	2	0	4
OG0018760	4	0	0	0	0	4
OG0018761	4	0	0	0	0	4
OG0018762	2	1	0	1	0	4
OG0018763	2	2	0	0	0	4
OG0018764	2	0	0	2	0	4
OG0018765	2	0	0	2	0	4
OG0018766	2	0	0	1	1	4
OG0018767	2	0	0	2	0	4
OG0018768	2	0	0	1	1	4
OG0018769	4	0	0	0	0	4
OG0018770	2	0	0	2	0	4
OG0018771	1	0	1	1	1	4
OG0018772	4	0	0	0	0	4
OG0018773	2	0	0	1	1	4
OG0018774	4	0	0	0	0	4
OG0018775	4	0	0	0	0	4
OG0018776	4	0	0	0	0	4
OG0018777	4	0	0	0	0	4
OG0018778	4	0	0	0	0	4
OG0018779	2	0	0	2	0	4
OG0018780	4	0	0	0	0	4
OG0018781	4	0	0	0	0	4
OG0018782	2	0	0	1	1	4
OG0018783	4	0	0	0	0	4
OG0018784	2	0	1	1	0	4
OG0018785	4	0	0	0	0	4
OG0018786	2	0	1	0	1	4
OG0018787	1	0	2	0	1	4
OG0018788	2	0	1	1	0	4
OG0018789	1	1	1	1	0	4
OG0018790	3	1	0	0	0	4
OG0018791	2	0	1	0	1	4
OG0018792	1	2	1	0	0	4
OG0018793	4	0	0	0	0	4
OG0018794	2	0	0	0	2	4
OG0018795	4	0	0	0	0	4
OG0018796	4	0	0	0	0	4
OG0018797	2	0	1	1	0	4
OG0018798	4	0	0	0	0	4
OG0018799	1	2	0	1	0	4
OG0018800	4	0	0	0	0	4
OG0018801	2	0	0	1	1	4
OG0018802	4	0	0	0	0	4
OG0018803	1	0	1	1	1	4
OG0018804	3	0	0	1	0	4
OG0018805	4	0	0	0	0	4
OG0018806	2	0	1	1	0	4
OG0018807	4	0	0	0	0	4
OG0018808	1	0	1	1	1	4
OG0018809	4	0	0	0	0	4
OG0018810	2	0	0	1	1	4
OG0018811	2	0	1	1	0	4
OG0018812	4	0	0	0	0	4
OG0018813	2	0	0	1	1	4
OG0018814	3	0	0	1	0	4
OG0018815	4	0	0	0	0	4
OG0018816	2	0	0	1	1	4
OG0018817	4	0	0	0	0	4
OG0018818	2	0	1	0	1	4
OG0018819	1	0	1	0	2	4
OG0018820	1	1	1	0	1	4
OG0018821	4	0	0	0	0	4
OG0018822	4	0	0	0	0	4
OG0018823	4	0	0	0	0	4
OG0018824	2	0	0	1	1	4
OG0018825	4	0	0	0	0	4
OG0018826	2	0	0	1	1	4
OG0018827	4	0	0	0	0	4
OG0018828	4	0	0	0	0	4
OG0018829	2	2	0	0	0	4
OG0018830	4	0	0	0	0	4
OG0018831	4	0	0	0	0	4
OG0018832	4	0	0	0	0	4
OG0018833	1	0	1	1	1	4
OG0018834	2	0	0	1	1	4
OG0018835	2	0	1	1	0	4
OG0018836	1	0	1	1	1	4
OG0018837	1	0	1	1	1	4
OG0018838	4	0	0	0	0	4
OG0018839	2	0	0	2	0	4
OG0018840	4	0	0	0	0	4
OG0018841	2	0	0	1	1	4
OG0018842	2	0	0	2	0	4
OG0018843	4	0	0	0	0	4
OG0018844	1	1	0	1	1	4
OG0018845	1	1	0	1	1	4
OG0018846	1	2	0	1	0	4
OG0018847	1	1	2	0	0	4
OG0018848	2	2	0	0	0	4
OG0018849	3	0	0	1	0	4
OG0018850	1	0	1	0	2	4
OG0018851	2	0	0	1	1	4
OG0018852	4	0	0	0	0	4
OG0018853	4	0	0	0	0	4
OG0018854	3	0	0	1	0	4
OG0018855	3	0	0	0	1	4
OG0018856	2	1	1	0	0	4
OG0018857	1	1	2	0	0	4
OG0018858	2	0	1	0	1	4
OG0018859	2	0	0	1	1	4
OG0018860	4	0	0	0	0	4
OG0018861	2	0	0	2	0	4
OG0018862	2	0	1	0	1	4
OG0018863	4	0	0	0	0	4
OG0018864	4	0	0	0	0	4
OG0018865	4	0	0	0	0	4
OG0018866	4	0	0	0	0	4
OG0018867	1	0	1	1	1	4
OG0018868	1	0	1	1	1	4
OG0018869	3	0	1	0	0	4
OG0018870	4	0	0	0	0	4
OG0018871	4	0	0	0	0	4
OG0018872	4	0	0	0	0	4
OG0018873	3	0	1	0	0	4
OG0018874	3	0	1	0	0	4
OG0018875	4	0	0	0	0	4
OG0018876	4	0	0	0	0	4
OG0018877	3	0	1	0	0	4
OG0018878	3	0	1	0	0	4
OG0018879	4	0	0	0	0	4
OG0018880	4	0	0	0	0	4
OG0018881	3	0	0	1	0	4
OG0018882	1	2	0	1	0	4
OG0018883	2	1	0	1	0	4
OG0018884	4	0	0	0	0	4
OG0018885	2	0	0	1	1	4
OG0018886	1	0	1	1	1	4
OG0018887	4	0	0	0	0	4
OG0018888	1	0	2	0	1	4
OG0018889	3	0	0	1	0	4
OG0018890	3	0	0	1	0	4
OG0018891	4	0	0	0	0	4
OG0018892	4	0	0	0	0	4
OG0018893	4	0	0	0	0	4
OG0018894	1	0	1	1	1	4
OG0018895	4	0	0	0	0	4
OG0018896	2	0	1	0	1	4
OG0018897	4	0	0	0	0	4
OG0018898	2	0	0	1	1	4
OG0018899	4	0	0	0	0	4
OG0018900	2	2	0	0	0	4
OG0018901	1	2	0	1	0	4
OG0018902	4	0	0	0	0	4
OG0018903	1	3	0	0	0	4
OG0018904	4	0	0	0	0	4
OG0018905	1	2	1	0	0	4
OG0018906	2	1	0	1	0	4
OG0018907	1	0	1	1	1	4
OG0018908	4	0	0	0	0	4
OG0018909	4	0	0	0	0	4
OG0018910	2	0	0	1	1	4
OG0018911	1	0	1	1	1	4
OG0018912	3	0	0	0	1	4
OG0018913	2	0	0	1	1	4
OG0018914	2	0	0	1	1	4
OG0018915	4	0	0	0	0	4
OG0018916	2	1	0	1	0	4
OG0018917	3	0	0	1	0	4
OG0018918	4	0	0	0	0	4
OG0018919	4	0	0	0	0	4
OG0018920	2	0	0	2	0	4
OG0018921	1	2	0	1	0	4
OG0018922	2	0	0	2	0	4
OG0018923	1	0	1	1	1	4
OG0018924	2	0	1	0	1	4
OG0018925	4	0	0	0	0	4
OG0018926	4	0	0	0	0	4
OG0018927	2	0	0	1	1	4
OG0018928	2	0	0	1	1	4
OG0018929	2	0	0	2	0	4
OG0018930	2	1	0	0	1	4
OG0018931	1	2	0	1	0	4
OG0018932	2	0	0	1	1	4
OG0018933	4	0	0	0	0	4
OG0018934	3	1	0	0	0	4
OG0018935	1	3	0	0	0	4
OG0018936	1	1	1	0	1	4
OG0018937	4	0	0	0	0	4
OG0018938	3	1	0	0	0	4
OG0018939	4	0	0	0	0	4
OG0018940	2	2	0	0	0	4
OG0018941	1	0	1	1	1	4
OG0018942	1	0	1	1	1	4
OG0018943	1	0	1	1	1	4
OG0018944	4	0	0	0	0	4
OG0018945	2	0	1	1	0	4
OG0018946	4	0	0	0	0	4
OG0018947	1	2	1	0	0	4
OG0018948	4	0	0	0	0	4
OG0018949	3	0	0	1	0	4
OG0018950	4	0	0	0	0	4
OG0018951	2	0	0	1	1	4
OG0018952	2	0	1	1	0	4
OG0018953	4	0	0	0	0	4
OG0018954	4	0	0	0	0	4
OG0018955	4	0	0	0	0	4
OG0018956	4	0	0	0	0	4
OG0018957	4	0	0	0	0	4
OG0018958	2	0	1	1	0	4
OG0018959	4	0	0	0	0	4
OG0018960	3	0	1	0	0	4
OG0018961	4	0	0	0	0	4
OG0018962	4	0	0	0	0	4
OG0018963	2	0	1	0	1	4
OG0018964	4	0	0	0	0	4
OG0018965	2	0	0	2	0	4
OG0018966	2	0	0	1	1	4
OG0018967	1	0	1	1	1	4
OG0018968	2	1	1	0	0	4
OG0018969	2	0	0	1	1	4
OG0018970	1	1	0	2	0	4
OG0018971	4	0	0	0	0	4
OG0018972	1	3	0	0	0	4
OG0018973	2	0	1	1	0	4
OG0018974	1	0	1	1	1	4
OG0018975	4	0	0	0	0	4
OG0018976	4	0	0	0	0	4
OG0018977	3	1	0	0	0	4
OG0018978	4	0	0	0	0	4
OG0018979	1	1	1	1	0	4
OG0018980	1	0	1	1	1	4
OG0018981	1	0	1	1	1	4
OG0018982	2	1	0	1	0	4
OG0018983	1	1	0	1	1	4
OG0018984	4	0	0	0	0	4
OG0018985	1	0	1	1	1	4
OG0018986	3	0	0	0	1	4
OG0018987	1	0	2	0	1	4
OG0018988	1	0	0	3	0	4
OG0018989	2	0	2	0	0	4
OG0018990	1	0	2	1	0	4
OG0018991	1	2	0	1	0	4
OG0018992	1	1	0	1	1	4
OG0018993	3	0	0	0	1	4
OG0018994	1	1	0	1	1	4
OG0018995	1	1	2	0	0	4
OG0018996	1	0	1	1	1	4
OG0018997	1	0	1	1	1	4
OG0018998	4	0	0	0	0	4
OG0018999	1	0	1	1	1	4
OG0019000	1	2	0	1	0	4
OG0019001	4	0	0	0	0	4
OG0019002	4	0	0	0	0	4
OG0019003	2	0	0	1	1	4
OG0019004	4	0	0	0	0	4
OG0019005	4	0	0	0	0	4
OG0019006	4	0	0	0	0	4
OG0019007	1	0	1	1	1	4
OG0019008	4	0	0	0	0	4
OG0019009	4	0	0	0	0	4
OG0019010	4	0	0	0	0	4
OG0019011	2	0	0	1	1	4
OG0019012	2	2	0	0	0	4
OG0019013	4	0	0	0	0	4
OG0019014	2	0	1	1	0	4
OG0019015	2	0	1	1	0	4
OG0019016	3	0	1	0	0	4
OG0019017	3	1	0	0	0	4
OG0019018	2	0	0	1	1	4
OG0019019	4	0	0	0	0	4
OG0019020	4	0	0	0	0	4
OG0019021	1	2	0	0	1	4
OG0019022	4	0	0	0	0	4
OG0019023	4	0	0	0	0	4
OG0019024	1	0	1	1	1	4
OG0019025	4	0	0	0	0	4
OG0019026	2	0	1	0	1	4
OG0019027	2	0	0	1	1	4
OG0019028	4	0	0	0	0	4
OG0019029	2	0	1	1	0	4
OG0019030	1	1	0	2	0	4
OG0019031	4	0	0	0	0	4
OG0019032	2	0	1	1	0	4
OG0019033	2	0	0	1	1	4
OG0019034	2	0	1	0	1	4
OG0019035	3	0	0	1	0	4
OG0019036	1	0	1	1	1	4
OG0019037	2	0	1	0	1	4
OG0019038	1	1	0	1	1	4
OG0019039	2	1	0	1	0	4
OG0019040	1	0	1	0	2	4
OG0019041	1	1	1	0	1	4
OG0019042	1	0	0	3	0	4
OG0019043	1	0	1	1	1	4
OG0019044	3	0	0	1	0	4
OG0019045	1	0	1	1	1	4
OG0019046	1	2	0	1	0	4
OG0019047	1	0	2	0	1	4
OG0019048	1	1	1	1	0	4
OG0019049	1	0	0	0	3	4
OG0019050	1	2	0	1	0	4
OG0019051	1	0	1	2	0	4
OG0019052	1	3	0	0	0	4
OG0019053	2	0	0	0	2	4
OG0019054	1	2	0	1	0	4
OG0019055	2	0	2	0	0	4
OG0019056	1	0	0	0	3	4
OG0019057	1	0	0	0	3	4
OG0019058	1	3	0	0	0	4
OG0019059	1	3	0	0	0	4
OG0019060	1	1	0	1	1	4
OG0019061	1	0	2	0	1	4
OG0019062	1	0	1	2	0	4
OG0019063	1	0	3	0	0	4
OG0019064	1	0	1	1	1	4
OG0019065	1	0	2	0	1	4
OG0019066	1	2	0	1	0	4
OG0019067	1	0	1	1	1	4
OG0019068	1	2	0	1	0	4
OG0019069	1	0	3	0	0	4
OG0019070	1	1	0	1	1	4
OG0019071	1	1	0	1	1	4
OG0019072	1	1	0	1	1	4
OG0019073	0	4	0	0	0	4
OG0019074	0	4	0	0	0	4
OG0019075	0	4	0	0	0	4
OG0019076	0	4	0	0	0	4
OG0019077	0	4	0	0	0	4
OG0019078	0	4	0	0	0	4
OG0019079	0	4	0	0	0	4
OG0019080	0	4	0	0	0	4
OG0019081	0	4	0	0	0	4
OG0019082	0	4	0	0	0	4
OG0019083	0	4	0	0	0	4
OG0019084	0	4	0	0	0	4
OG0019085	0	4	0	0	0	4
OG0019086	0	4	0	0	0	4
OG0019087	0	4	0	0	0	4
OG0019088	0	4	0	0	0	4
OG0019089	0	4	0	0	0	4
OG0019090	0	4	0	0	0	4
OG0019091	0	4	0	0	0	4
OG0019092	0	4	0	0	0	4
OG0019093	0	4	0	0	0	4
OG0019094	0	4	0	0	0	4
OG0019095	0	4	0	0	0	4
OG0019096	0	4	0	0	0	4
OG0019097	0	4	0	0	0	4
OG0019098	0	4	0	0	0	4
OG0019099	0	4	0	0	0	4
OG0019100	0	4	0	0	0	4
OG0019101	0	4	0	0	0	4
OG0019102	0	4	0	0	0	4
OG0019103	0	3	0	1	0	4
OG0019104	0	4	0	0	0	4
OG0019105	0	4	0	0	0	4
OG0019106	0	4	0	0	0	4
OG0019107	0	4	0	0	0	4
OG0019108	0	4	0	0	0	4
OG0019109	0	4	0	0	0	4
OG0019110	0	4	0	0	0	4
OG0019111	0	4	0	0	0	4
OG0019112	0	4	0	0	0	4
OG0019113	0	4	0	0	0	4
OG0019114	0	4	0	0	0	4
OG0019115	0	4	0	0	0	4
OG0019116	0	4	0	0	0	4
OG0019117	0	4	0	0	0	4
OG0019118	0	4	0	0	0	4
OG0019119	0	4	0	0	0	4
OG0019120	0	4	0	0	0	4
OG0019121	0	4	0	0	0	4
OG0019122	0	4	0	0	0	4
OG0019123	0	4	0	0	0	4
OG0019124	0	4	0	0	0	4
OG0019125	0	4	0	0	0	4
OG0019126	0	4	0	0	0	4
OG0019127	0	4	0	0	0	4
OG0019128	0	4	0	0	0	4
OG0019129	0	4	0	0	0	4
OG0019130	0	4	0	0	0	4
OG0019131	0	4	0	0	0	4
OG0019132	0	4	0	0	0	4
OG0019133	0	4	0	0	0	4
OG0019134	0	2	0	0	2	4
OG0019135	0	4	0	0	0	4
OG0019136	0	4	0	0	0	4
OG0019137	0	4	0	0	0	4
OG0019138	0	4	0	0	0	4
OG0019139	0	4	0	0	0	4
OG0019140	0	4	0	0	0	4
OG0019141	0	4	0	0	0	4
OG0019142	0	4	0	0	0	4
OG0019143	0	4	0	0	0	4
OG0019144	0	4	0	0	0	4
OG0019145	0	3	0	1	0	4
OG0019146	0	4	0	0	0	4
OG0019147	0	4	0	0	0	4
OG0019148	0	4	0	0	0	4
OG0019149	0	4	0	0	0	4
OG0019150	0	4	0	0	0	4
OG0019151	0	4	0	0	0	4
OG0019152	0	4	0	0	0	4
OG0019153	0	4	0	0	0	4
OG0019154	0	2	0	2	0	4
OG0019155	0	4	0	0	0	4
OG0019156	0	4	0	0	0	4
OG0019157	0	4	0	0	0	4
OG0019158	0	4	0	0	0	4
OG0019159	0	4	0	0	0	4
OG0019160	0	4	0	0	0	4
OG0019161	0	4	0	0	0	4
OG0019162	0	4	0	0	0	4
OG0019163	0	4	0	0	0	4
OG0019164	0	4	0	0	0	4
OG0019165	0	4	0	0	0	4
OG0019166	0	4	0	0	0	4
OG0019167	0	4	0	0	0	4
OG0019168	0	4	0	0	0	4
OG0019169	0	4	0	0	0	4
OG0019170	0	4	0	0	0	4
OG0019171	0	4	0	0	0	4
OG0019172	0	4	0	0	0	4
OG0019173	0	4	0	0	0	4
OG0019174	0	3	0	1	0	4
OG0019175	0	2	2	0	0	4
OG0019176	0	4	0	0	0	4
OG0019177	0	4	0	0	0	4
OG0019178	0	4	0	0	0	4
OG0019179	0	4	0	0	0	4
OG0019180	0	4	0	0	0	4
OG0019181	0	4	0	0	0	4
OG0019182	0	4	0	0	0	4
OG0019183	0	4	0	0	0	4
OG0019184	0	4	0	0	0	4
OG0019185	0	4	0	0	0	4
OG0019186	0	4	0	0	0	4
OG0019187	0	4	0	0	0	4
OG0019188	0	4	0	0	0	4
OG0019189	0	4	0	0	0	4
OG0019190	0	4	0	0	0	4
OG0019191	0	4	0	0	0	4
OG0019192	0	4	0	0	0	4
OG0019193	0	4	0	0	0	4
OG0019194	0	4	0	0	0	4
OG0019195	0	4	0	0	0	4
OG0019196	0	4	0	0	0	4
OG0019197	0	4	0	0	0	4
OG0019198	0	4	0	0	0	4
OG0019199	0	4	0	0	0	4
OG0019200	0	4	0	0	0	4
OG0019201	0	4	0	0	0	4
OG0019202	0	4	0	0	0	4
OG0019203	0	4	0	0	0	4
OG0019204	0	4	0	0	0	4
OG0019205	0	4	0	0	0	4
OG0019206	0	4	0	0	0	4
OG0019207	0	4	0	0	0	4
OG0019208	0	4	0	0	0	4
OG0019209	0	4	0	0	0	4
OG0019210	0	4	0	0	0	4
OG0019211	0	4	0	0	0	4
OG0019212	0	2	0	1	1	4
OG0019213	0	4	0	0	0	4
OG0019214	0	4	0	0	0	4
OG0019215	0	4	0	0	0	4
OG0019216	0	4	0	0	0	4
OG0019217	0	4	0	0	0	4
OG0019218	0	3	0	1	0	4
OG0019219	0	4	0	0	0	4
OG0019220	0	2	1	1	0	4
OG0019221	0	4	0	0	0	4
OG0019222	0	4	0	0	0	4
OG0019223	0	4	0	0	0	4
OG0019224	0	4	0	0	0	4
OG0019225	0	4	0	0	0	4
OG0019226	0	4	0	0	0	4
OG0019227	0	4	0	0	0	4
OG0019228	0	4	0	0	0	4
OG0019229	0	4	0	0	0	4
OG0019230	0	4	0	0	0	4
OG0019231	0	1	1	1	1	4
OG0019232	0	4	0	0	0	4
OG0019233	0	4	0	0	0	4
OG0019234	0	2	1	1	0	4
OG0019235	0	4	0	0	0	4
OG0019236	0	2	1	1	0	4
OG0019237	0	4	0	0	0	4
OG0019238	0	4	0	0	0	4
OG0019239	0	4	0	0	0	4
OG0019240	0	4	0	0	0	4
OG0019241	0	4	0	0	0	4
OG0019242	0	4	0	0	0	4
OG0019243	0	4	0	0	0	4
OG0019244	0	4	0	0	0	4
OG0019245	0	4	0	0	0	4
OG0019246	0	4	0	0	0	4
OG0019247	0	4	0	0	0	4
OG0019248	0	4	0	0	0	4
OG0019249	0	4	0	0	0	4
OG0019250	0	4	0	0	0	4
OG0019251	0	4	0	0	0	4
OG0019252	0	4	0	0	0	4
OG0019253	0	4	0	0	0	4
OG0019254	0	2	1	0	1	4
OG0019255	0	4	0	0	0	4
OG0019256	0	4	0	0	0	4
OG0019257	0	4	0	0	0	4
OG0019258	0	2	1	1	0	4
OG0019259	0	4	0	0	0	4
OG0019260	0	2	1	1	0	4
OG0019261	0	4	0	0	0	4
OG0019262	0	1	3	0	0	4
OG0019263	0	4	0	0	0	4
OG0019264	0	4	0	0	0	4
OG0019265	0	4	0	0	0	4
OG0019266	0	4	0	0	0	4
OG0019267	0	4	0	0	0	4
OG0019268	0	4	0	0	0	4
OG0019269	0	4	0	0	0	4
OG0019270	0	4	0	0	0	4
OG0019271	0	4	0	0	0	4
OG0019272	0	4	0	0	0	4
OG0019273	0	1	2	0	1	4
OG0019274	0	4	0	0	0	4
OG0019275	0	4	0	0	0	4
OG0019276	0	4	0	0	0	4
OG0019277	0	2	1	0	1	4
OG0019278	0	4	0	0	0	4
OG0019279	0	4	0	0	0	4
OG0019280	0	4	0	0	0	4
OG0019281	0	4	0	0	0	4
OG0019282	0	4	0	0	0	4
OG0019283	0	4	0	0	0	4
OG0019284	0	4	0	0	0	4
OG0019285	0	4	0	0	0	4
OG0019286	0	4	0	0	0	4
OG0019287	0	4	0	0	0	4
OG0019288	0	4	0	0	0	4
OG0019289	0	4	0	0	0	4
OG0019290	0	4	0	0	0	4
OG0019291	0	4	0	0	0	4
OG0019292	0	4	0	0	0	4
OG0019293	0	4	0	0	0	4
OG0019294	0	1	2	1	0	4
OG0019295	0	4	0	0	0	4
OG0019296	0	4	0	0	0	4
OG0019297	0	4	0	0	0	4
OG0019298	0	4	0	0	0	4
OG0019299	0	4	0	0	0	4
OG0019300	0	4	0	0	0	4
OG0019301	0	4	0	0	0	4
OG0019302	0	4	0	0	0	4
OG0019303	0	4	0	0	0	4
OG0019304	0	4	0	0	0	4
OG0019305	0	4	0	0	0	4
OG0019306	0	4	0	0	0	4
OG0019307	0	4	0	0	0	4
OG0019308	0	4	0	0	0	4
OG0019309	0	4	0	0	0	4
OG0019310	0	4	0	0	0	4
OG0019311	0	4	0	0	0	4
OG0019312	0	4	0	0	0	4
OG0019313	0	4	0	0	0	4
OG0019314	0	4	0	0	0	4
OG0019315	0	4	0	0	0	4
OG0019316	0	4	0	0	0	4
OG0019317	0	4	0	0	0	4
OG0019318	0	4	0	0	0	4
OG0019319	0	4	0	0	0	4
OG0019320	0	4	0	0	0	4
OG0019321	0	4	0	0	0	4
OG0019322	0	4	0	0	0	4
OG0019323	0	4	0	0	0	4
OG0019324	0	4	0	0	0	4
OG0019325	0	4	0	0	0	4
OG0019326	0	4	0	0	0	4
OG0019327	0	4	0	0	0	4
OG0019328	0	4	0	0	0	4
OG0019329	0	4	0	0	0	4
OG0019330	0	4	0	0	0	4
OG0019331	0	4	0	0	0	4
OG0019332	0	4	0	0	0	4
OG0019333	0	4	0	0	0	4
OG0019334	0	4	0	0	0	4
OG0019335	0	2	0	1	1	4
OG0019336	0	4	0	0	0	4
OG0019337	0	4	0	0	0	4
OG0019338	0	2	0	1	1	4
OG0019339	0	4	0	0	0	4
OG0019340	0	4	0	0	0	4
OG0019341	0	4	0	0	0	4
OG0019342	0	4	0	0	0	4
OG0019343	0	4	0	0	0	4
OG0019344	0	4	0	0	0	4
OG0019345	0	4	0	0	0	4
OG0019346	0	4	0	0	0	4
OG0019347	0	4	0	0	0	4
OG0019348	0	4	0	0	0	4
OG0019349	0	4	0	0	0	4
OG0019350	0	4	0	0	0	4
OG0019351	0	4	0	0	0	4
OG0019352	0	4	0	0	0	4
OG0019353	0	2	0	1	1	4
OG0019354	0	4	0	0	0	4
OG0019355	0	4	0	0	0	4
OG0019356	0	4	0	0	0	4
OG0019357	0	4	0	0	0	4
OG0019358	0	4	0	0	0	4
OG0019359	0	4	0	0	0	4
OG0019360	0	4	0	0	0	4
OG0019361	0	4	0	0	0	4
OG0019362	0	4	0	0	0	4
OG0019363	0	4	0	0	0	4
OG0019364	0	4	0	0	0	4
OG0019365	0	4	0	0	0	4
OG0019366	0	1	3	0	0	4
OG0019367	0	4	0	0	0	4
OG0019368	0	4	0	0	0	4
OG0019369	0	4	0	0	0	4
OG0019370	0	4	0	0	0	4
OG0019371	0	4	0	0	0	4
OG0019372	0	4	0	0	0	4
OG0019373	0	4	0	0	0	4
OG0019374	0	4	0	0	0	4
OG0019375	0	4	0	0	0	4
OG0019376	0	4	0	0	0	4
OG0019377	0	4	0	0	0	4
OG0019378	0	4	0	0	0	4
OG0019379	0	4	0	0	0	4
OG0019380	0	4	0	0	0	4
OG0019381	0	4	0	0	0	4
OG0019382	0	4	0	0	0	4
OG0019383	0	4	0	0	0	4
OG0019384	0	4	0	0	0	4
OG0019385	0	4	0	0	0	4
OG0019386	0	2	0	1	1	4
OG0019387	0	4	0	0	0	4
OG0019388	0	4	0	0	0	4
OG0019389	0	4	0	0	0	4
OG0019390	0	4	0	0	0	4
OG0019391	0	4	0	0	0	4
OG0019392	0	4	0	0	0	4
OG0019393	0	4	0	0	0	4
OG0019394	0	3	1	0	0	4
OG0019395	0	4	0	0	0	4
OG0019396	0	4	0	0	0	4
OG0019397	0	4	0	0	0	4
OG0019398	0	4	0	0	0	4
OG0019399	0	4	0	0	0	4
OG0019400	0	4	0	0	0	4
OG0019401	0	4	0	0	0	4
OG0019402	0	4	0	0	0	4
OG0019403	0	4	0	0	0	4
OG0019404	0	4	0	0	0	4
OG0019405	0	4	0	0	0	4
OG0019406	0	4	0	0	0	4
OG0019407	0	4	0	0	0	4
OG0019408	0	2	1	1	0	4
OG0019409	0	4	0	0	0	4
OG0019410	0	4	0	0	0	4
OG0019411	0	4	0	0	0	4
OG0019412	0	4	0	0	0	4
OG0019413	0	4	0	0	0	4
OG0019414	0	4	0	0	0	4
OG0019415	0	4	0	0	0	4
OG0019416	0	4	0	0	0	4
OG0019417	0	4	0	0	0	4
OG0019418	0	4	0	0	0	4
OG0019419	0	4	0	0	0	4
OG0019420	0	2	1	0	1	4
OG0019421	0	4	0	0	0	4
OG0019422	0	4	0	0	0	4
OG0019423	0	4	0	0	0	4
OG0019424	0	4	0	0	0	4
OG0019425	0	1	3	0	0	4
OG0019426	0	3	0	0	1	4
OG0019427	0	3	0	1	0	4
OG0019428	0	4	0	0	0	4
OG0019429	0	4	0	0	0	4
OG0019430	0	4	0	0	0	4
OG0019431	0	4	0	0	0	4
OG0019432	0	4	0	0	0	4
OG0019433	0	3	0	1	0	4
OG0019434	0	4	0	0	0	4
OG0019435	0	4	0	0	0	4
OG0019436	0	4	0	0	0	4
OG0019437	0	4	0	0	0	4
OG0019438	0	4	0	0	0	4
OG0019439	0	4	0	0	0	4
OG0019440	0	4	0	0	0	4
OG0019441	0	4	0	0	0	4
OG0019442	0	4	0	0	0	4
OG0019443	0	4	0	0	0	4
OG0019444	0	4	0	0	0	4
OG0019445	0	4	0	0	0	4
OG0019446	0	4	0	0	0	4
OG0019447	0	4	0	0	0	4
OG0019448	0	4	0	0	0	4
OG0019449	0	4	0	0	0	4
OG0019450	0	4	0	0	0	4
OG0019451	0	4	0	0	0	4
OG0019452	0	4	0	0	0	4
OG0019453	0	4	0	0	0	4
OG0019454	0	4	0	0	0	4
OG0019455	0	4	0	0	0	4
OG0019456	0	4	0	0	0	4
OG0019457	0	4	0	0	0	4
OG0019458	0	4	0	0	0	4
OG0019459	0	4	0	0	0	4
OG0019460	0	4	0	0	0	4
OG0019461	0	4	0	0	0	4
OG0019462	0	4	0	0	0	4
OG0019463	0	4	0	0	0	4
OG0019464	0	4	0	0	0	4
OG0019465	0	4	0	0	0	4
OG0019466	0	4	0	0	0	4
OG0019467	0	4	0	0	0	4
OG0019468	0	1	1	1	1	4
OG0019469	0	4	0	0	0	4
OG0019470	0	4	0	0	0	4
OG0019471	0	4	0	0	0	4
OG0019472	0	4	0	0	0	4
OG0019473	0	4	0	0	0	4
OG0019474	0	4	0	0	0	4
OG0019475	0	4	0	0	0	4
OG0019476	0	4	0	0	0	4
OG0019477	0	4	0	0	0	4
OG0019478	0	4	0	0	0	4
OG0019479	0	4	0	0	0	4
OG0019480	0	4	0	0	0	4
OG0019481	0	4	0	0	0	4
OG0019482	0	4	0	0	0	4
OG0019483	0	4	0	0	0	4
OG0019484	0	4	0	0	0	4
OG0019485	0	4	0	0	0	4
OG0019486	0	4	0	0	0	4
OG0019487	0	4	0	0	0	4
OG0019488	0	4	0	0	0	4
OG0019489	0	4	0	0	0	4
OG0019490	0	4	0	0	0	4
OG0019491	0	3	1	0	0	4
OG0019492	0	4	0	0	0	4
OG0019493	0	4	0	0	0	4
OG0019494	0	4	0	0	0	4
OG0019495	0	4	0	0	0	4
OG0019496	0	4	0	0	0	4
OG0019497	0	4	0	0	0	4
OG0019498	0	4	0	0	0	4
OG0019499	0	4	0	0	0	4
OG0019500	0	4	0	0	0	4
OG0019501	0	4	0	0	0	4
OG0019502	0	4	0	0	0	4
OG0019503	0	4	0	0	0	4
OG0019504	0	4	0	0	0	4
OG0019505	0	4	0	0	0	4
OG0019506	0	2	0	1	1	4
OG0019507	0	4	0	0	0	4
OG0019508	0	4	0	0	0	4
OG0019509	0	4	0	0	0	4
OG0019510	0	4	0	0	0	4
OG0019511	0	4	0	0	0	4
OG0019512	0	4	0	0	0	4
OG0019513	0	4	0	0	0	4
OG0019514	0	4	0	0	0	4
OG0019515	0	4	0	0	0	4
OG0019516	0	4	0	0	0	4
OG0019517	0	4	0	0	0	4
OG0019518	0	4	0	0	0	4
OG0019519	0	4	0	0	0	4
OG0019520	0	4	0	0	0	4
OG0019521	0	4	0	0	0	4
OG0019522	0	4	0	0	0	4
OG0019523	0	4	0	0	0	4
OG0019524	0	4	0	0	0	4
OG0019525	0	4	0	0	0	4
OG0019526	0	4	0	0	0	4
OG0019527	0	4	0	0	0	4
OG0019528	0	4	0	0	0	4
OG0019529	0	4	0	0	0	4
OG0019530	0	4	0	0	0	4
OG0019531	0	4	0	0	0	4
OG0019532	0	4	0	0	0	4
OG0019533	0	4	0	0	0	4
OG0019534	0	2	0	1	1	4
OG0019535	0	4	0	0	0	4
OG0019536	0	4	0	0	0	4
OG0019537	0	3	0	1	0	4
OG0019538	0	4	0	0	0	4
OG0019539	0	1	1	1	1	4
OG0019540	0	4	0	0	0	4
OG0019541	0	4	0	0	0	4
OG0019542	0	4	0	0	0	4
OG0019543	0	2	1	0	1	4
OG0019544	0	4	0	0	0	4
OG0019545	0	4	0	0	0	4
OG0019546	0	4	0	0	0	4
OG0019547	0	4	0	0	0	4
OG0019548	0	4	0	0	0	4
OG0019549	0	4	0	0	0	4
OG0019550	0	2	2	0	0	4
OG0019551	0	4	0	0	0	4
OG0019552	0	4	0	0	0	4
OG0019553	0	4	0	0	0	4
OG0019554	0	4	0	0	0	4
OG0019555	0	4	0	0	0	4
OG0019556	0	4	0	0	0	4
OG0019557	0	4	0	0	0	4
OG0019558	0	4	0	0	0	4
OG0019559	0	4	0	0	0	4
OG0019560	0	4	0	0	0	4
OG0019561	0	4	0	0	0	4
OG0019562	0	4	0	0	0	4
OG0019563	0	4	0	0	0	4
OG0019564	0	4	0	0	0	4
OG0019565	0	4	0	0	0	4
OG0019566	0	4	0	0	0	4
OG0019567	0	4	0	0	0	4
OG0019568	0	4	0	0	0	4
OG0019569	0	4	0	0	0	4
OG0019570	0	4	0	0	0	4
OG0019571	0	4	0	0	0	4
OG0019572	0	4	0	0	0	4
OG0019573	0	4	0	0	0	4
OG0019574	0	4	0	0	0	4
OG0019575	0	4	0	0	0	4
OG0019576	0	1	1	1	1	4
OG0019577	0	4	0	0	0	4
OG0019578	0	4	0	0	0	4
OG0019579	0	4	0	0	0	4
OG0019580	0	4	0	0	0	4
OG0019581	0	4	0	0	0	4
OG0019582	0	4	0	0	0	4
OG0019583	0	4	0	0	0	4
OG0019584	0	4	0	0	0	4
OG0019585	0	4	0	0	0	4
OG0019586	0	4	0	0	0	4
OG0019587	0	4	0	0	0	4
OG0019588	0	4	0	0	0	4
OG0019589	0	4	0	0	0	4
OG0019590	0	4	0	0	0	4
OG0019591	0	4	0	0	0	4
OG0019592	0	4	0	0	0	4
OG0019593	0	4	0	0	0	4
OG0019594	0	4	0	0	0	4
OG0019595	0	4	0	0	0	4
OG0019596	0	4	0	0	0	4
OG0019597	0	4	0	0	0	4
OG0019598	0	4	0	0	0	4
OG0019599	0	4	0	0	0	4
OG0019600	0	2	1	1	0	4
OG0019601	0	4	0	0	0	4
OG0019602	0	4	0	0	0	4
OG0019603	0	4	0	0	0	4
OG0019604	0	4	0	0	0	4
OG0019605	0	4	0	0	0	4
OG0019606	0	4	0	0	0	4
OG0019607	0	4	0	0	0	4
OG0019608	0	2	0	1	1	4
OG0019609	0	4	0	0	0	4
OG0019610	0	4	0	0	0	4
OG0019611	0	4	0	0	0	4
OG0019612	0	3	1	0	0	4
OG0019613	0	4	0	0	0	4
OG0019614	0	4	0	0	0	4
OG0019615	0	4	0	0	0	4
OG0019616	0	2	0	1	1	4
OG0019617	0	4	0	0	0	4
OG0019618	0	4	0	0	0	4
OG0019619	0	4	0	0	0	4
OG0019620	0	4	0	0	0	4
OG0019621	0	4	0	0	0	4
OG0019622	0	4	0	0	0	4
OG0019623	0	4	0	0	0	4
OG0019624	0	4	0	0	0	4
OG0019625	0	4	0	0	0	4
OG0019626	0	4	0	0	0	4
OG0019627	0	4	0	0	0	4
OG0019628	0	4	0	0	0	4
OG0019629	0	4	0	0	0	4
OG0019630	0	4	0	0	0	4
OG0019631	0	4	0	0	0	4
OG0019632	0	4	0	0	0	4
OG0019633	0	4	0	0	0	4
OG0019634	0	4	0	0	0	4
OG0019635	0	4	0	0	0	4
OG0019636	0	4	0	0	0	4
OG0019637	0	4	0	0	0	4
OG0019638	0	4	0	0	0	4
OG0019639	0	4	0	0	0	4
OG0019640	0	4	0	0	0	4
OG0019641	0	4	0	0	0	4
OG0019642	0	4	0	0	0	4
OG0019643	0	4	0	0	0	4
OG0019644	0	4	0	0	0	4
OG0019645	0	4	0	0	0	4
OG0019646	0	4	0	0	0	4
OG0019647	0	4	0	0	0	4
OG0019648	0	4	0	0	0	4
OG0019649	0	4	0	0	0	4
OG0019650	0	4	0	0	0	4
OG0019651	0	4	0	0	0	4
OG0019652	0	4	0	0	0	4
OG0019653	0	4	0	0	0	4
OG0019654	0	4	0	0	0	4
OG0019655	0	4	0	0	0	4
OG0019656	0	4	0	0	0	4
OG0019657	0	4	0	0	0	4
OG0019658	0	4	0	0	0	4
OG0019659	0	4	0	0	0	4
OG0019660	0	4	0	0	0	4
OG0019661	0	4	0	0	0	4
OG0019662	0	4	0	0	0	4
OG0019663	0	4	0	0	0	4
OG0019664	0	4	0	0	0	4
OG0019665	0	4	0	0	0	4
OG0019666	0	4	0	0	0	4
OG0019667	0	4	0	0	0	4
OG0019668	0	4	0	0	0	4
OG0019669	0	4	0	0	0	4
OG0019670	0	1	3	0	0	4
OG0019671	0	4	0	0	0	4
OG0019672	0	4	0	0	0	4
OG0019673	0	4	0	0	0	4
OG0019674	0	4	0	0	0	4
OG0019675	0	4	0	0	0	4
OG0019676	0	4	0	0	0	4
OG0019677	0	4	0	0	0	4
OG0019678	0	4	0	0	0	4
OG0019679	0	4	0	0	0	4
OG0019680	0	4	0	0	0	4
OG0019681	0	2	2	0	0	4
OG0019682	0	3	0	1	0	4
OG0019683	0	4	0	0	0	4
OG0019684	0	4	0	0	0	4
OG0019685	0	4	0	0	0	4
OG0019686	0	4	0	0	0	4
OG0019687	0	4	0	0	0	4
OG0019688	0	4	0	0	0	4
OG0019689	0	4	0	0	0	4
OG0019690	0	3	1	0	0	4
OG0019691	0	4	0	0	0	4
OG0019692	0	4	0	0	0	4
OG0019693	0	4	0	0	0	4
OG0019694	0	4	0	0	0	4
OG0019695	0	4	0	0	0	4
OG0019696	0	4	0	0	0	4
OG0019697	0	4	0	0	0	4
OG0019698	0	4	0	0	0	4
OG0019699	0	3	1	0	0	4
OG0019700	0	4	0	0	0	4
OG0019701	0	4	0	0	0	4
OG0019702	0	4	0	0	0	4
OG0019703	0	4	0	0	0	4
OG0019704	0	4	0	0	0	4
OG0019705	0	4	0	0	0	4
OG0019706	0	4	0	0	0	4
OG0019707	0	4	0	0	0	4
OG0019708	0	4	0	0	0	4
OG0019709	0	4	0	0	0	4
OG0019710	0	3	0	0	1	4
OG0019711	0	4	0	0	0	4
OG0019712	0	4	0	0	0	4
OG0019713	0	4	0	0	0	4
OG0019714	0	4	0	0	0	4
OG0019715	0	4	0	0	0	4
OG0019716	0	4	0	0	0	4
OG0019717	0	4	0	0	0	4
OG0019718	0	4	0	0	0	4
OG0019719	0	4	0	0	0	4
OG0019720	0	2	1	1	0	4
OG0019721	0	4	0	0	0	4
OG0019722	0	4	0	0	0	4
OG0019723	0	4	0	0	0	4
OG0019724	0	4	0	0	0	4
OG0019725	0	2	0	1	1	4
OG0019726	0	4	0	0	0	4
OG0019727	0	4	0	0	0	4
OG0019728	0	4	0	0	0	4
OG0019729	0	4	0	0	0	4
OG0019730	0	4	0	0	0	4
OG0019731	0	4	0	0	0	4
OG0019732	0	4	0	0	0	4
OG0019733	0	4	0	0	0	4
OG0019734	0	3	0	1	0	4
OG0019735	0	4	0	0	0	4
OG0019736	0	4	0	0	0	4
OG0019737	0	4	0	0	0	4
OG0019738	0	3	0	1	0	4
OG0019739	0	4	0	0	0	4
OG0019740	0	4	0	0	0	4
OG0019741	0	4	0	0	0	4
OG0019742	0	4	0	0	0	4
OG0019743	0	4	0	0	0	4
OG0019744	0	4	0	0	0	4
OG0019745	0	4	0	0	0	4
OG0019746	0	4	0	0	0	4
OG0019747	0	4	0	0	0	4
OG0019748	0	4	0	0	0	4
OG0019749	0	2	0	1	1	4
OG0019750	0	4	0	0	0	4
OG0019751	0	4	0	0	0	4
OG0019752	0	4	0	0	0	4
OG0019753	0	4	0	0	0	4
OG0019754	0	4	0	0	0	4
OG0019755	0	4	0	0	0	4
OG0019756	0	4	0	0	0	4
OG0019757	0	4	0	0	0	4
OG0019758	0	4	0	0	0	4
OG0019759	0	4	0	0	0	4
OG0019760	0	4	0	0	0	4
OG0019761	0	4	0	0	0	4
OG0019762	0	4	0	0	0	4
OG0019763	0	4	0	0	0	4
OG0019764	0	4	0	0	0	4
OG0019765	0	4	0	0	0	4
OG0019766	0	4	0	0	0	4
OG0019767	0	4	0	0	0	4
OG0019768	0	4	0	0	0	4
OG0019769	0	4	0	0	0	4
OG0019770	0	4	0	0	0	4
OG0019771	0	4	0	0	0	4
OG0019772	0	4	0	0	0	4
OG0019773	0	4	0	0	0	4
OG0019774	0	4	0	0	0	4
OG0019775	0	4	0	0	0	4
OG0019776	0	4	0	0	0	4
OG0019777	0	4	0	0	0	4
OG0019778	0	1	1	1	1	4
OG0019779	0	4	0	0	0	4
OG0019780	0	4	0	0	0	4
OG0019781	0	4	0	0	0	4
OG0019782	0	1	2	0	1	4
OG0019783	0	4	0	0	0	4
OG0019784	0	4	0	0	0	4
OG0019785	0	4	0	0	0	4
OG0019786	0	4	0	0	0	4
OG0019787	0	4	0	0	0	4
OG0019788	0	4	0	0	0	4
OG0019789	0	4	0	0	0	4
OG0019790	0	4	0	0	0	4
OG0019791	0	4	0	0	0	4
OG0019792	0	4	0	0	0	4
OG0019793	0	2	1	1	0	4
OG0019794	0	4	0	0	0	4
OG0019795	0	4	0	0	0	4
OG0019796	0	4	0	0	0	4
OG0019797	0	4	0	0	0	4
OG0019798	0	4	0	0	0	4
OG0019799	0	4	0	0	0	4
OG0019800	0	4	0	0	0	4
OG0019801	0	4	0	0	0	4
OG0019802	0	4	0	0	0	4
OG0019803	0	4	0	0	0	4
OG0019804	0	4	0	0	0	4
OG0019805	0	4	0	0	0	4
OG0019806	0	4	0	0	0	4
OG0019807	0	4	0	0	0	4
OG0019808	0	4	0	0	0	4
OG0019809	0	4	0	0	0	4
OG0019810	0	4	0	0	0	4
OG0019811	0	4	0	0	0	4
OG0019812	0	2	0	1	1	4
OG0019813	0	4	0	0	0	4
OG0019814	0	4	0	0	0	4
OG0019815	0	4	0	0	0	4
OG0019816	0	2	1	1	0	4
OG0019817	0	4	0	0	0	4
OG0019818	0	4	0	0	0	4
OG0019819	0	4	0	0	0	4
OG0019820	0	4	0	0	0	4
OG0019821	0	4	0	0	0	4
OG0019822	0	4	0	0	0	4
OG0019823	0	4	0	0	0	4
OG0019824	0	4	0	0	0	4
OG0019825	0	4	0	0	0	4
OG0019826	0	4	0	0	0	4
OG0019827	0	4	0	0	0	4
OG0019828	0	4	0	0	0	4
OG0019829	0	1	1	1	1	4
OG0019830	0	4	0	0	0	4
OG0019831	0	4	0	0	0	4
OG0019832	0	4	0	0	0	4
OG0019833	0	4	0	0	0	4
OG0019834	0	4	0	0	0	4
OG0019835	0	4	0	0	0	4
OG0019836	0	4	0	0	0	4
OG0019837	0	4	0	0	0	4
OG0019838	0	4	0	0	0	4
OG0019839	0	4	0	0	0	4
OG0019840	0	4	0	0	0	4
OG0019841	0	4	0	0	0	4
OG0019842	0	4	0	0	0	4
OG0019843	0	4	0	0	0	4
OG0019844	0	4	0	0	0	4
OG0019845	0	4	0	0	0	4
OG0019846	0	4	0	0	0	4
OG0019847	0	4	0	0	0	4
OG0019848	0	4	0	0	0	4
OG0019849	0	4	0	0	0	4
OG0019850	0	1	3	0	0	4
OG0019851	0	4	0	0	0	4
OG0019852	0	2	1	1	0	4
OG0019853	0	4	0	0	0	4
OG0019854	0	4	0	0	0	4
OG0019855	0	4	0	0	0	4
OG0019856	0	4	0	0	0	4
OG0019857	0	4	0	0	0	4
OG0019858	0	4	0	0	0	4
OG0019859	0	4	0	0	0	4
OG0019860	0	4	0	0	0	4
OG0019861	0	4	0	0	0	4
OG0019862	0	4	0	0	0	4
OG0019863	0	4	0	0	0	4
OG0019864	0	4	0	0	0	4
OG0019865	0	4	0	0	0	4
OG0019866	0	4	0	0	0	4
OG0019867	0	4	0	0	0	4
OG0019868	0	4	0	0	0	4
OG0019869	0	4	0	0	0	4
OG0019870	0	4	0	0	0	4
OG0019871	0	4	0	0	0	4
OG0019872	0	4	0	0	0	4
OG0019873	0	3	0	1	0	4
OG0019874	0	2	0	2	0	4
OG0019875	0	4	0	0	0	4
OG0019876	0	4	0	0	0	4
OG0019877	0	4	0	0	0	4
OG0019878	0	4	0	0	0	4
OG0019879	0	4	0	0	0	4
OG0019880	0	4	0	0	0	4
OG0019881	0	4	0	0	0	4
OG0019882	0	4	0	0	0	4
OG0019883	0	4	0	0	0	4
OG0019884	0	4	0	0	0	4
OG0019885	0	4	0	0	0	4
OG0019886	0	4	0	0	0	4
OG0019887	0	4	0	0	0	4
OG0019888	0	4	0	0	0	4
OG0019889	0	4	0	0	0	4
OG0019890	0	4	0	0	0	4
OG0019891	0	4	0	0	0	4
OG0019892	0	4	0	0	0	4
OG0019893	0	4	0	0	0	4
OG0019894	0	4	0	0	0	4
OG0019895	0	4	0	0	0	4
OG0019896	0	4	0	0	0	4
OG0019897	0	4	0	0	0	4
OG0019898	0	4	0	0	0	4
OG0019899	0	4	0	0	0	4
OG0019900	0	4	0	0	0	4
OG0019901	0	4	0	0	0	4
OG0019902	0	4	0	0	0	4
OG0019903	0	4	0	0	0	4
OG0019904	0	3	0	1	0	4
OG0019905	0	4	0	0	0	4
OG0019906	0	4	0	0	0	4
OG0019907	0	4	0	0	0	4
OG0019908	0	4	0	0	0	4
OG0019909	0	4	0	0	0	4
OG0019910	0	4	0	0	0	4
OG0019911	0	4	0	0	0	4
OG0019912	0	4	0	0	0	4
OG0019913	0	4	0	0	0	4
OG0019914	0	2	1	1	0	4
OG0019915	0	4	0	0	0	4
OG0019916	0	4	0	0	0	4
OG0019917	0	4	0	0	0	4
OG0019918	0	4	0	0	0	4
OG0019919	0	4	0	0	0	4
OG0019920	0	4	0	0	0	4
OG0019921	0	4	0	0	0	4
OG0019922	0	4	0	0	0	4
OG0019923	0	4	0	0	0	4
OG0019924	0	4	0	0	0	4
OG0019925	0	4	0	0	0	4
OG0019926	0	4	0	0	0	4
OG0019927	0	4	0	0	0	4
OG0019928	0	4	0	0	0	4
OG0019929	0	1	1	1	1	4
OG0019930	0	2	0	1	1	4
OG0019931	0	3	1	0	0	4
OG0019932	0	4	0	0	0	4
OG0019933	0	4	0	0	0	4
OG0019934	0	4	0	0	0	4
OG0019935	0	4	0	0	0	4
OG0019936	0	2	1	1	0	4
OG0019937	0	4	0	0	0	4
OG0019938	0	4	0	0	0	4
OG0019939	0	4	0	0	0	4
OG0019940	0	4	0	0	0	4
OG0019941	0	4	0	0	0	4
OG0019942	0	4	0	0	0	4
OG0019943	0	3	0	1	0	4
OG0019944	0	4	0	0	0	4
OG0019945	0	4	0	0	0	4
OG0019946	0	4	0	0	0	4
OG0019947	0	4	0	0	0	4
OG0019948	0	4	0	0	0	4
OG0019949	0	4	0	0	0	4
OG0019950	0	4	0	0	0	4
OG0019951	0	4	0	0	0	4
OG0019952	0	4	0	0	0	4
OG0019953	0	4	0	0	0	4
OG0019954	0	4	0	0	0	4
OG0019955	0	4	0	0	0	4
OG0019956	0	4	0	0	0	4
OG0019957	0	4	0	0	0	4
OG0019958	0	3	1	0	0	4
OG0019959	0	4	0	0	0	4
OG0019960	0	4	0	0	0	4
OG0019961	0	4	0	0	0	4
OG0019962	0	4	0	0	0	4
OG0019963	0	4	0	0	0	4
OG0019964	0	4	0	0	0	4
OG0019965	0	1	1	1	1	4
OG0019966	0	2	1	0	1	4
OG0019967	0	3	0	1	0	4
OG0019968	0	4	0	0	0	4
OG0019969	0	4	0	0	0	4
OG0019970	0	4	0	0	0	4
OG0019971	0	4	0	0	0	4
OG0019972	0	4	0	0	0	4
OG0019973	0	4	0	0	0	4
OG0019974	0	4	0	0	0	4
OG0019975	0	4	0	0	0	4
OG0019976	0	4	0	0	0	4
OG0019977	0	4	0	0	0	4
OG0019978	0	4	0	0	0	4
OG0019979	0	4	0	0	0	4
OG0019980	0	4	0	0	0	4
OG0019981	0	4	0	0	0	4
OG0019982	0	4	0	0	0	4
OG0019983	0	4	0	0	0	4
OG0019984	0	4	0	0	0	4
OG0019985	0	4	0	0	0	4
OG0019986	0	4	0	0	0	4
OG0019987	0	4	0	0	0	4
OG0019988	0	4	0	0	0	4
OG0019989	0	4	0	0	0	4
OG0019990	0	4	0	0	0	4
OG0019991	0	4	0	0	0	4
OG0019992	0	4	0	0	0	4
OG0019993	0	4	0	0	0	4
OG0019994	0	4	0	0	0	4
OG0019995	0	4	0	0	0	4
OG0019996	0	4	0	0	0	4
OG0019997	0	4	0	0	0	4
OG0019998	0	4	0	0	0	4
OG0019999	0	4	0	0	0	4
OG0020000	0	4	0	0	0	4
OG0020001	0	4	0	0	0	4
OG0020002	0	4	0	0	0	4
OG0020003	0	4	0	0	0	4
OG0020004	0	4	0	0	0	4
OG0020005	0	4	0	0	0	4
OG0020006	0	3	1	0	0	4
OG0020007	0	4	0	0	0	4
OG0020008	0	4	0	0	0	4
OG0020009	0	4	0	0	0	4
OG0020010	0	4	0	0	0	4
OG0020011	0	4	0	0	0	4
OG0020012	0	4	0	0	0	4
OG0020013	0	4	0	0	0	4
OG0020014	0	4	0	0	0	4
OG0020015	0	4	0	0	0	4
OG0020016	0	4	0	0	0	4
OG0020017	0	4	0	0	0	4
OG0020018	0	4	0	0	0	4
OG0020019	0	4	0	0	0	4
OG0020020	0	4	0	0	0	4
OG0020021	0	4	0	0	0	4
OG0020022	0	4	0	0	0	4
OG0020023	0	4	0	0	0	4
OG0020024	0	4	0	0	0	4
OG0020025	0	4	0	0	0	4
OG0020026	0	3	0	1	0	4
OG0020027	0	4	0	0	0	4
OG0020028	0	4	0	0	0	4
OG0020029	0	4	0	0	0	4
OG0020030	0	4	0	0	0	4
OG0020031	0	4	0	0	0	4
OG0020032	0	4	0	0	0	4
OG0020033	0	4	0	0	0	4
OG0020034	0	4	0	0	0	4
OG0020035	0	4	0	0	0	4
OG0020036	0	4	0	0	0	4
OG0020037	0	4	0	0	0	4
OG0020038	0	4	0	0	0	4
OG0020039	0	4	0	0	0	4
OG0020040	0	4	0	0	0	4
OG0020041	0	4	0	0	0	4
OG0020042	0	4	0	0	0	4
OG0020043	0	4	0	0	0	4
OG0020044	0	4	0	0	0	4
OG0020045	0	4	0	0	0	4
OG0020046	0	4	0	0	0	4
OG0020047	0	4	0	0	0	4
OG0020048	0	4	0	0	0	4
OG0020049	0	4	0	0	0	4
OG0020050	0	4	0	0	0	4
OG0020051	0	4	0	0	0	4
OG0020052	0	4	0	0	0	4
OG0020053	0	4	0	0	0	4
OG0020054	0	4	0	0	0	4
OG0020055	0	4	0	0	0	4
OG0020056	0	4	0	0	0	4
OG0020057	0	4	0	0	0	4
OG0020058	0	4	0	0	0	4
OG0020059	0	4	0	0	0	4
OG0020060	0	4	0	0	0	4
OG0020061	0	2	2	0	0	4
OG0020062	0	4	0	0	0	4
OG0020063	0	4	0	0	0	4
OG0020064	0	2	1	0	1	4
OG0020065	0	4	0	0	0	4
OG0020066	0	4	0	0	0	4
OG0020067	0	4	0	0	0	4
OG0020068	0	2	0	1	1	4
OG0020069	0	4	0	0	0	4
OG0020070	0	4	0	0	0	4
OG0020071	0	4	0	0	0	4
OG0020072	0	4	0	0	0	4
OG0020073	0	4	0	0	0	4
OG0020074	0	4	0	0	0	4
OG0020075	0	4	0	0	0	4
OG0020076	0	4	0	0	0	4
OG0020077	0	4	0	0	0	4
OG0020078	0	4	0	0	0	4
OG0020079	0	4	0	0	0	4
OG0020080	0	4	0	0	0	4
OG0020081	0	4	0	0	0	4
OG0020082	0	4	0	0	0	4
OG0020083	0	4	0	0	0	4
OG0020084	0	4	0	0	0	4
OG0020085	0	4	0	0	0	4
OG0020086	0	4	0	0	0	4
OG0020087	0	4	0	0	0	4
OG0020088	0	4	0	0	0	4
OG0020089	0	4	0	0	0	4
OG0020090	0	3	0	1	0	4
OG0020091	0	4	0	0	0	4
OG0020092	0	1	1	1	1	4
OG0020093	0	4	0	0	0	4
OG0020094	0	4	0	0	0	4
OG0020095	0	4	0	0	0	4
OG0020096	0	4	0	0	0	4
OG0020097	0	4	0	0	0	4
OG0020098	0	4	0	0	0	4
OG0020099	0	4	0	0	0	4
OG0020100	0	4	0	0	0	4
OG0020101	0	4	0	0	0	4
OG0020102	0	4	0	0	0	4
OG0020103	0	4	0	0	0	4
OG0020104	0	4	0	0	0	4
OG0020105	0	4	0	0	0	4
OG0020106	0	4	0	0	0	4
OG0020107	0	4	0	0	0	4
OG0020108	0	4	0	0	0	4
OG0020109	0	4	0	0	0	4
OG0020110	0	4	0	0	0	4
OG0020111	0	4	0	0	0	4
OG0020112	0	4	0	0	0	4
OG0020113	0	4	0	0	0	4
OG0020114	0	4	0	0	0	4
OG0020115	0	4	0	0	0	4
OG0020116	0	4	0	0	0	4
OG0020117	0	4	0	0	0	4
OG0020118	0	4	0	0	0	4
OG0020119	0	4	0	0	0	4
OG0020120	0	4	0	0	0	4
OG0020121	0	4	0	0	0	4
OG0020122	0	4	0	0	0	4
OG0020123	0	4	0	0	0	4
OG0020124	0	4	0	0	0	4
OG0020125	0	4	0	0	0	4
OG0020126	0	4	0	0	0	4
OG0020127	0	4	0	0	0	4
OG0020128	0	4	0	0	0	4
OG0020129	0	4	0	0	0	4
OG0020130	0	4	0	0	0	4
OG0020131	0	4	0	0	0	4
OG0020132	0	4	0	0	0	4
OG0020133	0	1	2	0	1	4
OG0020134	0	4	0	0	0	4
OG0020135	0	4	0	0	0	4
OG0020136	0	4	0	0	0	4
OG0020137	0	4	0	0	0	4
OG0020138	0	4	0	0	0	4
OG0020139	0	4	0	0	0	4
OG0020140	0	4	0	0	0	4
OG0020141	0	4	0	0	0	4
OG0020142	0	4	0	0	0	4
OG0020143	0	4	0	0	0	4
OG0020144	0	3	0	1	0	4
OG0020145	0	3	0	1	0	4
OG0020146	0	4	0	0	0	4
OG0020147	0	4	0	0	0	4
OG0020148	0	4	0	0	0	4
OG0020149	0	4	0	0	0	4
OG0020150	0	4	0	0	0	4
OG0020151	0	4	0	0	0	4
OG0020152	0	4	0	0	0	4
OG0020153	0	4	0	0	0	4
OG0020154	0	4	0	0	0	4
OG0020155	0	4	0	0	0	4
OG0020156	0	4	0	0	0	4
OG0020157	0	4	0	0	0	4
OG0020158	0	4	0	0	0	4
OG0020159	0	4	0	0	0	4
OG0020160	0	4	0	0	0	4
OG0020161	0	4	0	0	0	4
OG0020162	0	4	0	0	0	4
OG0020163	0	4	0	0	0	4
OG0020164	0	4	0	0	0	4
OG0020165	0	4	0	0	0	4
OG0020166	0	4	0	0	0	4
OG0020167	0	4	0	0	0	4
OG0020168	0	4	0	0	0	4
OG0020169	0	4	0	0	0	4
OG0020170	0	4	0	0	0	4
OG0020171	0	4	0	0	0	4
OG0020172	0	4	0	0	0	4
OG0020173	0	4	0	0	0	4
OG0020174	0	4	0	0	0	4
OG0020175	0	4	0	0	0	4
OG0020176	0	4	0	0	0	4
OG0020177	0	4	0	0	0	4
OG0020178	0	4	0	0	0	4
OG0020179	0	4	0	0	0	4
OG0020180	0	4	0	0	0	4
OG0020181	0	4	0	0	0	4
OG0020182	0	4	0	0	0	4
OG0020183	0	4	0	0	0	4
OG0020184	0	4	0	0	0	4
OG0020185	0	4	0	0	0	4
OG0020186	0	4	0	0	0	4
OG0020187	0	4	0	0	0	4
OG0020188	0	4	0	0	0	4
OG0020189	0	4	0	0	0	4
OG0020190	0	4	0	0	0	4
OG0020191	0	4	0	0	0	4
OG0020192	0	4	0	0	0	4
OG0020193	0	4	0	0	0	4
OG0020194	0	4	0	0	0	4
OG0020195	0	4	0	0	0	4
OG0020196	0	2	0	1	1	4
OG0020197	0	4	0	0	0	4
OG0020198	0	4	0	0	0	4
OG0020199	0	4	0	0	0	4
OG0020200	0	4	0	0	0	4
OG0020201	0	4	0	0	0	4
OG0020202	0	4	0	0	0	4
OG0020203	0	4	0	0	0	4
OG0020204	0	4	0	0	0	4
OG0020205	0	4	0	0	0	4
OG0020206	0	4	0	0	0	4
OG0020207	0	4	0	0	0	4
OG0020208	0	4	0	0	0	4
OG0020209	0	4	0	0	0	4
OG0020210	0	4	0	0	0	4
OG0020211	0	4	0	0	0	4
OG0020212	0	4	0	0	0	4
OG0020213	0	2	0	1	1	4
OG0020214	0	4	0	0	0	4
OG0020215	0	4	0	0	0	4
OG0020216	0	4	0	0	0	4
OG0020217	0	4	0	0	0	4
OG0020218	0	2	1	0	1	4
OG0020219	0	4	0	0	0	4
OG0020220	0	4	0	0	0	4
OG0020221	0	4	0	0	0	4
OG0020222	0	4	0	0	0	4
OG0020223	0	4	0	0	0	4
OG0020224	0	4	0	0	0	4
OG0020225	0	4	0	0	0	4
OG0020226	0	4	0	0	0	4
OG0020227	0	4	0	0	0	4
OG0020228	0	4	0	0	0	4
OG0020229	0	2	1	0	1	4
OG0020230	0	4	0	0	0	4
OG0020231	0	4	0	0	0	4
OG0020232	0	4	0	0	0	4
OG0020233	0	1	1	1	1	4
OG0020234	0	4	0	0	0	4
OG0020235	0	2	1	1	0	4
OG0020236	0	4	0	0	0	4
OG0020237	0	4	0	0	0	4
OG0020238	0	4	0	0	0	4
OG0020239	0	4	0	0	0	4
OG0020240	0	3	0	1	0	4
OG0020241	0	4	0	0	0	4
OG0020242	0	4	0	0	0	4
OG0020243	0	4	0	0	0	4
OG0020244	0	4	0	0	0	4
OG0020245	0	4	0	0	0	4
OG0020246	0	4	0	0	0	4
OG0020247	0	4	0	0	0	4
OG0020248	0	2	0	1	1	4
OG0020249	0	4	0	0	0	4
OG0020250	0	4	0	0	0	4
OG0020251	0	4	0	0	0	4
OG0020252	0	4	0	0	0	4
OG0020253	0	4	0	0	0	4
OG0020254	0	4	0	0	0	4
OG0020255	0	4	0	0	0	4
OG0020256	0	4	0	0	0	4
OG0020257	0	4	0	0	0	4
OG0020258	0	4	0	0	0	4
OG0020259	0	4	0	0	0	4
OG0020260	0	4	0	0	0	4
OG0020261	0	4	0	0	0	4
OG0020262	0	4	0	0	0	4
OG0020263	0	4	0	0	0	4
OG0020264	0	4	0	0	0	4
OG0020265	0	4	0	0	0	4
OG0020266	0	4	0	0	0	4
OG0020267	0	4	0	0	0	4
OG0020268	0	4	0	0	0	4
OG0020269	0	3	0	1	0	4
OG0020270	0	4	0	0	0	4
OG0020271	0	4	0	0	0	4
OG0020272	0	4	0	0	0	4
OG0020273	0	4	0	0	0	4
OG0020274	0	4	0	0	0	4
OG0020275	0	4	0	0	0	4
OG0020276	0	4	0	0	0	4
OG0020277	0	4	0	0	0	4
OG0020278	0	4	0	0	0	4
OG0020279	0	4	0	0	0	4
OG0020280	0	4	0	0	0	4
OG0020281	0	4	0	0	0	4
OG0020282	0	4	0	0	0	4
OG0020283	0	2	1	1	0	4
OG0020284	0	1	1	1	1	4
OG0020285	0	4	0	0	0	4
OG0020286	0	4	0	0	0	4
OG0020287	0	4	0	0	0	4
OG0020288	0	1	1	1	1	4
OG0020289	0	4	0	0	0	4
OG0020290	0	4	0	0	0	4
OG0020291	0	2	0	1	1	4
OG0020292	0	4	0	0	0	4
OG0020293	0	4	0	0	0	4
OG0020294	0	4	0	0	0	4
OG0020295	0	4	0	0	0	4
OG0020296	0	4	0	0	0	4
OG0020297	0	4	0	0	0	4
OG0020298	0	4	0	0	0	4
OG0020299	0	4	0	0	0	4
OG0020300	0	4	0	0	0	4
OG0020301	0	4	0	0	0	4
OG0020302	0	4	0	0	0	4
OG0020303	0	3	0	1	0	4
OG0020304	0	4	0	0	0	4
OG0020305	0	4	0	0	0	4
OG0020306	0	2	0	1	1	4
OG0020307	0	4	0	0	0	4
OG0020308	0	4	0	0	0	4
OG0020309	0	4	0	0	0	4
OG0020310	0	4	0	0	0	4
OG0020311	0	4	0	0	0	4
OG0020312	0	4	0	0	0	4
OG0020313	0	4	0	0	0	4
OG0020314	0	4	0	0	0	4
OG0020315	0	4	0	0	0	4
OG0020316	0	4	0	0	0	4
OG0020317	0	3	1	0	0	4
OG0020318	0	4	0	0	0	4
OG0020319	0	4	0	0	0	4
OG0020320	0	4	0	0	0	4
OG0020321	0	1	1	1	1	4
OG0020322	0	4	0	0	0	4
OG0020323	0	4	0	0	0	4
OG0020324	0	4	0	0	0	4
OG0020325	0	4	0	0	0	4
OG0020326	0	4	0	0	0	4
OG0020327	0	4	0	0	0	4
OG0020328	0	4	0	0	0	4
OG0020329	0	3	0	1	0	4
OG0020330	0	4	0	0	0	4
OG0020331	0	4	0	0	0	4
OG0020332	0	4	0	0	0	4
OG0020333	0	4	0	0	0	4
OG0020334	0	4	0	0	0	4
OG0020335	0	4	0	0	0	4
OG0020336	0	4	0	0	0	4
OG0020337	0	4	0	0	0	4
OG0020338	0	4	0	0	0	4
OG0020339	0	4	0	0	0	4
OG0020340	0	4	0	0	0	4
OG0020341	0	2	0	1	1	4
OG0020342	0	4	0	0	0	4
OG0020343	0	4	0	0	0	4
OG0020344	0	4	0	0	0	4
OG0020345	0	1	1	1	1	4
OG0020346	0	4	0	0	0	4
OG0020347	0	4	0	0	0	4
OG0020348	0	4	0	0	0	4
OG0020349	0	4	0	0	0	4
OG0020350	0	2	0	1	1	4
OG0020351	0	4	0	0	0	4
OG0020352	0	4	0	0	0	4
OG0020353	0	4	0	0	0	4
OG0020354	0	4	0	0	0	4
OG0020355	0	4	0	0	0	4
OG0020356	0	2	0	1	1	4
OG0020357	0	4	0	0	0	4
OG0020358	0	4	0	0	0	4
OG0020359	0	2	1	1	0	4
OG0020360	0	2	1	1	0	4
OG0020361	0	3	1	0	0	4
OG0020362	0	4	0	0	0	4
OG0020363	0	4	0	0	0	4
OG0020364	0	4	0	0	0	4
OG0020365	0	4	0	0	0	4
OG0020366	0	4	0	0	0	4
OG0020367	0	1	1	1	1	4
OG0020368	0	4	0	0	0	4
OG0020369	0	4	0	0	0	4
OG0020370	0	4	0	0	0	4
OG0020371	0	4	0	0	0	4
OG0020372	0	4	0	0	0	4
OG0020373	0	2	1	1	0	4
OG0020374	0	4	0	0	0	4
OG0020375	0	4	0	0	0	4
OG0020376	0	4	0	0	0	4
OG0020377	0	4	0	0	0	4
OG0020378	0	4	0	0	0	4
OG0020379	0	2	1	1	0	4
OG0020380	0	2	0	1	1	4
OG0020381	0	4	0	0	0	4
OG0020382	0	4	0	0	0	4
OG0020383	0	4	0	0	0	4
OG0020384	0	4	0	0	0	4
OG0020385	0	4	0	0	0	4
OG0020386	0	4	0	0	0	4
OG0020387	0	4	0	0	0	4
OG0020388	0	4	0	0	0	4
OG0020389	0	4	0	0	0	4
OG0020390	0	3	1	0	0	4
OG0020391	0	4	0	0	0	4
OG0020392	0	4	0	0	0	4
OG0020393	0	3	1	0	0	4
OG0020394	0	2	0	1	1	4
OG0020395	0	4	0	0	0	4
OG0020396	0	4	0	0	0	4
OG0020397	0	4	0	0	0	4
OG0020398	0	4	0	0	0	4
OG0020399	0	4	0	0	0	4
OG0020400	0	4	0	0	0	4
OG0020401	0	4	0	0	0	4
OG0020402	0	4	0	0	0	4
OG0020403	0	4	0	0	0	4
OG0020404	0	2	0	1	1	4
OG0020405	0	2	1	1	0	4
OG0020406	0	4	0	0	0	4
OG0020407	0	1	1	1	1	4
OG0020408	0	4	0	0	0	4
OG0020409	0	4	0	0	0	4
OG0020410	0	4	0	0	0	4
OG0020411	0	1	2	0	1	4
OG0020412	0	4	0	0	0	4
OG0020413	0	2	0	1	1	4
OG0020414	0	4	0	0	0	4
OG0020415	0	4	0	0	0	4
OG0020416	0	3	1	0	0	4
OG0020417	0	4	0	0	0	4
OG0020418	0	4	0	0	0	4
OG0020419	0	4	0	0	0	4
OG0020420	0	4	0	0	0	4
OG0020421	0	4	0	0	0	4
OG0020422	0	2	1	1	0	4
OG0020423	0	4	0	0	0	4
OG0020424	0	3	0	0	1	4
OG0020425	0	3	0	1	0	4
OG0020426	0	2	1	0	1	4
OG0020427	0	4	0	0	0	4
OG0020428	0	3	0	1	0	4
OG0020429	0	4	0	0	0	4
OG0020430	0	4	0	0	0	4
OG0020431	0	4	0	0	0	4
OG0020432	0	4	0	0	0	4
OG0020433	0	2	0	2	0	4
OG0020434	0	2	1	1	0	4
OG0020435	0	4	0	0	0	4
OG0020436	0	3	0	1	0	4
OG0020437	0	4	0	0	0	4
OG0020438	0	4	0	0	0	4
OG0020439	0	4	0	0	0	4
OG0020440	0	4	0	0	0	4
OG0020441	0	2	0	1	1	4
OG0020442	0	4	0	0	0	4
OG0020443	0	4	0	0	0	4
OG0020444	0	4	0	0	0	4
OG0020445	0	4	0	0	0	4
OG0020446	0	4	0	0	0	4
OG0020447	0	2	1	0	1	4
OG0020448	0	2	1	1	0	4
OG0020449	0	1	1	0	2	4
OG0020450	0	1	1	1	1	4
OG0020451	0	4	0	0	0	4
OG0020452	0	4	0	0	0	4
OG0020453	0	4	0	0	0	4
OG0020454	0	4	0	0	0	4
OG0020455	0	4	0	0	0	4
OG0020456	0	4	0	0	0	4
OG0020457	0	2	1	0	1	4
OG0020458	0	4	0	0	0	4
OG0020459	0	4	0	0	0	4
OG0020460	0	1	3	0	0	4
OG0020461	0	3	0	1	0	4
OG0020462	0	4	0	0	0	4
OG0020463	0	4	0	0	0	4
OG0020464	0	3	1	0	0	4
OG0020465	0	1	3	0	0	4
OG0020466	0	1	1	1	1	4
OG0020467	0	4	0	0	0	4
OG0020468	0	2	1	0	1	4
OG0020469	0	2	0	1	1	4
OG0020470	0	4	0	0	0	4
OG0020471	0	2	1	1	0	4
OG0020472	0	4	0	0	0	4
OG0020473	0	4	0	0	0	4
OG0020474	0	4	0	0	0	4
OG0020475	0	1	1	2	0	4
OG0020476	0	2	0	1	1	4
OG0020477	0	2	0	1	1	4
OG0020478	0	4	0	0	0	4
OG0020479	0	4	0	0	0	4
OG0020480	0	4	0	0	0	4
OG0020481	0	4	0	0	0	4
OG0020482	0	4	0	0	0	4
OG0020483	0	4	0	0	0	4
OG0020484	0	4	0	0	0	4
OG0020485	0	4	0	0	0	4
OG0020486	0	4	0	0	0	4
OG0020487	0	1	3	0	0	4
OG0020488	0	4	0	0	0	4
OG0020489	0	4	0	0	0	4
OG0020490	0	4	0	0	0	4
OG0020491	0	4	0	0	0	4
OG0020492	0	4	0	0	0	4
OG0020493	0	1	1	1	1	4
OG0020494	0	4	0	0	0	4
OG0020495	0	4	0	0	0	4
OG0020496	0	4	0	0	0	4
OG0020497	0	4	0	0	0	4
OG0020498	0	1	1	1	1	4
OG0020499	0	4	0	0	0	4
OG0020500	0	2	0	1	1	4
OG0020501	0	4	0	0	0	4
OG0020502	0	4	0	0	0	4
OG0020503	0	4	0	0	0	4
OG0020504	0	4	0	0	0	4
OG0020505	0	4	0	0	0	4
OG0020506	0	4	0	0	0	4
OG0020507	0	4	0	0	0	4
OG0020508	0	4	0	0	0	4
OG0020509	0	1	1	1	1	4
OG0020510	0	2	0	1	1	4
OG0020511	0	4	0	0	0	4
OG0020512	0	2	1	0	1	4
OG0020513	0	1	1	1	1	4
OG0020514	0	1	0	1	2	4
OG0020515	0	1	1	1	1	4
OG0020516	0	4	0	0	0	4
OG0020517	0	3	0	1	0	4
OG0020518	0	1	1	1	1	4
OG0020519	0	2	1	1	0	4
OG0020520	0	1	1	1	1	4
OG0020521	0	1	3	0	0	4
OG0020522	0	4	0	0	0	4
OG0020523	0	4	0	0	0	4
OG0020524	0	4	0	0	0	4
OG0020525	0	4	0	0	0	4
OG0020526	0	3	0	1	0	4
OG0020527	0	4	0	0	0	4
OG0020528	0	2	0	1	1	4
OG0020529	0	4	0	0	0	4
OG0020530	0	2	1	1	0	4
OG0020531	0	1	1	2	0	4
OG0020532	0	1	1	1	1	4
OG0020533	0	1	1	1	1	4
OG0020534	0	1	1	1	1	4
OG0020535	0	1	3	0	0	4
OG0020536	0	1	3	0	0	4
OG0020537	0	1	2	0	1	4
OG0020538	0	2	0	0	2	4
OG0020539	0	1	0	3	0	4
OG0020540	0	1	3	0	0	4
OG0020541	0	1	1	0	2	4
OG0020542	0	2	0	1	1	4
OG0020543	0	2	1	0	1	4
OG0020544	0	1	3	0	0	4
OG0020545	0	1	1	1	1	4
OG0020546	0	0	2	0	2	4
OG0020547	0	0	4	0	0	4
OG0020548	0	0	2	0	2	4
OG0020549	0	0	3	0	1	4
OG0020550	0	0	3	0	1	4
OG0020551	0	0	4	0	0	4
OG0020552	0	0	4	0	0	4
OG0020553	0	0	4	0	0	4
OG0020554	0	0	4	0	0	4
OG0020555	0	0	2	0	2	4
OG0020556	0	0	1	0	3	4
OG0020557	0	0	4	0	0	4
OG0020558	0	0	3	0	1	4
OG0020559	0	0	3	0	1	4
OG0020560	0	0	4	0	0	4
OG0020561	0	0	1	0	3	4
OG0020562	0	0	4	0	0	4
OG0020563	0	0	4	0	0	4
OG0020564	0	0	1	0	3	4
OG0020565	0	0	4	0	0	4
OG0020566	0	0	4	0	0	4
OG0020567	0	0	4	0	0	4
OG0020568	0	0	4	0	0	4
OG0020569	0	0	4	0	0	4
OG0020570	0	0	4	0	0	4
OG0020571	0	0	4	0	0	4
OG0020572	0	0	1	0	3	4
OG0020573	0	0	3	0	1	4
OG0020574	0	0	3	0	1	4
OG0020575	0	0	3	0	1	4
OG0020576	0	0	4	0	0	4
OG0020577	0	0	2	1	1	4
OG0020578	0	0	4	0	0	4
OG0020579	0	0	3	0	1	4
OG0020580	0	0	2	0	2	4
OG0020581	0	0	3	1	0	4
OG0020582	0	0	2	2	0	4
OG0020583	0	0	3	0	1	4
OG0020584	0	0	4	0	0	4
OG0020585	0	0	1	0	3	4
OG0020586	0	0	4	0	0	4
OG0020587	0	0	3	0	1	4
OG0020588	0	0	2	0	2	4
OG0020589	0	0	4	0	0	4
OG0020590	0	0	4	0	0	4
OG0020591	0	0	4	0	0	4
OG0020592	0	0	4	0	0	4
OG0020593	0	0	2	0	2	4
OG0020594	0	0	2	0	2	4
OG0020595	0	0	1	0	3	4
OG0020596	0	0	2	0	2	4
OG0020597	0	0	4	0	0	4
OG0020598	0	0	3	0	1	4
OG0020599	0	0	1	0	3	4
OG0020600	0	0	4	0	0	4
OG0020601	0	0	1	0	3	4
OG0020602	0	0	2	0	2	4
OG0020603	0	0	2	0	2	4
OG0020604	0	0	4	0	0	4
OG0020605	0	0	2	0	2	4
OG0020606	0	0	1	0	3	4
OG0020607	0	0	3	0	1	4
OG0020608	0	0	2	0	2	4
OG0020609	0	0	3	0	1	4
OG0020610	0	0	2	0	2	4
OG0020611	0	0	4	0	0	4
OG0020612	0	0	3	0	1	4
OG0020613	0	0	3	0	1	4
OG0020614	0	0	2	0	2	4
OG0020615	0	0	3	0	1	4
OG0020616	0	0	2	0	2	4
OG0020617	0	0	2	1	1	4
OG0020618	0	0	2	0	2	4
OG0020619	0	0	1	0	3	4
OG0020620	0	0	1	1	2	4
OG0020621	0	0	2	0	2	4
OG0020622	0	0	4	0	0	4
OG0020623	0	0	3	0	1	4
OG0020624	0	0	1	0	3	4
OG0020625	0	0	1	0	3	4
OG0020626	0	0	1	0	3	4
OG0020627	0	0	4	0	0	4
OG0020628	0	0	4	0	0	4
OG0020629	0	0	2	0	2	4
OG0020630	0	0	2	1	1	4
OG0020631	0	0	2	0	2	4
OG0020632	0	0	1	1	2	4
OG0020633	0	0	1	1	2	4
OG0020634	0	0	4	0	0	4
OG0020635	0	0	4	0	0	4
OG0020636	0	0	3	0	1	4
OG0020637	0	0	2	1	1	4
OG0020638	0	0	4	0	0	4
OG0020639	0	0	4	0	0	4
OG0020640	0	0	3	0	1	4
OG0020641	0	0	2	1	1	4
OG0020642	0	0	2	0	2	4
OG0020643	0	0	2	0	2	4
OG0020644	0	0	3	0	1	4
OG0020645	0	0	4	0	0	4
OG0020646	0	0	2	0	2	4
OG0020647	0	0	4	0	0	4
OG0020648	0	0	3	0	1	4
OG0020649	0	0	3	0	1	4
OG0020650	0	0	2	1	1	4
OG0020651	0	0	4	0	0	4
OG0020652	0	0	3	0	1	4
OG0020653	0	0	2	0	2	4
OG0020654	0	0	3	0	1	4
OG0020655	0	0	2	0	2	4
OG0020656	0	0	3	0	1	4
OG0020657	0	0	3	0	1	4
OG0020658	0	0	4	0	0	4
OG0020659	0	0	2	0	2	4
OG0020660	0	0	2	0	2	4
OG0020661	0	0	4	0	0	4
OG0020662	0	0	1	0	3	4
OG0020663	0	0	4	0	0	4
OG0020664	0	0	3	0	1	4
OG0020665	0	0	1	0	3	4
OG0020666	0	0	4	0	0	4
OG0020667	0	0	4	0	0	4
OG0020668	0	0	2	0	2	4
OG0020669	0	0	4	0	0	4
OG0020670	0	0	3	0	1	4
OG0020671	0	0	3	0	1	4
OG0020672	0	0	1	2	1	4
OG0020673	0	0	2	0	2	4
OG0020674	0	0	1	1	2	4
OG0020675	0	0	2	1	1	4
OG0020676	0	0	3	0	1	4
OG0020677	0	0	4	0	0	4
OG0020678	0	0	1	0	3	4
OG0020679	0	0	3	0	1	4
OG0020680	0	0	3	0	1	4
OG0020681	0	0	3	0	1	4
OG0020682	0	0	2	0	2	4
OG0020683	0	0	4	0	0	4
OG0020684	0	0	4	0	0	4
OG0020685	0	0	2	1	1	4
OG0020686	0	0	2	0	2	4
OG0020687	0	0	1	1	2	4
OG0020688	0	0	3	0	1	4
OG0020689	0	0	3	0	1	4
OG0020690	0	0	3	0	1	4
OG0020691	0	0	3	0	1	4
OG0020692	0	0	4	0	0	4
OG0020693	0	0	1	0	3	4
OG0020694	0	0	3	0	1	4
OG0020695	0	0	1	2	1	4
OG0020696	0	0	1	0	3	4
OG0020697	0	0	4	0	0	4
OG0020698	0	0	3	0	1	4
OG0020699	0	0	1	1	2	4
OG0020700	0	0	1	1	2	4
OG0020701	0	0	2	1	1	4
OG0020702	0	0	2	0	2	4
OG0020703	0	0	1	0	3	4
OG0020704	0	0	4	0	0	4
OG0020705	0	0	3	0	1	4
OG0020706	0	0	4	0	0	4
OG0020707	0	0	4	0	0	4
OG0020708	0	0	3	0	1	4
OG0020709	0	0	2	0	2	4
OG0020710	0	0	4	0	0	4
OG0020711	0	0	1	0	3	4
OG0020712	0	0	2	0	2	4
OG0020713	0	0	2	1	1	4
OG0020714	0	0	1	0	3	4
OG0020715	0	0	1	0	3	4
OG0020716	0	0	3	0	1	4
OG0020717	0	0	4	0	0	4
OG0020718	0	0	2	1	1	4
OG0020719	0	0	2	0	2	4
OG0020720	0	0	2	1	1	4
OG0020721	0	0	1	0	3	4
OG0020722	0	0	3	0	1	4
OG0020723	0	0	4	0	0	4
OG0020724	0	0	2	1	1	4
OG0020725	0	0	2	0	2	4
OG0020726	0	0	1	0	3	4
OG0020727	0	0	2	0	2	4
OG0020728	0	0	4	0	0	4
OG0020729	0	0	2	0	2	4
OG0020730	0	0	3	0	1	4
OG0020731	0	0	4	0	0	4
OG0020732	0	0	4	0	0	4
OG0020733	0	0	2	0	2	4
OG0020734	0	0	3	0	1	4
OG0020735	0	0	2	0	2	4
OG0020736	0	0	2	0	2	4
OG0020737	0	0	4	0	0	4
OG0020738	0	0	4	0	0	4
OG0020739	0	0	2	1	1	4
OG0020740	0	0	3	0	1	4
OG0020741	0	0	2	1	1	4
OG0020742	0	0	2	0	2	4
OG0020743	0	0	4	0	0	4
OG0020744	0	0	2	0	2	4
OG0020745	0	0	2	0	2	4
OG0020746	0	0	1	0	3	4
OG0020747	0	0	1	3	0	4
OG0020748	0	0	1	1	2	4
OG0020749	0	0	3	0	1	4
OG0020750	0	0	2	0	2	4
OG0020751	0	0	3	0	1	4
OG0020752	0	0	3	0	1	4
OG0020753	0	0	3	0	1	4
OG0020754	0	0	1	2	1	4
OG0020755	0	0	3	0	1	4
OG0020756	0	0	3	1	0	4
OG0020757	0	0	2	1	1	4
OG0020758	0	0	2	0	2	4
OG0020759	0	0	2	0	2	4
OG0020760	0	0	4	0	0	4
OG0020761	0	0	3	0	1	4
OG0020762	0	0	1	2	1	4
OG0020763	0	0	1	1	2	4
OG0020764	0	0	1	0	3	4
OG0020765	0	0	2	0	2	4
OG0020766	0	0	2	1	1	4
OG0020767	0	0	4	0	0	4
OG0020768	0	0	1	0	3	4
OG0020769	0	0	2	0	2	4
OG0020770	0	0	2	0	2	4
OG0020771	0	0	2	0	2	4
OG0020772	0	0	2	0	2	4
OG0020773	0	0	1	3	0	4
OG0020774	0	0	2	0	2	4
OG0020775	0	0	1	0	3	4
OG0020776	0	0	1	0	3	4
OG0020777	0	0	1	0	3	4
OG0020778	0	0	1	0	3	4
OG0020779	0	0	1	0	3	4
OG0020780	0	0	1	1	2	4
OG0020781	0	0	4	0	0	4
OG0020782	0	0	3	0	1	4
OG0020783	0	0	1	1	2	4
OG0020784	0	0	2	0	2	4
OG0020785	0	0	2	1	1	4
OG0020786	0	0	1	0	3	4
OG0020787	0	0	4	0	0	4
OG0020788	0	0	1	2	1	4
OG0020789	0	0	1	0	3	4
OG0020790	0	0	3	0	1	4
OG0020791	0	0	1	2	1	4
OG0020792	0	0	2	0	2	4
OG0020793	0	0	1	2	1	4
OG0020794	0	0	1	0	3	4
OG0020795	0	0	1	0	3	4
OG0020796	0	0	3	1	0	4
OG0020797	0	0	2	0	2	4
OG0020798	0	0	3	0	1	4
OG0020799	0	0	1	2	1	4
OG0020800	0	0	4	0	0	4
OG0020801	0	0	1	2	1	4
OG0020802	0	0	4	0	0	4
OG0020803	0	0	2	0	2	4
OG0020804	0	0	1	2	1	4
OG0020805	0	0	1	0	3	4
OG0020806	0	0	2	0	2	4
OG0020807	0	0	1	1	2	4
OG0020808	0	0	3	0	1	4
OG0020809	0	0	2	0	2	4
OG0020810	0	0	1	1	2	4
OG0020811	0	0	1	0	3	4
OG0020812	0	0	1	1	2	4
OG0020813	0	0	2	0	2	4
OG0020814	0	0	2	0	2	4
OG0020815	0	0	1	3	0	4
OG0020816	0	0	2	0	2	4
OG0020817	0	0	1	0	3	4
OG0020818	0	0	2	1	1	4
OG0020819	0	0	2	0	2	4
OG0020820	0	0	4	0	0	4
OG0020821	0	0	2	0	2	4
OG0020822	0	0	4	0	0	4
OG0020823	0	0	4	0	0	4
OG0020824	0	0	3	0	1	4
OG0020825	0	0	2	0	2	4
OG0020826	0	0	2	0	2	4
OG0020827	0	0	4	0	0	4
OG0020828	0	0	1	2	1	4
OG0020829	0	0	2	0	2	4
OG0020830	0	0	3	0	1	4
OG0020831	0	0	1	1	2	4
OG0020832	0	0	1	2	1	4
OG0020833	0	0	1	3	0	4
OG0020834	0	0	2	0	2	4
OG0020835	0	0	2	0	2	4
OG0020836	0	0	1	0	3	4
OG0020837	0	0	3	0	1	4
OG0020838	0	0	1	1	2	4
OG0020839	0	0	1	1	2	4
OG0020840	0	0	1	0	3	4
OG0020841	0	0	1	1	2	4
OG0020842	0	0	1	1	2	4
OG0020843	0	0	1	2	1	4
OG0020844	0	0	1	0	3	4
OG0020845	0	0	1	0	3	4
OG0020846	0	0	1	0	3	4
OG0020847	0	0	1	1	2	4
OG0020848	0	0	0	4	0	4
OG0020849	0	0	0	4	0	4
OG0020850	0	0	0	4	0	4
OG0020851	0	0	0	4	0	4
OG0020852	0	0	0	4	0	4
OG0020853	0	0	0	4	0	4
OG0020854	0	0	0	4	0	4
OG0020855	0	0	0	4	0	4
OG0020856	0	0	0	4	0	4
OG0020857	0	0	0	4	0	4
OG0020858	0	0	0	4	0	4
OG0020859	0	0	0	4	0	4
OG0020860	0	0	0	4	0	4
OG0020861	0	0	0	4	0	4
OG0020862	0	0	0	4	0	4
OG0020863	0	0	0	4	0	4
OG0020864	0	0	0	4	0	4
OG0020865	0	0	0	4	0	4
OG0020866	0	0	0	4	0	4
OG0020867	0	0	0	4	0	4
OG0020868	0	0	0	4	0	4
OG0020869	0	0	0	4	0	4
OG0020870	0	0	0	4	0	4
OG0020871	0	0	0	4	0	4
OG0020872	0	0	0	4	0	4
OG0020873	0	0	0	4	0	4
OG0020874	0	0	0	4	0	4
OG0020875	0	0	0	4	0	4
OG0020876	0	0	0	4	0	4
OG0020877	0	0	0	4	0	4
OG0020878	0	0	0	4	0	4
OG0020879	0	0	0	4	0	4
OG0020880	0	0	0	4	0	4
OG0020881	0	0	0	4	0	4
OG0020882	0	0	0	4	0	4
OG0020883	0	0	0	4	0	4
OG0020884	0	0	0	4	0	4
OG0020885	0	0	0	4	0	4
OG0020886	0	0	0	4	0	4
OG0020887	0	0	0	4	0	4
OG0020888	0	0	0	1	3	4
OG0020889	0	0	0	4	0	4
OG0020890	0	0	0	4	0	4
OG0020891	0	0	0	2	2	4
OG0020892	0	0	0	4	0	4
OG0020893	0	0	0	4	0	4
OG0020894	0	0	0	4	0	4
OG0020895	0	0	0	4	0	4
OG0020896	0	0	0	4	0	4
OG0020897	0	0	0	4	0	4
OG0020898	0	0	0	4	0	4
OG0020899	0	0	0	4	0	4
OG0020900	0	0	0	4	0	4
OG0020901	0	0	0	4	0	4
OG0020902	0	0	0	4	0	4
OG0020903	0	0	0	4	0	4
OG0020904	0	0	0	4	0	4
OG0020905	0	0	0	4	0	4
OG0020906	0	0	0	4	0	4
OG0020907	0	0	0	4	0	4
OG0020908	0	0	0	4	0	4
OG0020909	0	0	0	4	0	4
OG0020910	0	0	0	4	0	4
OG0020911	0	0	0	0	4	4
OG0020912	0	0	0	0	4	4
OG0020913	0	0	0	0	4	4
OG0020914	0	0	0	0	4	4
OG0020915	0	0	0	0	4	4
OG0020916	0	0	0	0	4	4
OG0020917	0	0	0	0	4	4
OG0020918	0	0	0	0	4	4
OG0020919	0	0	0	0	4	4
OG0020920	0	0	0	0	4	4
OG0020921	0	0	0	0	4	4
OG0020922	0	0	0	0	4	4
OG0020923	0	0	0	0	4	4
OG0020924	0	0	0	0	4	4
OG0020925	0	0	0	0	4	4
OG0020926	0	0	0	0	4	4
OG0020927	0	0	0	0	4	4
OG0020928	0	0	0	0	4	4
OG0020929	0	0	0	0	4	4
OG0020930	0	0	0	0	4	4
OG0020931	0	0	0	0	4	4
OG0020932	0	0	0	0	4	4
OG0020933	0	0	0	0	4	4
OG0020934	0	0	0	0	4	4
OG0020935	0	0	0	0	4	4
OG0020936	0	0	0	0	4	4
OG0020937	0	0	0	0	4	4
OG0020938	0	0	0	0	4	4
OG0020939	0	0	0	0	4	4
OG0020940	0	0	0	0	4	4
OG0020941	0	0	0	0	4	4
OG0020942	0	0	0	0	4	4
OG0020943	0	0	0	0	4	4
OG0020944	0	0	0	0	4	4
OG0020945	0	0	0	0	4	4
OG0020946	0	0	0	0	4	4
OG0020947	0	0	0	0	4	4
OG0020948	0	0	0	0	4	4
OG0020949	0	0	0	0	4	4
OG0020950	0	0	0	0	4	4
OG0020951	0	0	0	0	4	4
OG0020952	0	0	0	0	4	4
OG0020953	0	0	0	0	4	4
OG0020954	0	0	0	0	4	4
OG0020955	0	0	0	0	4	4
OG0020956	0	0	0	0	4	4
OG0020957	0	0	0	0	4	4
OG0020958	0	0	0	0	4	4
OG0020959	0	0	0	0	4	4
OG0020960	0	0	0	0	4	4
OG0020961	0	0	0	0	4	4
OG0020962	0	0	0	0	4	4
OG0020963	0	0	0	0	4	4
OG0020964	0	0	0	0	4	4
OG0020965	0	0	0	0	4	4
OG0020966	0	0	0	0	4	4
OG0020967	0	0	0	0	4	4
OG0020968	0	0	0	0	4	4
OG0020969	0	0	0	0	4	4
OG0020970	0	0	0	0	4	4
OG0020971	0	0	0	0	4	4
OG0020972	0	0	0	0	4	4
OG0020973	0	0	0	0	4	4
OG0020974	0	0	0	0	4	4
OG0020975	0	0	0	0	4	4
OG0020976	0	0	0	0	4	4
OG0020977	0	0	0	0	4	4
OG0020978	0	0	0	0	4	4
OG0020979	0	0	0	0	4	4
OG0020980	0	0	0	0	4	4
OG0020981	0	0	0	0	4	4
OG0020982	0	0	0	0	4	4
OG0020983	0	0	0	0	4	4
OG0020984	0	0	0	0	4	4
OG0020985	0	0	0	0	4	4
OG0020986	0	0	0	0	4	4
OG0020987	0	0	0	0	4	4
OG0020988	0	0	0	0	4	4
OG0020989	0	0	0	0	4	4
OG0020990	0	0	0	0	4	4
OG0020991	0	0	0	0	4	4
OG0020992	0	0	0	0	4	4
OG0020993	0	0	0	0	4	4
OG0020994	0	0	0	0	4	4
OG0020995	0	0	0	0	4	4
OG0020996	0	0	0	0	4	4
OG0020997	0	0	0	0	4	4
OG0020998	0	0	0	0	4	4
OG0020999	0	0	0	0	4	4
OG0021000	0	0	0	0	4	4
OG0021001	0	0	0	0	4	4
OG0021002	0	0	0	0	4	4
OG0021003	0	0	0	0	4	4
OG0021004	0	0	0	0	4	4
OG0021005	0	0	0	0	4	4
OG0021006	0	0	0	0	4	4
OG0021007	0	0	0	0	4	4
OG0021008	0	0	0	0	4	4
OG0021009	0	0	0	0	4	4
OG0021010	0	0	0	0	4	4
OG0021011	0	0	0	0	4	4
OG0021012	0	0	0	0	4	4
OG0021013	0	0	0	0	4	4
OG0021014	0	0	0	0	4	4
OG0021015	0	0	0	0	4	4
OG0021016	0	0	0	0	4	4
OG0021017	0	0	0	0	4	4
OG0021018	0	0	0	0	4	4
OG0021019	0	0	0	0	4	4
OG0021020	0	0	0	0	4	4
OG0021021	0	0	0	0	4	4
OG0021022	0	0	0	0	4	4
OG0021023	3	0	0	0	0	3
OG0021024	3	0	0	0	0	3
OG0021025	2	0	0	1	0	3
OG0021026	3	0	0	0	0	3
OG0021027	2	0	0	1	0	3
OG0021028	2	0	0	1	0	3
OG0021029	3	0	0	0	0	3
OG0021030	3	0	0	0	0	3
OG0021031	3	0	0	0	0	3
OG0021032	3	0	0	0	0	3
OG0021033	2	0	0	0	1	3
OG0021034	3	0	0	0	0	3
OG0021035	3	0	0	0	0	3
OG0021036	3	0	0	0	0	3
OG0021037	3	0	0	0	0	3
OG0021038	2	0	1	0	0	3
OG0021039	2	0	0	0	1	3
OG0021040	3	0	0	0	0	3
OG0021041	3	0	0	0	0	3
OG0021042	3	0	0	0	0	3
OG0021043	2	0	0	1	0	3
OG0021044	1	2	0	0	0	3
OG0021045	3	0	0	0	0	3
OG0021046	3	0	0	0	0	3
OG0021047	3	0	0	0	0	3
OG0021048	3	0	0	0	0	3
OG0021049	1	2	0	0	0	3
OG0021050	2	0	0	1	0	3
OG0021051	2	0	0	1	0	3
OG0021052	3	0	0	0	0	3
OG0021053	3	0	0	0	0	3
OG0021054	3	0	0	0	0	3
OG0021055	2	0	0	1	0	3
OG0021056	2	0	0	1	0	3
OG0021057	3	0	0	0	0	3
OG0021058	3	0	0	0	0	3
OG0021059	3	0	0	0	0	3
OG0021060	3	0	0	0	0	3
OG0021061	3	0	0	0	0	3
OG0021062	3	0	0	0	0	3
OG0021063	3	0	0	0	0	3
OG0021064	2	0	0	1	0	3
OG0021065	3	0	0	0	0	3
OG0021066	3	0	0	0	0	3
OG0021067	3	0	0	0	0	3
OG0021068	3	0	0	0	0	3
OG0021069	3	0	0	0	0	3
OG0021070	3	0	0	0	0	3
OG0021071	2	1	0	0	0	3
OG0021072	3	0	0	0	0	3
OG0021073	3	0	0	0	0	3
OG0021074	2	0	1	0	0	3
OG0021075	3	0	0	0	0	3
OG0021076	3	0	0	0	0	3
OG0021077	3	0	0	0	0	3
OG0021078	3	0	0	0	0	3
OG0021079	3	0	0	0	0	3
OG0021080	3	0	0	0	0	3
OG0021081	3	0	0	0	0	3
OG0021082	3	0	0	0	0	3
OG0021083	3	0	0	0	0	3
OG0021084	3	0	0	0	0	3
OG0021085	2	0	0	1	0	3
OG0021086	2	0	0	1	0	3
OG0021087	3	0	0	0	0	3
OG0021088	3	0	0	0	0	3
OG0021089	3	0	0	0	0	3
OG0021090	2	0	0	1	0	3
OG0021091	3	0	0	0	0	3
OG0021092	2	0	0	1	0	3
OG0021093	3	0	0	0	0	3
OG0021094	3	0	0	0	0	3
OG0021095	3	0	0	0	0	3
OG0021096	3	0	0	0	0	3
OG0021097	2	0	0	0	1	3
OG0021098	2	0	0	1	0	3
OG0021099	3	0	0	0	0	3
OG0021100	2	0	0	1	0	3
OG0021101	2	0	0	1	0	3
OG0021102	2	0	1	0	0	3
OG0021103	3	0	0	0	0	3
OG0021104	3	0	0	0	0	3
OG0021105	2	0	0	1	0	3
OG0021106	2	0	0	1	0	3
OG0021107	3	0	0	0	0	3
OG0021108	3	0	0	0	0	3
OG0021109	1	1	0	0	1	3
OG0021110	1	2	0	0	0	3
OG0021111	3	0	0	0	0	3
OG0021112	3	0	0	0	0	3
OG0021113	1	1	1	0	0	3
OG0021114	3	0	0	0	0	3
OG0021115	3	0	0	0	0	3
OG0021116	3	0	0	0	0	3
OG0021117	3	0	0	0	0	3
OG0021118	3	0	0	0	0	3
OG0021119	3	0	0	0	0	3
OG0021120	3	0	0	0	0	3
OG0021121	3	0	0	0	0	3
OG0021122	2	0	0	1	0	3
OG0021123	3	0	0	0	0	3
OG0021124	1	0	0	1	1	3
OG0021125	2	0	0	1	0	3
OG0021126	3	0	0	0	0	3
OG0021127	2	0	0	1	0	3
OG0021128	3	0	0	0	0	3
OG0021129	3	0	0	0	0	3
OG0021130	3	0	0	0	0	3
OG0021131	1	0	0	1	1	3
OG0021132	2	0	0	1	0	3
OG0021133	3	0	0	0	0	3
OG0021134	2	0	0	1	0	3
OG0021135	2	0	0	1	0	3
OG0021136	3	0	0	0	0	3
OG0021137	3	0	0	0	0	3
OG0021138	1	0	1	0	1	3
OG0021139	3	0	0	0	0	3
OG0021140	3	0	0	0	0	3
OG0021141	3	0	0	0	0	3
OG0021142	3	0	0	0	0	3
OG0021143	3	0	0	0	0	3
OG0021144	3	0	0	0	0	3
OG0021145	3	0	0	0	0	3
OG0021146	3	0	0	0	0	3
OG0021147	3	0	0	0	0	3
OG0021148	3	0	0	0	0	3
OG0021149	3	0	0	0	0	3
OG0021150	1	0	2	0	0	3
OG0021151	3	0	0	0	0	3
OG0021152	2	0	0	1	0	3
OG0021153	1	0	2	0	0	3
OG0021154	3	0	0	0	0	3
OG0021155	3	0	0	0	0	3
OG0021156	3	0	0	0	0	3
OG0021157	2	1	0	0	0	3
OG0021158	3	0	0	0	0	3
OG0021159	3	0	0	0	0	3
OG0021160	1	2	0	0	0	3
OG0021161	3	0	0	0	0	3
OG0021162	2	0	0	1	0	3
OG0021163	3	0	0	0	0	3
OG0021164	3	0	0	0	0	3
OG0021165	2	0	0	1	0	3
OG0021166	3	0	0	0	0	3
OG0021167	3	0	0	0	0	3
OG0021168	2	0	0	1	0	3
OG0021169	3	0	0	0	0	3
OG0021170	3	0	0	0	0	3
OG0021171	3	0	0	0	0	3
OG0021172	3	0	0	0	0	3
OG0021173	3	0	0	0	0	3
OG0021174	2	0	0	1	0	3
OG0021175	3	0	0	0	0	3
OG0021176	3	0	0	0	0	3
OG0021177	3	0	0	0	0	3
OG0021178	3	0	0	0	0	3
OG0021179	3	0	0	0	0	3
OG0021180	3	0	0	0	0	3
OG0021181	3	0	0	0	0	3
OG0021182	3	0	0	0	0	3
OG0021183	3	0	0	0	0	3
OG0021184	3	0	0	0	0	3
OG0021185	3	0	0	0	0	3
OG0021186	3	0	0	0	0	3
OG0021187	3	0	0	0	0	3
OG0021188	2	0	0	1	0	3
OG0021189	3	0	0	0	0	3
OG0021190	3	0	0	0	0	3
OG0021191	2	1	0	0	0	3
OG0021192	3	0	0	0	0	3
OG0021193	2	0	0	0	1	3
OG0021194	3	0	0	0	0	3
OG0021195	3	0	0	0	0	3
OG0021196	3	0	0	0	0	3
OG0021197	3	0	0	0	0	3
OG0021198	2	0	0	1	0	3
OG0021199	3	0	0	0	0	3
OG0021200	3	0	0	0	0	3
OG0021201	3	0	0	0	0	3
OG0021202	2	0	0	1	0	3
OG0021203	2	0	0	1	0	3
OG0021204	2	0	0	1	0	3
OG0021205	2	0	1	0	0	3
OG0021206	3	0	0	0	0	3
OG0021207	3	0	0	0	0	3
OG0021208	3	0	0	0	0	3
OG0021209	3	0	0	0	0	3
OG0021210	3	0	0	0	0	3
OG0021211	3	0	0	0	0	3
OG0021212	3	0	0	0	0	3
OG0021213	3	0	0	0	0	3
OG0021214	2	0	0	1	0	3
OG0021215	3	0	0	0	0	3
OG0021216	1	0	1	0	1	3
OG0021217	3	0	0	0	0	3
OG0021218	2	0	0	1	0	3
OG0021219	3	0	0	0	0	3
OG0021220	2	0	0	1	0	3
OG0021221	3	0	0	0	0	3
OG0021222	3	0	0	0	0	3
OG0021223	3	0	0	0	0	3
OG0021224	3	0	0	0	0	3
OG0021225	2	0	0	1	0	3
OG0021226	2	0	0	1	0	3
OG0021227	2	0	0	1	0	3
OG0021228	3	0	0	0	0	3
OG0021229	3	0	0	0	0	3
OG0021230	3	0	0	0	0	3
OG0021231	3	0	0	0	0	3
OG0021232	2	1	0	0	0	3
OG0021233	2	0	0	1	0	3
OG0021234	2	0	1	0	0	3
OG0021235	3	0	0	0	0	3
OG0021236	3	0	0	0	0	3
OG0021237	3	0	0	0	0	3
OG0021238	3	0	0	0	0	3
OG0021239	1	1	1	0	0	3
OG0021240	3	0	0	0	0	3
OG0021241	2	0	0	1	0	3
OG0021242	3	0	0	0	0	3
OG0021243	3	0	0	0	0	3
OG0021244	2	0	0	1	0	3
OG0021245	3	0	0	0	0	3
OG0021246	2	0	0	1	0	3
OG0021247	2	1	0	0	0	3
OG0021248	3	0	0	0	0	3
OG0021249	3	0	0	0	0	3
OG0021250	2	0	0	1	0	3
OG0021251	3	0	0	0	0	3
OG0021252	3	0	0	0	0	3
OG0021253	3	0	0	0	0	3
OG0021254	2	0	0	1	0	3
OG0021255	2	0	0	1	0	3
OG0021256	2	0	0	1	0	3
OG0021257	3	0	0	0	0	3
OG0021258	3	0	0	0	0	3
OG0021259	2	0	0	1	0	3
OG0021260	2	0	0	1	0	3
OG0021261	3	0	0	0	0	3
OG0021262	3	0	0	0	0	3
OG0021263	3	0	0	0	0	3
OG0021264	3	0	0	0	0	3
OG0021265	2	0	0	1	0	3
OG0021266	3	0	0	0	0	3
OG0021267	3	0	0	0	0	3
OG0021268	3	0	0	0	0	3
OG0021269	2	0	0	0	1	3
OG0021270	3	0	0	0	0	3
OG0021271	2	1	0	0	0	3
OG0021272	2	1	0	0	0	3
OG0021273	3	0	0	0	0	3
OG0021274	3	0	0	0	0	3
OG0021275	3	0	0	0	0	3
OG0021276	3	0	0	0	0	3
OG0021277	3	0	0	0	0	3
OG0021278	3	0	0	0	0	3
OG0021279	3	0	0	0	0	3
OG0021280	2	0	0	1	0	3
OG0021281	3	0	0	0	0	3
OG0021282	2	0	0	1	0	3
OG0021283	3	0	0	0	0	3
OG0021284	3	0	0	0	0	3
OG0021285	3	0	0	0	0	3
OG0021286	3	0	0	0	0	3
OG0021287	2	0	0	1	0	3
OG0021288	3	0	0	0	0	3
OG0021289	3	0	0	0	0	3
OG0021290	3	0	0	0	0	3
OG0021291	3	0	0	0	0	3
OG0021292	2	0	0	1	0	3
OG0021293	2	0	0	1	0	3
OG0021294	3	0	0	0	0	3
OG0021295	3	0	0	0	0	3
OG0021296	3	0	0	0	0	3
OG0021297	3	0	0	0	0	3
OG0021298	3	0	0	0	0	3
OG0021299	3	0	0	0	0	3
OG0021300	3	0	0	0	0	3
OG0021301	3	0	0	0	0	3
OG0021302	3	0	0	0	0	3
OG0021303	2	0	0	1	0	3
OG0021304	3	0	0	0	0	3
OG0021305	2	0	0	0	1	3
OG0021306	2	0	0	1	0	3
OG0021307	3	0	0	0	0	3
OG0021308	2	0	0	1	0	3
OG0021309	2	1	0	0	0	3
OG0021310	2	0	0	1	0	3
OG0021311	3	0	0	0	0	3
OG0021312	3	0	0	0	0	3
OG0021313	2	0	0	1	0	3
OG0021314	3	0	0	0	0	3
OG0021315	3	0	0	0	0	3
OG0021316	1	0	2	0	0	3
OG0021317	2	0	0	1	0	3
OG0021318	3	0	0	0	0	3
OG0021319	3	0	0	0	0	3
OG0021320	3	0	0	0	0	3
OG0021321	2	0	0	1	0	3
OG0021322	3	0	0	0	0	3
OG0021323	3	0	0	0	0	3
OG0021324	3	0	0	0	0	3
OG0021325	3	0	0	0	0	3
OG0021326	2	1	0	0	0	3
OG0021327	3	0	0	0	0	3
OG0021328	3	0	0	0	0	3
OG0021329	3	0	0	0	0	3
OG0021330	2	1	0	0	0	3
OG0021331	3	0	0	0	0	3
OG0021332	2	0	0	1	0	3
OG0021333	3	0	0	0	0	3
OG0021334	2	0	0	1	0	3
OG0021335	1	0	0	2	0	3
OG0021336	2	0	0	1	0	3
OG0021337	2	0	0	1	0	3
OG0021338	3	0	0	0	0	3
OG0021339	2	0	0	0	1	3
OG0021340	2	0	0	1	0	3
OG0021341	3	0	0	0	0	3
OG0021342	3	0	0	0	0	3
OG0021343	3	0	0	0	0	3
OG0021344	3	0	0	0	0	3
OG0021345	2	0	0	1	0	3
OG0021346	2	0	0	1	0	3
OG0021347	3	0	0	0	0	3
OG0021348	3	0	0	0	0	3
OG0021349	3	0	0	0	0	3
OG0021350	2	0	0	1	0	3
OG0021351	2	0	0	1	0	3
OG0021352	2	0	0	1	0	3
OG0021353	3	0	0	0	0	3
OG0021354	3	0	0	0	0	3
OG0021355	1	0	1	0	1	3
OG0021356	2	0	0	1	0	3
OG0021357	2	0	0	1	0	3
OG0021358	3	0	0	0	0	3
OG0021359	3	0	0	0	0	3
OG0021360	3	0	0	0	0	3
OG0021361	2	0	0	1	0	3
OG0021362	3	0	0	0	0	3
OG0021363	1	0	1	1	0	3
OG0021364	3	0	0	0	0	3
OG0021365	3	0	0	0	0	3
OG0021366	2	0	0	1	0	3
OG0021367	3	0	0	0	0	3
OG0021368	3	0	0	0	0	3
OG0021369	3	0	0	0	0	3
OG0021370	3	0	0	0	0	3
OG0021371	2	1	0	0	0	3
OG0021372	3	0	0	0	0	3
OG0021373	3	0	0	0	0	3
OG0021374	1	1	1	0	0	3
OG0021375	3	0	0	0	0	3
OG0021376	3	0	0	0	0	3
OG0021377	3	0	0	0	0	3
OG0021378	2	0	0	1	0	3
OG0021379	3	0	0	0	0	3
OG0021380	3	0	0	0	0	3
OG0021381	3	0	0	0	0	3
OG0021382	3	0	0	0	0	3
OG0021383	3	0	0	0	0	3
OG0021384	3	0	0	0	0	3
OG0021385	3	0	0	0	0	3
OG0021386	3	0	0	0	0	3
OG0021387	1	2	0	0	0	3
OG0021388	2	0	0	1	0	3
OG0021389	2	0	0	0	1	3
OG0021390	2	0	0	1	0	3
OG0021391	2	0	0	1	0	3
OG0021392	2	0	0	1	0	3
OG0021393	1	2	0	0	0	3
OG0021394	3	0	0	0	0	3
OG0021395	2	0	0	1	0	3
OG0021396	3	0	0	0	0	3
OG0021397	3	0	0	0	0	3
OG0021398	3	0	0	0	0	3
OG0021399	3	0	0	0	0	3
OG0021400	3	0	0	0	0	3
OG0021401	3	0	0	0	0	3
OG0021402	3	0	0	0	0	3
OG0021403	2	0	0	1	0	3
OG0021404	1	1	1	0	0	3
OG0021405	2	0	0	1	0	3
OG0021406	2	0	1	0	0	3
OG0021407	2	0	0	1	0	3
OG0021408	3	0	0	0	0	3
OG0021409	2	0	0	1	0	3
OG0021410	3	0	0	0	0	3
OG0021411	2	0	0	1	0	3
OG0021412	1	0	1	0	1	3
OG0021413	3	0	0	0	0	3
OG0021414	2	0	0	1	0	3
OG0021415	3	0	0	0	0	3
OG0021416	1	0	0	0	2	3
OG0021417	3	0	0	0	0	3
OG0021418	3	0	0	0	0	3
OG0021419	3	0	0	0	0	3
OG0021420	2	0	0	1	0	3
OG0021421	3	0	0	0	0	3
OG0021422	2	1	0	0	0	3
OG0021423	3	0	0	0	0	3
OG0021424	2	0	0	0	1	3
OG0021425	3	0	0	0	0	3
OG0021426	2	0	1	0	0	3
OG0021427	2	0	0	1	0	3
OG0021428	2	1	0	0	0	3
OG0021429	2	0	1	0	0	3
OG0021430	3	0	0	0	0	3
OG0021431	3	0	0	0	0	3
OG0021432	3	0	0	0	0	3
OG0021433	2	0	0	1	0	3
OG0021434	2	0	0	1	0	3
OG0021435	2	0	1	0	0	3
OG0021436	3	0	0	0	0	3
OG0021437	3	0	0	0	0	3
OG0021438	2	0	0	1	0	3
OG0021439	2	0	0	1	0	3
OG0021440	3	0	0	0	0	3
OG0021441	3	0	0	0	0	3
OG0021442	3	0	0	0	0	3
OG0021443	1	0	2	0	0	3
OG0021444	3	0	0	0	0	3
OG0021445	2	0	0	1	0	3
OG0021446	3	0	0	0	0	3
OG0021447	2	0	1	0	0	3
OG0021448	2	0	1	0	0	3
OG0021449	2	0	0	1	0	3
OG0021450	1	2	0	0	0	3
OG0021451	3	0	0	0	0	3
OG0021452	2	0	0	1	0	3
OG0021453	3	0	0	0	0	3
OG0021454	3	0	0	0	0	3
OG0021455	3	0	0	0	0	3
OG0021456	3	0	0	0	0	3
OG0021457	3	0	0	0	0	3
OG0021458	3	0	0	0	0	3
OG0021459	2	0	0	1	0	3
OG0021460	2	0	0	1	0	3
OG0021461	2	0	0	1	0	3
OG0021462	2	1	0	0	0	3
OG0021463	3	0	0	0	0	3
OG0021464	2	0	0	1	0	3
OG0021465	3	0	0	0	0	3
OG0021466	2	0	0	1	0	3
OG0021467	1	0	0	2	0	3
OG0021468	2	0	0	1	0	3
OG0021469	3	0	0	0	0	3
OG0021470	3	0	0	0	0	3
OG0021471	3	0	0	0	0	3
OG0021472	3	0	0	0	0	3
OG0021473	2	0	0	1	0	3
OG0021474	2	1	0	0	0	3
OG0021475	2	0	0	1	0	3
OG0021476	2	0	0	1	0	3
OG0021477	3	0	0	0	0	3
OG0021478	3	0	0	0	0	3
OG0021479	2	0	0	1	0	3
OG0021480	1	2	0	0	0	3
OG0021481	3	0	0	0	0	3
OG0021482	3	0	0	0	0	3
OG0021483	2	0	0	1	0	3
OG0021484	3	0	0	0	0	3
OG0021485	3	0	0	0	0	3
OG0021486	3	0	0	0	0	3
OG0021487	2	0	0	1	0	3
OG0021488	2	0	0	1	0	3
OG0021489	3	0	0	0	0	3
OG0021490	2	0	1	0	0	3
OG0021491	2	0	0	1	0	3
OG0021492	2	0	0	1	0	3
OG0021493	3	0	0	0	0	3
OG0021494	3	0	0	0	0	3
OG0021495	3	0	0	0	0	3
OG0021496	3	0	0	0	0	3
OG0021497	2	0	0	1	0	3
OG0021498	3	0	0	0	0	3
OG0021499	3	0	0	0	0	3
OG0021500	3	0	0	0	0	3
OG0021501	2	0	0	1	0	3
OG0021502	2	0	0	1	0	3
OG0021503	3	0	0	0	0	3
OG0021504	3	0	0	0	0	3
OG0021505	3	0	0	0	0	3
OG0021506	3	0	0	0	0	3
OG0021507	2	1	0	0	0	3
OG0021508	3	0	0	0	0	3
OG0021509	3	0	0	0	0	3
OG0021510	3	0	0	0	0	3
OG0021511	2	0	1	0	0	3
OG0021512	3	0	0	0	0	3
OG0021513	2	0	0	0	1	3
OG0021514	3	0	0	0	0	3
OG0021515	3	0	0	0	0	3
OG0021516	1	2	0	0	0	3
OG0021517	2	0	1	0	0	3
OG0021518	3	0	0	0	0	3
OG0021519	3	0	0	0	0	3
OG0021520	3	0	0	0	0	3
OG0021521	3	0	0	0	0	3
OG0021522	2	0	0	1	0	3
OG0021523	3	0	0	0	0	3
OG0021524	3	0	0	0	0	3
OG0021525	2	0	0	1	0	3
OG0021526	3	0	0	0	0	3
OG0021527	3	0	0	0	0	3
OG0021528	3	0	0	0	0	3
OG0021529	3	0	0	0	0	3
OG0021530	3	0	0	0	0	3
OG0021531	2	0	0	1	0	3
OG0021532	3	0	0	0	0	3
OG0021533	3	0	0	0	0	3
OG0021534	2	1	0	0	0	3
OG0021535	3	0	0	0	0	3
OG0021536	3	0	0	0	0	3
OG0021537	2	0	0	1	0	3
OG0021538	3	0	0	0	0	3
OG0021539	3	0	0	0	0	3
OG0021540	2	0	1	0	0	3
OG0021541	3	0	0	0	0	3
OG0021542	2	0	0	1	0	3
OG0021543	2	0	0	1	0	3
OG0021544	2	0	0	1	0	3
OG0021545	3	0	0	0	0	3
OG0021546	2	0	0	0	1	3
OG0021547	2	0	1	0	0	3
OG0021548	2	0	0	1	0	3
OG0021549	2	1	0	0	0	3
OG0021550	3	0	0	0	0	3
OG0021551	3	0	0	0	0	3
OG0021552	1	1	1	0	0	3
OG0021553	3	0	0	0	0	3
OG0021554	3	0	0	0	0	3
OG0021555	3	0	0	0	0	3
OG0021556	2	0	0	1	0	3
OG0021557	3	0	0	0	0	3
OG0021558	2	0	0	1	0	3
OG0021559	2	0	0	1	0	3
OG0021560	2	0	0	1	0	3
OG0021561	3	0	0	0	0	3
OG0021562	3	0	0	0	0	3
OG0021563	2	1	0	0	0	3
OG0021564	3	0	0	0	0	3
OG0021565	3	0	0	0	0	3
OG0021566	2	0	1	0	0	3
OG0021567	2	0	0	0	1	3
OG0021568	2	0	0	1	0	3
OG0021569	2	0	0	1	0	3
OG0021570	2	0	1	0	0	3
OG0021571	2	0	0	1	0	3
OG0021572	2	0	0	1	0	3
OG0021573	3	0	0	0	0	3
OG0021574	2	1	0	0	0	3
OG0021575	1	2	0	0	0	3
OG0021576	3	0	0	0	0	3
OG0021577	3	0	0	0	0	3
OG0021578	3	0	0	0	0	3
OG0021579	2	0	0	1	0	3
OG0021580	2	0	0	1	0	3
OG0021581	3	0	0	0	0	3
OG0021582	3	0	0	0	0	3
OG0021583	3	0	0	0	0	3
OG0021584	3	0	0	0	0	3
OG0021585	3	0	0	0	0	3
OG0021586	1	2	0	0	0	3
OG0021587	2	0	0	1	0	3
OG0021588	3	0	0	0	0	3
OG0021589	3	0	0	0	0	3
OG0021590	2	0	0	1	0	3
OG0021591	3	0	0	0	0	3
OG0021592	2	0	0	1	0	3
OG0021593	2	0	0	1	0	3
OG0021594	2	0	0	1	0	3
OG0021595	2	0	0	1	0	3
OG0021596	2	1	0	0	0	3
OG0021597	2	0	0	0	1	3
OG0021598	2	0	0	1	0	3
OG0021599	2	0	0	1	0	3
OG0021600	2	0	0	1	0	3
OG0021601	3	0	0	0	0	3
OG0021602	3	0	0	0	0	3
OG0021603	1	2	0	0	0	3
OG0021604	3	0	0	0	0	3
OG0021605	2	0	1	0	0	3
OG0021606	3	0	0	0	0	3
OG0021607	2	0	0	1	0	3
OG0021608	3	0	0	0	0	3
OG0021609	1	2	0	0	0	3
OG0021610	2	0	0	1	0	3
OG0021611	3	0	0	0	0	3
OG0021612	3	0	0	0	0	3
OG0021613	3	0	0	0	0	3
OG0021614	2	0	0	1	0	3
OG0021615	1	0	2	0	0	3
OG0021616	3	0	0	0	0	3
OG0021617	2	0	0	1	0	3
OG0021618	3	0	0	0	0	3
OG0021619	3	0	0	0	0	3
OG0021620	3	0	0	0	0	3
OG0021621	2	0	1	0	0	3
OG0021622	2	0	0	1	0	3
OG0021623	2	1	0	0	0	3
OG0021624	2	0	0	1	0	3
OG0021625	1	1	0	1	0	3
OG0021626	2	0	0	0	1	3
OG0021627	3	0	0	0	0	3
OG0021628	2	0	0	1	0	3
OG0021629	3	0	0	0	0	3
OG0021630	3	0	0	0	0	3
OG0021631	3	0	0	0	0	3
OG0021632	3	0	0	0	0	3
OG0021633	3	0	0	0	0	3
OG0021634	3	0	0	0	0	3
OG0021635	2	0	0	1	0	3
OG0021636	2	0	0	1	0	3
OG0021637	2	0	0	1	0	3
OG0021638	3	0	0	0	0	3
OG0021639	1	0	0	2	0	3
OG0021640	2	0	0	1	0	3
OG0021641	2	0	0	1	0	3
OG0021642	2	0	1	0	0	3
OG0021643	2	0	0	1	0	3
OG0021644	3	0	0	0	0	3
OG0021645	3	0	0	0	0	3
OG0021646	2	0	0	1	0	3
OG0021647	3	0	0	0	0	3
OG0021648	3	0	0	0	0	3
OG0021649	2	0	0	1	0	3
OG0021650	3	0	0	0	0	3
OG0021651	1	0	1	0	1	3
OG0021652	2	0	0	0	1	3
OG0021653	3	0	0	0	0	3
OG0021654	3	0	0	0	0	3
OG0021655	3	0	0	0	0	3
OG0021656	3	0	0	0	0	3
OG0021657	3	0	0	0	0	3
OG0021658	2	0	0	1	0	3
OG0021659	2	0	0	1	0	3
OG0021660	3	0	0	0	0	3
OG0021661	3	0	0	0	0	3
OG0021662	2	0	1	0	0	3
OG0021663	2	0	0	1	0	3
OG0021664	2	0	0	0	1	3
OG0021665	2	0	0	1	0	3
OG0021666	2	0	0	1	0	3
OG0021667	3	0	0	0	0	3
OG0021668	3	0	0	0	0	3
OG0021669	2	0	0	1	0	3
OG0021670	3	0	0	0	0	3
OG0021671	3	0	0	0	0	3
OG0021672	2	0	0	1	0	3
OG0021673	3	0	0	0	0	3
OG0021674	3	0	0	0	0	3
OG0021675	2	0	0	1	0	3
OG0021676	3	0	0	0	0	3
OG0021677	2	0	0	0	1	3
OG0021678	2	0	0	1	0	3
OG0021679	2	0	0	1	0	3
OG0021680	3	0	0	0	0	3
OG0021681	3	0	0	0	0	3
OG0021682	3	0	0	0	0	3
OG0021683	2	0	0	1	0	3
OG0021684	2	0	0	1	0	3
OG0021685	3	0	0	0	0	3
OG0021686	2	0	0	1	0	3
OG0021687	3	0	0	0	0	3
OG0021688	3	0	0	0	0	3
OG0021689	3	0	0	0	0	3
OG0021690	2	0	0	1	0	3
OG0021691	3	0	0	0	0	3
OG0021692	2	0	0	1	0	3
OG0021693	1	0	0	1	1	3
OG0021694	3	0	0	0	0	3
OG0021695	1	0	2	0	0	3
OG0021696	3	0	0	0	0	3
OG0021697	1	0	0	1	1	3
OG0021698	3	0	0	0	0	3
OG0021699	2	0	0	1	0	3
OG0021700	1	1	1	0	0	3
OG0021701	2	1	0	0	0	3
OG0021702	3	0	0	0	0	3
OG0021703	1	0	0	1	1	3
OG0021704	1	0	0	1	1	3
OG0021705	2	0	0	1	0	3
OG0021706	3	0	0	0	0	3
OG0021707	3	0	0	0	0	3
OG0021708	2	0	0	1	0	3
OG0021709	2	0	0	1	0	3
OG0021710	2	0	1	0	0	3
OG0021711	2	0	0	1	0	3
OG0021712	3	0	0	0	0	3
OG0021713	3	0	0	0	0	3
OG0021714	2	0	1	0	0	3
OG0021715	2	0	0	1	0	3
OG0021716	3	0	0	0	0	3
OG0021717	2	0	0	1	0	3
OG0021718	3	0	0	0	0	3
OG0021719	2	0	0	1	0	3
OG0021720	2	0	0	1	0	3
OG0021721	3	0	0	0	0	3
OG0021722	1	2	0	0	0	3
OG0021723	1	0	0	2	0	3
OG0021724	3	0	0	0	0	3
OG0021725	3	0	0	0	0	3
OG0021726	3	0	0	0	0	3
OG0021727	3	0	0	0	0	3
OG0021728	3	0	0	0	0	3
OG0021729	3	0	0	0	0	3
OG0021730	1	0	0	2	0	3
OG0021731	3	0	0	0	0	3
OG0021732	3	0	0	0	0	3
OG0021733	2	1	0	0	0	3
OG0021734	3	0	0	0	0	3
OG0021735	3	0	0	0	0	3
OG0021736	1	0	1	1	0	3
OG0021737	3	0	0	0	0	3
OG0021738	3	0	0	0	0	3
OG0021739	3	0	0	0	0	3
OG0021740	3	0	0	0	0	3
OG0021741	3	0	0	0	0	3
OG0021742	1	2	0	0	0	3
OG0021743	3	0	0	0	0	3
OG0021744	2	0	0	1	0	3
OG0021745	2	0	0	1	0	3
OG0021746	2	0	0	1	0	3
OG0021747	2	0	0	1	0	3
OG0021748	1	2	0	0	0	3
OG0021749	1	0	1	0	1	3
OG0021750	3	0	0	0	0	3
OG0021751	2	0	0	1	0	3
OG0021752	3	0	0	0	0	3
OG0021753	1	0	2	0	0	3
OG0021754	3	0	0	0	0	3
OG0021755	3	0	0	0	0	3
OG0021756	3	0	0	0	0	3
OG0021757	2	1	0	0	0	3
OG0021758	3	0	0	0	0	3
OG0021759	3	0	0	0	0	3
OG0021760	1	2	0	0	0	3
OG0021761	2	0	0	0	1	3
OG0021762	2	0	0	1	0	3
OG0021763	2	0	0	1	0	3
OG0021764	3	0	0	0	0	3
OG0021765	3	0	0	0	0	3
OG0021766	3	0	0	0	0	3
OG0021767	3	0	0	0	0	3
OG0021768	3	0	0	0	0	3
OG0021769	2	0	0	1	0	3
OG0021770	3	0	0	0	0	3
OG0021771	2	0	0	1	0	3
OG0021772	3	0	0	0	0	3
OG0021773	2	0	0	1	0	3
OG0021774	3	0	0	0	0	3
OG0021775	2	0	0	1	0	3
OG0021776	2	0	0	1	0	3
OG0021777	2	0	0	1	0	3
OG0021778	3	0	0	0	0	3
OG0021779	3	0	0	0	0	3
OG0021780	3	0	0	0	0	3
OG0021781	3	0	0	0	0	3
OG0021782	3	0	0	0	0	3
OG0021783	3	0	0	0	0	3
OG0021784	2	0	0	0	1	3
OG0021785	2	0	0	1	0	3
OG0021786	3	0	0	0	0	3
OG0021787	2	0	0	1	0	3
OG0021788	3	0	0	0	0	3
OG0021789	3	0	0	0	0	3
OG0021790	2	1	0	0	0	3
OG0021791	2	0	0	1	0	3
OG0021792	2	1	0	0	0	3
OG0021793	3	0	0	0	0	3
OG0021794	3	0	0	0	0	3
OG0021795	1	0	1	0	1	3
OG0021796	3	0	0	0	0	3
OG0021797	2	0	0	1	0	3
OG0021798	3	0	0	0	0	3
OG0021799	3	0	0	0	0	3
OG0021800	3	0	0	0	0	3
OG0021801	2	0	0	0	1	3
OG0021802	3	0	0	0	0	3
OG0021803	3	0	0	0	0	3
OG0021804	2	0	0	1	0	3
OG0021805	2	0	0	1	0	3
OG0021806	3	0	0	0	0	3
OG0021807	3	0	0	0	0	3
OG0021808	3	0	0	0	0	3
OG0021809	3	0	0	0	0	3
OG0021810	2	0	0	1	0	3
OG0021811	2	0	0	1	0	3
OG0021812	2	0	0	1	0	3
OG0021813	2	0	0	1	0	3
OG0021814	2	0	0	1	0	3
OG0021815	3	0	0	0	0	3
OG0021816	2	1	0	0	0	3
OG0021817	2	0	0	0	1	3
OG0021818	2	1	0	0	0	3
OG0021819	2	0	0	1	0	3
OG0021820	3	0	0	0	0	3
OG0021821	2	0	0	1	0	3
OG0021822	2	1	0	0	0	3
OG0021823	3	0	0	0	0	3
OG0021824	3	0	0	0	0	3
OG0021825	1	1	1	0	0	3
OG0021826	3	0	0	0	0	3
OG0021827	1	1	1	0	0	3
OG0021828	3	0	0	0	0	3
OG0021829	1	1	0	1	0	3
OG0021830	1	0	2	0	0	3
OG0021831	3	0	0	0	0	3
OG0021832	2	0	0	1	0	3
OG0021833	1	0	0	2	0	3
OG0021834	1	0	0	0	2	3
OG0021835	3	0	0	0	0	3
OG0021836	3	0	0	0	0	3
OG0021837	1	0	2	0	0	3
OG0021838	2	0	1	0	0	3
OG0021839	3	0	0	0	0	3
OG0021840	1	2	0	0	0	3
OG0021841	3	0	0	0	0	3
OG0021842	2	0	0	1	0	3
OG0021843	2	0	1	0	0	3
OG0021844	2	0	0	1	0	3
OG0021845	2	0	0	1	0	3
OG0021846	2	0	0	1	0	3
OG0021847	2	0	0	1	0	3
OG0021848	2	0	0	1	0	3
OG0021849	2	0	0	1	0	3
OG0021850	2	0	1	0	0	3
OG0021851	2	0	0	1	0	3
OG0021852	3	0	0	0	0	3
OG0021853	2	0	0	1	0	3
OG0021854	3	0	0	0	0	3
OG0021855	1	0	0	1	1	3
OG0021856	2	0	0	0	1	3
OG0021857	1	0	2	0	0	3
OG0021858	3	0	0	0	0	3
OG0021859	2	0	0	1	0	3
OG0021860	1	0	0	1	1	3
OG0021861	2	0	0	1	0	3
OG0021862	3	0	0	0	0	3
OG0021863	2	1	0	0	0	3
OG0021864	1	1	1	0	0	3
OG0021865	2	0	0	1	0	3
OG0021866	1	2	0	0	0	3
OG0021867	2	0	0	1	0	3
OG0021868	3	0	0	0	0	3
OG0021869	3	0	0	0	0	3
OG0021870	1	0	0	0	2	3
OG0021871	1	0	0	1	1	3
OG0021872	2	0	0	1	0	3
OG0021873	1	0	2	0	0	3
OG0021874	3	0	0	0	0	3
OG0021875	1	0	0	2	0	3
OG0021876	1	2	0	0	0	3
OG0021877	3	0	0	0	0	3
OG0021878	3	0	0	0	0	3
OG0021879	3	0	0	0	0	3
OG0021880	3	0	0	0	0	3
OG0021881	3	0	0	0	0	3
OG0021882	2	0	1	0	0	3
OG0021883	3	0	0	0	0	3
OG0021884	2	0	0	0	1	3
OG0021885	2	0	0	0	1	3
OG0021886	3	0	0	0	0	3
OG0021887	2	0	1	0	0	3
OG0021888	3	0	0	0	0	3
OG0021889	3	0	0	0	0	3
OG0021890	1	0	1	0	1	3
OG0021891	1	0	1	0	1	3
OG0021892	2	1	0	0	0	3
OG0021893	2	1	0	0	0	3
OG0021894	1	0	0	1	1	3
OG0021895	3	0	0	0	0	3
OG0021896	2	0	0	0	1	3
OG0021897	1	1	0	1	0	3
OG0021898	1	1	1	0	0	3
OG0021899	3	0	0	0	0	3
OG0021900	1	0	0	1	1	3
OG0021901	1	1	0	0	1	3
OG0021902	1	1	0	0	1	3
OG0021903	1	2	0	0	0	3
OG0021904	3	0	0	0	0	3
OG0021905	1	0	0	0	2	3
OG0021906	3	0	0	0	0	3
OG0021907	3	0	0	0	0	3
OG0021908	2	0	1	0	0	3
OG0021909	2	0	1	0	0	3
OG0021910	3	0	0	0	0	3
OG0021911	3	0	0	0	0	3
OG0021912	3	0	0	0	0	3
OG0021913	1	0	1	0	1	3
OG0021914	1	1	0	0	1	3
OG0021915	3	0	0	0	0	3
OG0021916	3	0	0	0	0	3
OG0021917	1	0	1	0	1	3
OG0021918	2	0	0	1	0	3
OG0021919	3	0	0	0	0	3
OG0021920	3	0	0	0	0	3
OG0021921	3	0	0	0	0	3
OG0021922	3	0	0	0	0	3
OG0021923	2	0	0	1	0	3
OG0021924	1	2	0	0	0	3
OG0021925	2	0	0	1	0	3
OG0021926	3	0	0	0	0	3
OG0021927	3	0	0	0	0	3
OG0021928	2	0	0	1	0	3
OG0021929	2	1	0	0	0	3
OG0021930	3	0	0	0	0	3
OG0021931	3	0	0	0	0	3
OG0021932	3	0	0	0	0	3
OG0021933	3	0	0	0	0	3
OG0021934	3	0	0	0	0	3
OG0021935	3	0	0	0	0	3
OG0021936	3	0	0	0	0	3
OG0021937	2	0	0	0	1	3
OG0021938	1	2	0	0	0	3
OG0021939	1	0	0	1	1	3
OG0021940	2	0	0	1	0	3
OG0021941	3	0	0	0	0	3
OG0021942	2	0	0	1	0	3
OG0021943	3	0	0	0	0	3
OG0021944	2	0	0	1	0	3
OG0021945	3	0	0	0	0	3
OG0021946	2	0	0	1	0	3
OG0021947	3	0	0	0	0	3
OG0021948	3	0	0	0	0	3
OG0021949	3	0	0	0	0	3
OG0021950	2	0	0	0	1	3
OG0021951	2	0	0	1	0	3
OG0021952	3	0	0	0	0	3
OG0021953	2	0	0	1	0	3
OG0021954	2	0	0	1	0	3
OG0021955	3	0	0	0	0	3
OG0021956	2	0	0	1	0	3
OG0021957	1	0	0	0	2	3
OG0021958	2	0	0	1	0	3
OG0021959	2	0	0	1	0	3
OG0021960	3	0	0	0	0	3
OG0021961	2	0	0	1	0	3
OG0021962	2	0	0	1	0	3
OG0021963	3	0	0	0	0	3
OG0021964	3	0	0	0	0	3
OG0021965	1	2	0	0	0	3
OG0021966	3	0	0	0	0	3
OG0021967	2	0	0	1	0	3
OG0021968	2	0	0	1	0	3
OG0021969	3	0	0	0	0	3
OG0021970	3	0	0	0	0	3
OG0021971	2	0	0	1	0	3
OG0021972	3	0	0	0	0	3
OG0021973	2	0	1	0	0	3
OG0021974	3	0	0	0	0	3
OG0021975	2	0	0	1	0	3
OG0021976	1	0	2	0	0	3
OG0021977	2	0	1	0	0	3
OG0021978	2	0	0	0	1	3
OG0021979	2	0	0	1	0	3
OG0021980	3	0	0	0	0	3
OG0021981	2	0	0	1	0	3
OG0021982	2	0	0	1	0	3
OG0021983	3	0	0	0	0	3
OG0021984	2	0	0	1	0	3
OG0021985	2	1	0	0	0	3
OG0021986	3	0	0	0	0	3
OG0021987	1	2	0	0	0	3
OG0021988	2	0	0	1	0	3
OG0021989	2	0	1	0	0	3
OG0021990	1	0	1	0	1	3
OG0021991	1	0	0	0	2	3
OG0021992	1	2	0	0	0	3
OG0021993	3	0	0	0	0	3
OG0021994	3	0	0	0	0	3
OG0021995	1	1	1	0	0	3
OG0021996	1	1	1	0	0	3
OG0021997	1	0	1	0	1	3
OG0021998	3	0	0	0	0	3
OG0021999	3	0	0	0	0	3
OG0022000	2	0	1	0	0	3
OG0022001	3	0	0	0	0	3
OG0022002	2	1	0	0	0	3
OG0022003	1	0	1	1	0	3
OG0022004	1	0	1	0	1	3
OG0022005	3	0	0	0	0	3
OG0022006	1	0	1	1	0	3
OG0022007	1	0	1	1	0	3
OG0022008	2	0	1	0	0	3
OG0022009	1	0	2	0	0	3
OG0022010	1	2	0	0	0	3
OG0022011	1	1	0	1	0	3
OG0022012	1	1	0	1	0	3
OG0022013	1	1	1	0	0	3
OG0022014	1	0	2	0	0	3
OG0022015	1	1	0	1	0	3
OG0022016	1	0	1	0	1	3
OG0022017	3	0	0	0	0	3
OG0022018	2	0	0	1	0	3
OG0022019	1	2	0	0	0	3
OG0022020	1	1	1	0	0	3
OG0022021	3	0	0	0	0	3
OG0022022	1	0	1	0	1	3
OG0022023	1	1	1	0	0	3
OG0022024	1	0	0	0	2	3
OG0022025	3	0	0	0	0	3
OG0022026	1	0	1	0	1	3
OG0022027	1	0	1	0	1	3
OG0022028	1	0	1	0	1	3
OG0022029	1	2	0	0	0	3
OG0022030	3	0	0	0	0	3
OG0022031	1	2	0	0	0	3
OG0022032	0	3	0	0	0	3
OG0022033	0	3	0	0	0	3
OG0022034	0	3	0	0	0	3
OG0022035	0	3	0	0	0	3
OG0022036	0	3	0	0	0	3
OG0022037	0	3	0	0	0	3
OG0022038	0	3	0	0	0	3
OG0022039	0	3	0	0	0	3
OG0022040	0	3	0	0	0	3
OG0022041	0	3	0	0	0	3
OG0022042	0	3	0	0	0	3
OG0022043	0	3	0	0	0	3
OG0022044	0	3	0	0	0	3
OG0022045	0	2	0	1	0	3
OG0022046	0	3	0	0	0	3
OG0022047	0	3	0	0	0	3
OG0022048	0	3	0	0	0	3
OG0022049	0	3	0	0	0	3
OG0022050	0	3	0	0	0	3
OG0022051	0	3	0	0	0	3
OG0022052	0	2	0	1	0	3
OG0022053	0	3	0	0	0	3
OG0022054	0	3	0	0	0	3
OG0022055	0	3	0	0	0	3
OG0022056	0	3	0	0	0	3
OG0022057	0	3	0	0	0	3
OG0022058	0	3	0	0	0	3
OG0022059	0	2	0	1	0	3
OG0022060	0	3	0	0	0	3
OG0022061	0	3	0	0	0	3
OG0022062	0	3	0	0	0	3
OG0022063	0	3	0	0	0	3
OG0022064	0	3	0	0	0	3
OG0022065	0	1	0	0	2	3
OG0022066	0	3	0	0	0	3
OG0022067	0	3	0	0	0	3
OG0022068	0	3	0	0	0	3
OG0022069	0	3	0	0	0	3
OG0022070	0	3	0	0	0	3
OG0022071	0	2	0	0	1	3
OG0022072	0	3	0	0	0	3
OG0022073	0	3	0	0	0	3
OG0022074	0	3	0	0	0	3
OG0022075	0	3	0	0	0	3
OG0022076	0	3	0	0	0	3
OG0022077	0	3	0	0	0	3
OG0022078	0	3	0	0	0	3
OG0022079	0	2	1	0	0	3
OG0022080	0	3	0	0	0	3
OG0022081	0	3	0	0	0	3
OG0022082	0	3	0	0	0	3
OG0022083	0	3	0	0	0	3
OG0022084	0	3	0	0	0	3
OG0022085	0	3	0	0	0	3
OG0022086	0	3	0	0	0	3
OG0022087	0	2	1	0	0	3
OG0022088	0	3	0	0	0	3
OG0022089	0	3	0	0	0	3
OG0022090	0	3	0	0	0	3
OG0022091	0	3	0	0	0	3
OG0022092	0	3	0	0	0	3
OG0022093	0	3	0	0	0	3
OG0022094	0	3	0	0	0	3
OG0022095	0	3	0	0	0	3
OG0022096	0	3	0	0	0	3
OG0022097	0	3	0	0	0	3
OG0022098	0	3	0	0	0	3
OG0022099	0	3	0	0	0	3
OG0022100	0	3	0	0	0	3
OG0022101	0	3	0	0	0	3
OG0022102	0	3	0	0	0	3
OG0022103	0	3	0	0	0	3
OG0022104	0	3	0	0	0	3
OG0022105	0	3	0	0	0	3
OG0022106	0	3	0	0	0	3
OG0022107	0	3	0	0	0	3
OG0022108	0	3	0	0	0	3
OG0022109	0	3	0	0	0	3
OG0022110	0	3	0	0	0	3
OG0022111	0	2	0	0	1	3
OG0022112	0	3	0	0	0	3
OG0022113	0	1	0	1	1	3
OG0022114	0	3	0	0	0	3
OG0022115	0	3	0	0	0	3
OG0022116	0	3	0	0	0	3
OG0022117	0	3	0	0	0	3
OG0022118	0	3	0	0	0	3
OG0022119	0	3	0	0	0	3
OG0022120	0	3	0	0	0	3
OG0022121	0	3	0	0	0	3
OG0022122	0	3	0	0	0	3
OG0022123	0	3	0	0	0	3
OG0022124	0	3	0	0	0	3
OG0022125	0	3	0	0	0	3
OG0022126	0	3	0	0	0	3
OG0022127	0	1	1	1	0	3
OG0022128	0	3	0	0	0	3
OG0022129	0	3	0	0	0	3
OG0022130	0	3	0	0	0	3
OG0022131	0	3	0	0	0	3
OG0022132	0	3	0	0	0	3
OG0022133	0	3	0	0	0	3
OG0022134	0	3	0	0	0	3
OG0022135	0	2	0	0	1	3
OG0022136	0	3	0	0	0	3
OG0022137	0	3	0	0	0	3
OG0022138	0	3	0	0	0	3
OG0022139	0	2	0	0	1	3
OG0022140	0	3	0	0	0	3
OG0022141	0	3	0	0	0	3
OG0022142	0	3	0	0	0	3
OG0022143	0	3	0	0	0	3
OG0022144	0	3	0	0	0	3
OG0022145	0	3	0	0	0	3
OG0022146	0	3	0	0	0	3
OG0022147	0	3	0	0	0	3
OG0022148	0	3	0	0	0	3
OG0022149	0	3	0	0	0	3
OG0022150	0	3	0	0	0	3
OG0022151	0	3	0	0	0	3
OG0022152	0	3	0	0	0	3
OG0022153	0	3	0	0	0	3
OG0022154	0	3	0	0	0	3
OG0022155	0	3	0	0	0	3
OG0022156	0	3	0	0	0	3
OG0022157	0	3	0	0	0	3
OG0022158	0	3	0	0	0	3
OG0022159	0	3	0	0	0	3
OG0022160	0	3	0	0	0	3
OG0022161	0	3	0	0	0	3
OG0022162	0	3	0	0	0	3
OG0022163	0	3	0	0	0	3
OG0022164	0	3	0	0	0	3
OG0022165	0	3	0	0	0	3
OG0022166	0	3	0	0	0	3
OG0022167	0	3	0	0	0	3
OG0022168	0	3	0	0	0	3
OG0022169	0	1	1	0	1	3
OG0022170	0	3	0	0	0	3
OG0022171	0	3	0	0	0	3
OG0022172	0	3	0	0	0	3
OG0022173	0	3	0	0	0	3
OG0022174	0	2	0	1	0	3
OG0022175	0	3	0	0	0	3
OG0022176	0	3	0	0	0	3
OG0022177	0	3	0	0	0	3
OG0022178	0	3	0	0	0	3
OG0022179	0	3	0	0	0	3
OG0022180	0	3	0	0	0	3
OG0022181	0	3	0	0	0	3
OG0022182	0	3	0	0	0	3
OG0022183	0	3	0	0	0	3
OG0022184	0	3	0	0	0	3
OG0022185	0	3	0	0	0	3
OG0022186	0	3	0	0	0	3
OG0022187	0	3	0	0	0	3
OG0022188	0	3	0	0	0	3
OG0022189	0	3	0	0	0	3
OG0022190	0	3	0	0	0	3
OG0022191	0	3	0	0	0	3
OG0022192	0	3	0	0	0	3
OG0022193	0	3	0	0	0	3
OG0022194	0	2	1	0	0	3
OG0022195	0	3	0	0	0	3
OG0022196	0	3	0	0	0	3
OG0022197	0	3	0	0	0	3
OG0022198	0	3	0	0	0	3
OG0022199	0	3	0	0	0	3
OG0022200	0	3	0	0	0	3
OG0022201	0	3	0	0	0	3
OG0022202	0	3	0	0	0	3
OG0022203	0	3	0	0	0	3
OG0022204	0	3	0	0	0	3
OG0022205	0	3	0	0	0	3
OG0022206	0	3	0	0	0	3
OG0022207	0	3	0	0	0	3
OG0022208	0	2	0	1	0	3
OG0022209	0	3	0	0	0	3
OG0022210	0	3	0	0	0	3
OG0022211	0	3	0	0	0	3
OG0022212	0	3	0	0	0	3
OG0022213	0	3	0	0	0	3
OG0022214	0	3	0	0	0	3
OG0022215	0	3	0	0	0	3
OG0022216	0	3	0	0	0	3
OG0022217	0	3	0	0	0	3
OG0022218	0	3	0	0	0	3
OG0022219	0	3	0	0	0	3
OG0022220	0	3	0	0	0	3
OG0022221	0	3	0	0	0	3
OG0022222	0	3	0	0	0	3
OG0022223	0	3	0	0	0	3
OG0022224	0	3	0	0	0	3
OG0022225	0	3	0	0	0	3
OG0022226	0	3	0	0	0	3
OG0022227	0	3	0	0	0	3
OG0022228	0	3	0	0	0	3
OG0022229	0	3	0	0	0	3
OG0022230	0	3	0	0	0	3
OG0022231	0	3	0	0	0	3
OG0022232	0	1	0	2	0	3
OG0022233	0	1	2	0	0	3
OG0022234	0	2	0	1	0	3
OG0022235	0	3	0	0	0	3
OG0022236	0	3	0	0	0	3
OG0022237	0	3	0	0	0	3
OG0022238	0	3	0	0	0	3
OG0022239	0	3	0	0	0	3
OG0022240	0	3	0	0	0	3
OG0022241	0	3	0	0	0	3
OG0022242	0	3	0	0	0	3
OG0022243	0	3	0	0	0	3
OG0022244	0	3	0	0	0	3
OG0022245	0	3	0	0	0	3
OG0022246	0	3	0	0	0	3
OG0022247	0	3	0	0	0	3
OG0022248	0	3	0	0	0	3
OG0022249	0	3	0	0	0	3
OG0022250	0	3	0	0	0	3
OG0022251	0	3	0	0	0	3
OG0022252	0	3	0	0	0	3
OG0022253	0	3	0	0	0	3
OG0022254	0	3	0	0	0	3
OG0022255	0	2	0	1	0	3
OG0022256	0	3	0	0	0	3
OG0022257	0	3	0	0	0	3
OG0022258	0	3	0	0	0	3
OG0022259	0	3	0	0	0	3
OG0022260	0	3	0	0	0	3
OG0022261	0	3	0	0	0	3
OG0022262	0	3	0	0	0	3
OG0022263	0	3	0	0	0	3
OG0022264	0	3	0	0	0	3
OG0022265	0	3	0	0	0	3
OG0022266	0	3	0	0	0	3
OG0022267	0	3	0	0	0	3
OG0022268	0	2	0	1	0	3
OG0022269	0	3	0	0	0	3
OG0022270	0	3	0	0	0	3
OG0022271	0	3	0	0	0	3
OG0022272	0	3	0	0	0	3
OG0022273	0	3	0	0	0	3
OG0022274	0	3	0	0	0	3
OG0022275	0	3	0	0	0	3
OG0022276	0	3	0	0	0	3
OG0022277	0	3	0	0	0	3
OG0022278	0	3	0	0	0	3
OG0022279	0	3	0	0	0	3
OG0022280	0	3	0	0	0	3
OG0022281	0	3	0	0	0	3
OG0022282	0	3	0	0	0	3
OG0022283	0	3	0	0	0	3
OG0022284	0	3	0	0	0	3
OG0022285	0	3	0	0	0	3
OG0022286	0	3	0	0	0	3
OG0022287	0	3	0	0	0	3
OG0022288	0	2	1	0	0	3
OG0022289	0	3	0	0	0	3
OG0022290	0	3	0	0	0	3
OG0022291	0	3	0	0	0	3
OG0022292	0	3	0	0	0	3
OG0022293	0	3	0	0	0	3
OG0022294	0	3	0	0	0	3
OG0022295	0	3	0	0	0	3
OG0022296	0	3	0	0	0	3
OG0022297	0	2	0	1	0	3
OG0022298	0	3	0	0	0	3
OG0022299	0	3	0	0	0	3
OG0022300	0	3	0	0	0	3
OG0022301	0	3	0	0	0	3
OG0022302	0	3	0	0	0	3
OG0022303	0	3	0	0	0	3
OG0022304	0	2	0	0	1	3
OG0022305	0	3	0	0	0	3
OG0022306	0	3	0	0	0	3
OG0022307	0	3	0	0	0	3
OG0022308	0	3	0	0	0	3
OG0022309	0	3	0	0	0	3
OG0022310	0	3	0	0	0	3
OG0022311	0	3	0	0	0	3
OG0022312	0	3	0	0	0	3
OG0022313	0	3	0	0	0	3
OG0022314	0	3	0	0	0	3
OG0022315	0	3	0	0	0	3
OG0022316	0	2	0	0	1	3
OG0022317	0	3	0	0	0	3
OG0022318	0	3	0	0	0	3
OG0022319	0	3	0	0	0	3
OG0022320	0	3	0	0	0	3
OG0022321	0	3	0	0	0	3
OG0022322	0	3	0	0	0	3
OG0022323	0	3	0	0	0	3
OG0022324	0	3	0	0	0	3
OG0022325	0	3	0	0	0	3
OG0022326	0	3	0	0	0	3
OG0022327	0	3	0	0	0	3
OG0022328	0	3	0	0	0	3
OG0022329	0	3	0	0	0	3
OG0022330	0	3	0	0	0	3
OG0022331	0	3	0	0	0	3
OG0022332	0	3	0	0	0	3
OG0022333	0	3	0	0	0	3
OG0022334	0	3	0	0	0	3
OG0022335	0	3	0	0	0	3
OG0022336	0	3	0	0	0	3
OG0022337	0	3	0	0	0	3
OG0022338	0	3	0	0	0	3
OG0022339	0	3	0	0	0	3
OG0022340	0	3	0	0	0	3
OG0022341	0	3	0	0	0	3
OG0022342	0	3	0	0	0	3
OG0022343	0	1	1	1	0	3
OG0022344	0	3	0	0	0	3
OG0022345	0	3	0	0	0	3
OG0022346	0	3	0	0	0	3
OG0022347	0	3	0	0	0	3
OG0022348	0	2	1	0	0	3
OG0022349	0	3	0	0	0	3
OG0022350	0	2	0	1	0	3
OG0022351	0	3	0	0	0	3
OG0022352	0	3	0	0	0	3
OG0022353	0	3	0	0	0	3
OG0022354	0	3	0	0	0	3
OG0022355	0	3	0	0	0	3
OG0022356	0	3	0	0	0	3
OG0022357	0	3	0	0	0	3
OG0022358	0	3	0	0	0	3
OG0022359	0	3	0	0	0	3
OG0022360	0	3	0	0	0	3
OG0022361	0	3	0	0	0	3
OG0022362	0	3	0	0	0	3
OG0022363	0	3	0	0	0	3
OG0022364	0	3	0	0	0	3
OG0022365	0	3	0	0	0	3
OG0022366	0	3	0	0	0	3
OG0022367	0	3	0	0	0	3
OG0022368	0	3	0	0	0	3
OG0022369	0	3	0	0	0	3
OG0022370	0	3	0	0	0	3
OG0022371	0	3	0	0	0	3
OG0022372	0	3	0	0	0	3
OG0022373	0	3	0	0	0	3
OG0022374	0	3	0	0	0	3
OG0022375	0	3	0	0	0	3
OG0022376	0	3	0	0	0	3
OG0022377	0	3	0	0	0	3
OG0022378	0	3	0	0	0	3
OG0022379	0	3	0	0	0	3
OG0022380	0	2	1	0	0	3
OG0022381	0	3	0	0	0	3
OG0022382	0	3	0	0	0	3
OG0022383	0	3	0	0	0	3
OG0022384	0	3	0	0	0	3
OG0022385	0	3	0	0	0	3
OG0022386	0	3	0	0	0	3
OG0022387	0	3	0	0	0	3
OG0022388	0	3	0	0	0	3
OG0022389	0	3	0	0	0	3
OG0022390	0	3	0	0	0	3
OG0022391	0	3	0	0	0	3
OG0022392	0	3	0	0	0	3
OG0022393	0	3	0	0	0	3
OG0022394	0	3	0	0	0	3
OG0022395	0	3	0	0	0	3
OG0022396	0	3	0	0	0	3
OG0022397	0	3	0	0	0	3
OG0022398	0	3	0	0	0	3
OG0022399	0	3	0	0	0	3
OG0022400	0	3	0	0	0	3
OG0022401	0	3	0	0	0	3
OG0022402	0	3	0	0	0	3
OG0022403	0	3	0	0	0	3
OG0022404	0	2	0	0	1	3
OG0022405	0	3	0	0	0	3
OG0022406	0	3	0	0	0	3
OG0022407	0	3	0	0	0	3
OG0022408	0	3	0	0	0	3
OG0022409	0	3	0	0	0	3
OG0022410	0	3	0	0	0	3
OG0022411	0	3	0	0	0	3
OG0022412	0	3	0	0	0	3
OG0022413	0	3	0	0	0	3
OG0022414	0	2	1	0	0	3
OG0022415	0	3	0	0	0	3
OG0022416	0	3	0	0	0	3
OG0022417	0	3	0	0	0	3
OG0022418	0	3	0	0	0	3
OG0022419	0	3	0	0	0	3
OG0022420	0	3	0	0	0	3
OG0022421	0	3	0	0	0	3
OG0022422	0	3	0	0	0	3
OG0022423	0	3	0	0	0	3
OG0022424	0	3	0	0	0	3
OG0022425	0	3	0	0	0	3
OG0022426	0	3	0	0	0	3
OG0022427	0	2	0	0	1	3
OG0022428	0	3	0	0	0	3
OG0022429	0	3	0	0	0	3
OG0022430	0	3	0	0	0	3
OG0022431	0	1	1	0	1	3
OG0022432	0	3	0	0	0	3
OG0022433	0	3	0	0	0	3
OG0022434	0	3	0	0	0	3
OG0022435	0	3	0	0	0	3
OG0022436	0	3	0	0	0	3
OG0022437	0	3	0	0	0	3
OG0022438	0	3	0	0	0	3
OG0022439	0	3	0	0	0	3
OG0022440	0	3	0	0	0	3
OG0022441	0	3	0	0	0	3
OG0022442	0	3	0	0	0	3
OG0022443	0	1	1	0	1	3
OG0022444	0	3	0	0	0	3
OG0022445	0	3	0	0	0	3
OG0022446	0	3	0	0	0	3
OG0022447	0	3	0	0	0	3
OG0022448	0	3	0	0	0	3
OG0022449	0	2	0	1	0	3
OG0022450	0	3	0	0	0	3
OG0022451	0	2	0	1	0	3
OG0022452	0	3	0	0	0	3
OG0022453	0	3	0	0	0	3
OG0022454	0	3	0	0	0	3
OG0022455	0	3	0	0	0	3
OG0022456	0	3	0	0	0	3
OG0022457	0	3	0	0	0	3
OG0022458	0	3	0	0	0	3
OG0022459	0	3	0	0	0	3
OG0022460	0	3	0	0	0	3
OG0022461	0	3	0	0	0	3
OG0022462	0	3	0	0	0	3
OG0022463	0	3	0	0	0	3
OG0022464	0	3	0	0	0	3
OG0022465	0	1	1	0	1	3
OG0022466	0	1	0	0	2	3
OG0022467	0	2	0	1	0	3
OG0022468	0	3	0	0	0	3
OG0022469	0	3	0	0	0	3
OG0022470	0	3	0	0	0	3
OG0022471	0	3	0	0	0	3
OG0022472	0	3	0	0	0	3
OG0022473	0	3	0	0	0	3
OG0022474	0	3	0	0	0	3
OG0022475	0	3	0	0	0	3
OG0022476	0	3	0	0	0	3
OG0022477	0	3	0	0	0	3
OG0022478	0	3	0	0	0	3
OG0022479	0	3	0	0	0	3
OG0022480	0	3	0	0	0	3
OG0022481	0	3	0	0	0	3
OG0022482	0	3	0	0	0	3
OG0022483	0	3	0	0	0	3
OG0022484	0	2	1	0	0	3
OG0022485	0	3	0	0	0	3
OG0022486	0	1	1	0	1	3
OG0022487	0	3	0	0	0	3
OG0022488	0	3	0	0	0	3
OG0022489	0	3	0	0	0	3
OG0022490	0	3	0	0	0	3
OG0022491	0	3	0	0	0	3
OG0022492	0	2	0	1	0	3
OG0022493	0	3	0	0	0	3
OG0022494	0	3	0	0	0	3
OG0022495	0	3	0	0	0	3
OG0022496	0	3	0	0	0	3
OG0022497	0	3	0	0	0	3
OG0022498	0	3	0	0	0	3
OG0022499	0	3	0	0	0	3
OG0022500	0	3	0	0	0	3
OG0022501	0	3	0	0	0	3
OG0022502	0	3	0	0	0	3
OG0022503	0	3	0	0	0	3
OG0022504	0	3	0	0	0	3
OG0022505	0	3	0	0	0	3
OG0022506	0	3	0	0	0	3
OG0022507	0	3	0	0	0	3
OG0022508	0	2	0	0	1	3
OG0022509	0	3	0	0	0	3
OG0022510	0	3	0	0	0	3
OG0022511	0	3	0	0	0	3
OG0022512	0	2	0	1	0	3
OG0022513	0	3	0	0	0	3
OG0022514	0	3	0	0	0	3
OG0022515	0	3	0	0	0	3
OG0022516	0	3	0	0	0	3
OG0022517	0	3	0	0	0	3
OG0022518	0	3	0	0	0	3
OG0022519	0	3	0	0	0	3
OG0022520	0	3	0	0	0	3
OG0022521	0	3	0	0	0	3
OG0022522	0	3	0	0	0	3
OG0022523	0	3	0	0	0	3
OG0022524	0	3	0	0	0	3
OG0022525	0	3	0	0	0	3
OG0022526	0	3	0	0	0	3
OG0022527	0	3	0	0	0	3
OG0022528	0	3	0	0	0	3
OG0022529	0	3	0	0	0	3
OG0022530	0	3	0	0	0	3
OG0022531	0	3	0	0	0	3
OG0022532	0	3	0	0	0	3
OG0022533	0	3	0	0	0	3
OG0022534	0	3	0	0	0	3
OG0022535	0	2	1	0	0	3
OG0022536	0	3	0	0	0	3
OG0022537	0	2	1	0	0	3
OG0022538	0	3	0	0	0	3
OG0022539	0	3	0	0	0	3
OG0022540	0	1	0	0	2	3
OG0022541	0	3	0	0	0	3
OG0022542	0	2	1	0	0	3
OG0022543	0	3	0	0	0	3
OG0022544	0	3	0	0	0	3
OG0022545	0	3	0	0	0	3
OG0022546	0	3	0	0	0	3
OG0022547	0	3	0	0	0	3
OG0022548	0	3	0	0	0	3
OG0022549	0	3	0	0	0	3
OG0022550	0	3	0	0	0	3
OG0022551	0	3	0	0	0	3
OG0022552	0	3	0	0	0	3
OG0022553	0	3	0	0	0	3
OG0022554	0	3	0	0	0	3
OG0022555	0	3	0	0	0	3
OG0022556	0	3	0	0	0	3
OG0022557	0	3	0	0	0	3
OG0022558	0	3	0	0	0	3
OG0022559	0	3	0	0	0	3
OG0022560	0	3	0	0	0	3
OG0022561	0	3	0	0	0	3
OG0022562	0	3	0	0	0	3
OG0022563	0	3	0	0	0	3
OG0022564	0	3	0	0	0	3
OG0022565	0	3	0	0	0	3
OG0022566	0	3	0	0	0	3
OG0022567	0	3	0	0	0	3
OG0022568	0	3	0	0	0	3
OG0022569	0	3	0	0	0	3
OG0022570	0	3	0	0	0	3
OG0022571	0	3	0	0	0	3
OG0022572	0	3	0	0	0	3
OG0022573	0	3	0	0	0	3
OG0022574	0	3	0	0	0	3
OG0022575	0	3	0	0	0	3
OG0022576	0	3	0	0	0	3
OG0022577	0	3	0	0	0	3
OG0022578	0	2	0	1	0	3
OG0022579	0	3	0	0	0	3
OG0022580	0	3	0	0	0	3
OG0022581	0	3	0	0	0	3
OG0022582	0	3	0	0	0	3
OG0022583	0	3	0	0	0	3
OG0022584	0	3	0	0	0	3
OG0022585	0	2	0	1	0	3
OG0022586	0	3	0	0	0	3
OG0022587	0	3	0	0	0	3
OG0022588	0	3	0	0	0	3
OG0022589	0	3	0	0	0	3
OG0022590	0	3	0	0	0	3
OG0022591	0	3	0	0	0	3
OG0022592	0	3	0	0	0	3
OG0022593	0	3	0	0	0	3
OG0022594	0	3	0	0	0	3
OG0022595	0	3	0	0	0	3
OG0022596	0	2	0	1	0	3
OG0022597	0	3	0	0	0	3
OG0022598	0	3	0	0	0	3
OG0022599	0	3	0	0	0	3
OG0022600	0	2	1	0	0	3
OG0022601	0	3	0	0	0	3
OG0022602	0	3	0	0	0	3
OG0022603	0	3	0	0	0	3
OG0022604	0	3	0	0	0	3
OG0022605	0	3	0	0	0	3
OG0022606	0	3	0	0	0	3
OG0022607	0	3	0	0	0	3
OG0022608	0	3	0	0	0	3
OG0022609	0	2	0	1	0	3
OG0022610	0	3	0	0	0	3
OG0022611	0	3	0	0	0	3
OG0022612	0	3	0	0	0	3
OG0022613	0	3	0	0	0	3
OG0022614	0	3	0	0	0	3
OG0022615	0	3	0	0	0	3
OG0022616	0	3	0	0	0	3
OG0022617	0	3	0	0	0	3
OG0022618	0	3	0	0	0	3
OG0022619	0	3	0	0	0	3
OG0022620	0	3	0	0	0	3
OG0022621	0	3	0	0	0	3
OG0022622	0	3	0	0	0	3
OG0022623	0	3	0	0	0	3
OG0022624	0	3	0	0	0	3
OG0022625	0	3	0	0	0	3
OG0022626	0	3	0	0	0	3
OG0022627	0	3	0	0	0	3
OG0022628	0	3	0	0	0	3
OG0022629	0	3	0	0	0	3
OG0022630	0	3	0	0	0	3
OG0022631	0	2	0	1	0	3
OG0022632	0	3	0	0	0	3
OG0022633	0	3	0	0	0	3
OG0022634	0	3	0	0	0	3
OG0022635	0	3	0	0	0	3
OG0022636	0	3	0	0	0	3
OG0022637	0	3	0	0	0	3
OG0022638	0	3	0	0	0	3
OG0022639	0	3	0	0	0	3
OG0022640	0	3	0	0	0	3
OG0022641	0	3	0	0	0	3
OG0022642	0	3	0	0	0	3
OG0022643	0	3	0	0	0	3
OG0022644	0	3	0	0	0	3
OG0022645	0	3	0	0	0	3
OG0022646	0	2	0	1	0	3
OG0022647	0	3	0	0	0	3
OG0022648	0	3	0	0	0	3
OG0022649	0	3	0	0	0	3
OG0022650	0	3	0	0	0	3
OG0022651	0	3	0	0	0	3
OG0022652	0	3	0	0	0	3
OG0022653	0	3	0	0	0	3
OG0022654	0	3	0	0	0	3
OG0022655	0	3	0	0	0	3
OG0022656	0	3	0	0	0	3
OG0022657	0	3	0	0	0	3
OG0022658	0	3	0	0	0	3
OG0022659	0	1	0	1	1	3
OG0022660	0	3	0	0	0	3
OG0022661	0	3	0	0	0	3
OG0022662	0	3	0	0	0	3
OG0022663	0	3	0	0	0	3
OG0022664	0	3	0	0	0	3
OG0022665	0	3	0	0	0	3
OG0022666	0	3	0	0	0	3
OG0022667	0	3	0	0	0	3
OG0022668	0	3	0	0	0	3
OG0022669	0	3	0	0	0	3
OG0022670	0	3	0	0	0	3
OG0022671	0	3	0	0	0	3
OG0022672	0	3	0	0	0	3
OG0022673	0	3	0	0	0	3
OG0022674	0	3	0	0	0	3
OG0022675	0	3	0	0	0	3
OG0022676	0	3	0	0	0	3
OG0022677	0	3	0	0	0	3
OG0022678	0	3	0	0	0	3
OG0022679	0	3	0	0	0	3
OG0022680	0	3	0	0	0	3
OG0022681	0	3	0	0	0	3
OG0022682	0	3	0	0	0	3
OG0022683	0	3	0	0	0	3
OG0022684	0	3	0	0	0	3
OG0022685	0	3	0	0	0	3
OG0022686	0	3	0	0	0	3
OG0022687	0	3	0	0	0	3
OG0022688	0	3	0	0	0	3
OG0022689	0	3	0	0	0	3
OG0022690	0	3	0	0	0	3
OG0022691	0	3	0	0	0	3
OG0022692	0	3	0	0	0	3
OG0022693	0	3	0	0	0	3
OG0022694	0	3	0	0	0	3
OG0022695	0	3	0	0	0	3
OG0022696	0	3	0	0	0	3
OG0022697	0	3	0	0	0	3
OG0022698	0	3	0	0	0	3
OG0022699	0	3	0	0	0	3
OG0022700	0	3	0	0	0	3
OG0022701	0	3	0	0	0	3
OG0022702	0	3	0	0	0	3
OG0022703	0	1	0	0	2	3
OG0022704	0	3	0	0	0	3
OG0022705	0	3	0	0	0	3
OG0022706	0	3	0	0	0	3
OG0022707	0	3	0	0	0	3
OG0022708	0	3	0	0	0	3
OG0022709	0	3	0	0	0	3
OG0022710	0	3	0	0	0	3
OG0022711	0	2	1	0	0	3
OG0022712	0	2	0	1	0	3
OG0022713	0	3	0	0	0	3
OG0022714	0	3	0	0	0	3
OG0022715	0	3	0	0	0	3
OG0022716	0	2	0	1	0	3
OG0022717	0	3	0	0	0	3
OG0022718	0	3	0	0	0	3
OG0022719	0	3	0	0	0	3
OG0022720	0	3	0	0	0	3
OG0022721	0	3	0	0	0	3
OG0022722	0	3	0	0	0	3
OG0022723	0	2	0	1	0	3
OG0022724	0	3	0	0	0	3
OG0022725	0	3	0	0	0	3
OG0022726	0	3	0	0	0	3
OG0022727	0	3	0	0	0	3
OG0022728	0	3	0	0	0	3
OG0022729	0	3	0	0	0	3
OG0022730	0	3	0	0	0	3
OG0022731	0	3	0	0	0	3
OG0022732	0	3	0	0	0	3
OG0022733	0	3	0	0	0	3
OG0022734	0	3	0	0	0	3
OG0022735	0	3	0	0	0	3
OG0022736	0	3	0	0	0	3
OG0022737	0	2	0	1	0	3
OG0022738	0	3	0	0	0	3
OG0022739	0	3	0	0	0	3
OG0022740	0	3	0	0	0	3
OG0022741	0	3	0	0	0	3
OG0022742	0	3	0	0	0	3
OG0022743	0	3	0	0	0	3
OG0022744	0	3	0	0	0	3
OG0022745	0	3	0	0	0	3
OG0022746	0	3	0	0	0	3
OG0022747	0	3	0	0	0	3
OG0022748	0	3	0	0	0	3
OG0022749	0	3	0	0	0	3
OG0022750	0	3	0	0	0	3
OG0022751	0	3	0	0	0	3
OG0022752	0	3	0	0	0	3
OG0022753	0	3	0	0	0	3
OG0022754	0	3	0	0	0	3
OG0022755	0	1	2	0	0	3
OG0022756	0	3	0	0	0	3
OG0022757	0	3	0	0	0	3
OG0022758	0	3	0	0	0	3
OG0022759	0	3	0	0	0	3
OG0022760	0	3	0	0	0	3
OG0022761	0	3	0	0	0	3
OG0022762	0	2	1	0	0	3
OG0022763	0	3	0	0	0	3
OG0022764	0	3	0	0	0	3
OG0022765	0	3	0	0	0	3
OG0022766	0	3	0	0	0	3
OG0022767	0	3	0	0	0	3
OG0022768	0	3	0	0	0	3
OG0022769	0	3	0	0	0	3
OG0022770	0	3	0	0	0	3
OG0022771	0	3	0	0	0	3
OG0022772	0	3	0	0	0	3
OG0022773	0	3	0	0	0	3
OG0022774	0	3	0	0	0	3
OG0022775	0	3	0	0	0	3
OG0022776	0	3	0	0	0	3
OG0022777	0	3	0	0	0	3
OG0022778	0	3	0	0	0	3
OG0022779	0	3	0	0	0	3
OG0022780	0	3	0	0	0	3
OG0022781	0	3	0	0	0	3
OG0022782	0	3	0	0	0	3
OG0022783	0	3	0	0	0	3
OG0022784	0	3	0	0	0	3
OG0022785	0	3	0	0	0	3
OG0022786	0	3	0	0	0	3
OG0022787	0	3	0	0	0	3
OG0022788	0	3	0	0	0	3
OG0022789	0	3	0	0	0	3
OG0022790	0	3	0	0	0	3
OG0022791	0	3	0	0	0	3
OG0022792	0	3	0	0	0	3
OG0022793	0	3	0	0	0	3
OG0022794	0	3	0	0	0	3
OG0022795	0	1	0	1	1	3
OG0022796	0	3	0	0	0	3
OG0022797	0	3	0	0	0	3
OG0022798	0	3	0	0	0	3
OG0022799	0	3	0	0	0	3
OG0022800	0	3	0	0	0	3
OG0022801	0	3	0	0	0	3
OG0022802	0	3	0	0	0	3
OG0022803	0	3	0	0	0	3
OG0022804	0	3	0	0	0	3
OG0022805	0	2	0	1	0	3
OG0022806	0	3	0	0	0	3
OG0022807	0	3	0	0	0	3
OG0022808	0	3	0	0	0	3
OG0022809	0	2	0	1	0	3
OG0022810	0	3	0	0	0	3
OG0022811	0	3	0	0	0	3
OG0022812	0	3	0	0	0	3
OG0022813	0	3	0	0	0	3
OG0022814	0	3	0	0	0	3
OG0022815	0	3	0	0	0	3
OG0022816	0	1	0	1	1	3
OG0022817	0	3	0	0	0	3
OG0022818	0	3	0	0	0	3
OG0022819	0	3	0	0	0	3
OG0022820	0	3	0	0	0	3
OG0022821	0	3	0	0	0	3
OG0022822	0	3	0	0	0	3
OG0022823	0	3	0	0	0	3
OG0022824	0	3	0	0	0	3
OG0022825	0	3	0	0	0	3
OG0022826	0	3	0	0	0	3
OG0022827	0	3	0	0	0	3
OG0022828	0	3	0	0	0	3
OG0022829	0	3	0	0	0	3
OG0022830	0	3	0	0	0	3
OG0022831	0	3	0	0	0	3
OG0022832	0	3	0	0	0	3
OG0022833	0	3	0	0	0	3
OG0022834	0	3	0	0	0	3
OG0022835	0	3	0	0	0	3
OG0022836	0	3	0	0	0	3
OG0022837	0	3	0	0	0	3
OG0022838	0	2	1	0	0	3
OG0022839	0	3	0	0	0	3
OG0022840	0	3	0	0	0	3
OG0022841	0	3	0	0	0	3
OG0022842	0	3	0	0	0	3
OG0022843	0	3	0	0	0	3
OG0022844	0	2	0	1	0	3
OG0022845	0	2	1	0	0	3
OG0022846	0	3	0	0	0	3
OG0022847	0	3	0	0	0	3
OG0022848	0	3	0	0	0	3
OG0022849	0	3	0	0	0	3
OG0022850	0	3	0	0	0	3
OG0022851	0	3	0	0	0	3
OG0022852	0	3	0	0	0	3
OG0022853	0	3	0	0	0	3
OG0022854	0	3	0	0	0	3
OG0022855	0	3	0	0	0	3
OG0022856	0	3	0	0	0	3
OG0022857	0	3	0	0	0	3
OG0022858	0	3	0	0	0	3
OG0022859	0	2	1	0	0	3
OG0022860	0	3	0	0	0	3
OG0022861	0	3	0	0	0	3
OG0022862	0	3	0	0	0	3
OG0022863	0	3	0	0	0	3
OG0022864	0	2	0	1	0	3
OG0022865	0	3	0	0	0	3
OG0022866	0	3	0	0	0	3
OG0022867	0	3	0	0	0	3
OG0022868	0	3	0	0	0	3
OG0022869	0	3	0	0	0	3
OG0022870	0	3	0	0	0	3
OG0022871	0	3	0	0	0	3
OG0022872	0	3	0	0	0	3
OG0022873	0	3	0	0	0	3
OG0022874	0	3	0	0	0	3
OG0022875	0	2	0	1	0	3
OG0022876	0	2	0	1	0	3
OG0022877	0	3	0	0	0	3
OG0022878	0	3	0	0	0	3
OG0022879	0	3	0	0	0	3
OG0022880	0	3	0	0	0	3
OG0022881	0	3	0	0	0	3
OG0022882	0	3	0	0	0	3
OG0022883	0	3	0	0	0	3
OG0022884	0	3	0	0	0	3
OG0022885	0	3	0	0	0	3
OG0022886	0	3	0	0	0	3
OG0022887	0	3	0	0	0	3
OG0022888	0	2	0	1	0	3
OG0022889	0	3	0	0	0	3
OG0022890	0	3	0	0	0	3
OG0022891	0	3	0	0	0	3
OG0022892	0	3	0	0	0	3
OG0022893	0	3	0	0	0	3
OG0022894	0	3	0	0	0	3
OG0022895	0	3	0	0	0	3
OG0022896	0	3	0	0	0	3
OG0022897	0	3	0	0	0	3
OG0022898	0	3	0	0	0	3
OG0022899	0	3	0	0	0	3
OG0022900	0	3	0	0	0	3
OG0022901	0	3	0	0	0	3
OG0022902	0	3	0	0	0	3
OG0022903	0	2	0	1	0	3
OG0022904	0	2	0	1	0	3
OG0022905	0	3	0	0	0	3
OG0022906	0	3	0	0	0	3
OG0022907	0	3	0	0	0	3
OG0022908	0	3	0	0	0	3
OG0022909	0	3	0	0	0	3
OG0022910	0	3	0	0	0	3
OG0022911	0	2	1	0	0	3
OG0022912	0	3	0	0	0	3
OG0022913	0	3	0	0	0	3
OG0022914	0	3	0	0	0	3
OG0022915	0	3	0	0	0	3
OG0022916	0	3	0	0	0	3
OG0022917	0	3	0	0	0	3
OG0022918	0	3	0	0	0	3
OG0022919	0	3	0	0	0	3
OG0022920	0	3	0	0	0	3
OG0022921	0	3	0	0	0	3
OG0022922	0	3	0	0	0	3
OG0022923	0	3	0	0	0	3
OG0022924	0	3	0	0	0	3
OG0022925	0	3	0	0	0	3
OG0022926	0	2	0	1	0	3
OG0022927	0	3	0	0	0	3
OG0022928	0	3	0	0	0	3
OG0022929	0	3	0	0	0	3
OG0022930	0	3	0	0	0	3
OG0022931	0	3	0	0	0	3
OG0022932	0	3	0	0	0	3
OG0022933	0	3	0	0	0	3
OG0022934	0	3	0	0	0	3
OG0022935	0	2	0	0	1	3
OG0022936	0	3	0	0	0	3
OG0022937	0	3	0	0	0	3
OG0022938	0	3	0	0	0	3
OG0022939	0	3	0	0	0	3
OG0022940	0	3	0	0	0	3
OG0022941	0	3	0	0	0	3
OG0022942	0	3	0	0	0	3
OG0022943	0	3	0	0	0	3
OG0022944	0	3	0	0	0	3
OG0022945	0	3	0	0	0	3
OG0022946	0	3	0	0	0	3
OG0022947	0	3	0	0	0	3
OG0022948	0	3	0	0	0	3
OG0022949	0	3	0	0	0	3
OG0022950	0	3	0	0	0	3
OG0022951	0	3	0	0	0	3
OG0022952	0	3	0	0	0	3
OG0022953	0	3	0	0	0	3
OG0022954	0	3	0	0	0	3
OG0022955	0	3	0	0	0	3
OG0022956	0	3	0	0	0	3
OG0022957	0	3	0	0	0	3
OG0022958	0	3	0	0	0	3
OG0022959	0	2	0	1	0	3
OG0022960	0	3	0	0	0	3
OG0022961	0	3	0	0	0	3
OG0022962	0	3	0	0	0	3
OG0022963	0	3	0	0	0	3
OG0022964	0	3	0	0	0	3
OG0022965	0	3	0	0	0	3
OG0022966	0	3	0	0	0	3
OG0022967	0	3	0	0	0	3
OG0022968	0	3	0	0	0	3
OG0022969	0	3	0	0	0	3
OG0022970	0	3	0	0	0	3
OG0022971	0	3	0	0	0	3
OG0022972	0	3	0	0	0	3
OG0022973	0	1	2	0	0	3
OG0022974	0	3	0	0	0	3
OG0022975	0	2	1	0	0	3
OG0022976	0	3	0	0	0	3
OG0022977	0	3	0	0	0	3
OG0022978	0	3	0	0	0	3
OG0022979	0	3	0	0	0	3
OG0022980	0	3	0	0	0	3
OG0022981	0	3	0	0	0	3
OG0022982	0	3	0	0	0	3
OG0022983	0	2	0	1	0	3
OG0022984	0	3	0	0	0	3
OG0022985	0	3	0	0	0	3
OG0022986	0	1	1	0	1	3
OG0022987	0	3	0	0	0	3
OG0022988	0	3	0	0	0	3
OG0022989	0	3	0	0	0	3
OG0022990	0	3	0	0	0	3
OG0022991	0	3	0	0	0	3
OG0022992	0	3	0	0	0	3
OG0022993	0	2	0	1	0	3
OG0022994	0	3	0	0	0	3
OG0022995	0	3	0	0	0	3
OG0022996	0	3	0	0	0	3
OG0022997	0	3	0	0	0	3
OG0022998	0	3	0	0	0	3
OG0022999	0	3	0	0	0	3
OG0023000	0	3	0	0	0	3
OG0023001	0	3	0	0	0	3
OG0023002	0	3	0	0	0	3
OG0023003	0	3	0	0	0	3
OG0023004	0	3	0	0	0	3
OG0023005	0	3	0	0	0	3
OG0023006	0	3	0	0	0	3
OG0023007	0	3	0	0	0	3
OG0023008	0	3	0	0	0	3
OG0023009	0	3	0	0	0	3
OG0023010	0	3	0	0	0	3
OG0023011	0	3	0	0	0	3
OG0023012	0	3	0	0	0	3
OG0023013	0	3	0	0	0	3
OG0023014	0	3	0	0	0	3
OG0023015	0	3	0	0	0	3
OG0023016	0	3	0	0	0	3
OG0023017	0	3	0	0	0	3
OG0023018	0	3	0	0	0	3
OG0023019	0	3	0	0	0	3
OG0023020	0	3	0	0	0	3
OG0023021	0	3	0	0	0	3
OG0023022	0	3	0	0	0	3
OG0023023	0	3	0	0	0	3
OG0023024	0	3	0	0	0	3
OG0023025	0	3	0	0	0	3
OG0023026	0	2	1	0	0	3
OG0023027	0	2	0	1	0	3
OG0023028	0	3	0	0	0	3
OG0023029	0	3	0	0	0	3
OG0023030	0	3	0	0	0	3
OG0023031	0	2	1	0	0	3
OG0023032	0	3	0	0	0	3
OG0023033	0	3	0	0	0	3
OG0023034	0	3	0	0	0	3
OG0023035	0	3	0	0	0	3
OG0023036	0	3	0	0	0	3
OG0023037	0	3	0	0	0	3
OG0023038	0	3	0	0	0	3
OG0023039	0	3	0	0	0	3
OG0023040	0	3	0	0	0	3
OG0023041	0	3	0	0	0	3
OG0023042	0	3	0	0	0	3
OG0023043	0	3	0	0	0	3
OG0023044	0	3	0	0	0	3
OG0023045	0	3	0	0	0	3
OG0023046	0	3	0	0	0	3
OG0023047	0	3	0	0	0	3
OG0023048	0	3	0	0	0	3
OG0023049	0	3	0	0	0	3
OG0023050	0	3	0	0	0	3
OG0023051	0	3	0	0	0	3
OG0023052	0	3	0	0	0	3
OG0023053	0	3	0	0	0	3
OG0023054	0	3	0	0	0	3
OG0023055	0	3	0	0	0	3
OG0023056	0	3	0	0	0	3
OG0023057	0	3	0	0	0	3
OG0023058	0	3	0	0	0	3
OG0023059	0	3	0	0	0	3
OG0023060	0	3	0	0	0	3
OG0023061	0	3	0	0	0	3
OG0023062	0	3	0	0	0	3
OG0023063	0	2	1	0	0	3
OG0023064	0	3	0	0	0	3
OG0023065	0	3	0	0	0	3
OG0023066	0	3	0	0	0	3
OG0023067	0	3	0	0	0	3
OG0023068	0	3	0	0	0	3
OG0023069	0	2	0	1	0	3
OG0023070	0	3	0	0	0	3
OG0023071	0	3	0	0	0	3
OG0023072	0	3	0	0	0	3
OG0023073	0	3	0	0	0	3
OG0023074	0	3	0	0	0	3
OG0023075	0	3	0	0	0	3
OG0023076	0	3	0	0	0	3
OG0023077	0	3	0	0	0	3
OG0023078	0	3	0	0	0	3
OG0023079	0	3	0	0	0	3
OG0023080	0	3	0	0	0	3
OG0023081	0	3	0	0	0	3
OG0023082	0	3	0	0	0	3
OG0023083	0	3	0	0	0	3
OG0023084	0	3	0	0	0	3
OG0023085	0	2	0	1	0	3
OG0023086	0	3	0	0	0	3
OG0023087	0	3	0	0	0	3
OG0023088	0	3	0	0	0	3
OG0023089	0	1	2	0	0	3
OG0023090	0	3	0	0	0	3
OG0023091	0	3	0	0	0	3
OG0023092	0	3	0	0	0	3
OG0023093	0	3	0	0	0	3
OG0023094	0	2	0	1	0	3
OG0023095	0	3	0	0	0	3
OG0023096	0	3	0	0	0	3
OG0023097	0	3	0	0	0	3
OG0023098	0	3	0	0	0	3
OG0023099	0	3	0	0	0	3
OG0023100	0	2	0	0	1	3
OG0023101	0	3	0	0	0	3
OG0023102	0	3	0	0	0	3
OG0023103	0	3	0	0	0	3
OG0023104	0	3	0	0	0	3
OG0023105	0	3	0	0	0	3
OG0023106	0	3	0	0	0	3
OG0023107	0	3	0	0	0	3
OG0023108	0	3	0	0	0	3
OG0023109	0	3	0	0	0	3
OG0023110	0	2	1	0	0	3
OG0023111	0	3	0	0	0	3
OG0023112	0	3	0	0	0	3
OG0023113	0	3	0	0	0	3
OG0023114	0	3	0	0	0	3
OG0023115	0	3	0	0	0	3
OG0023116	0	3	0	0	0	3
OG0023117	0	3	0	0	0	3
OG0023118	0	3	0	0	0	3
OG0023119	0	1	2	0	0	3
OG0023120	0	3	0	0	0	3
OG0023121	0	3	0	0	0	3
OG0023122	0	3	0	0	0	3
OG0023123	0	3	0	0	0	3
OG0023124	0	3	0	0	0	3
OG0023125	0	3	0	0	0	3
OG0023126	0	3	0	0	0	3
OG0023127	0	3	0	0	0	3
OG0023128	0	3	0	0	0	3
OG0023129	0	3	0	0	0	3
OG0023130	0	3	0	0	0	3
OG0023131	0	2	0	1	0	3
OG0023132	0	3	0	0	0	3
OG0023133	0	3	0	0	0	3
OG0023134	0	3	0	0	0	3
OG0023135	0	3	0	0	0	3
OG0023136	0	3	0	0	0	3
OG0023137	0	3	0	0	0	3
OG0023138	0	3	0	0	0	3
OG0023139	0	3	0	0	0	3
OG0023140	0	3	0	0	0	3
OG0023141	0	3	0	0	0	3
OG0023142	0	3	0	0	0	3
OG0023143	0	3	0	0	0	3
OG0023144	0	3	0	0	0	3
OG0023145	0	3	0	0	0	3
OG0023146	0	3	0	0	0	3
OG0023147	0	3	0	0	0	3
OG0023148	0	3	0	0	0	3
OG0023149	0	3	0	0	0	3
OG0023150	0	3	0	0	0	3
OG0023151	0	3	0	0	0	3
OG0023152	0	3	0	0	0	3
OG0023153	0	3	0	0	0	3
OG0023154	0	3	0	0	0	3
OG0023155	0	3	0	0	0	3
OG0023156	0	2	0	1	0	3
OG0023157	0	2	0	1	0	3
OG0023158	0	3	0	0	0	3
OG0023159	0	3	0	0	0	3
OG0023160	0	3	0	0	0	3
OG0023161	0	1	1	1	0	3
OG0023162	0	3	0	0	0	3
OG0023163	0	2	1	0	0	3
OG0023164	0	3	0	0	0	3
OG0023165	0	3	0	0	0	3
OG0023166	0	3	0	0	0	3
OG0023167	0	3	0	0	0	3
OG0023168	0	3	0	0	0	3
OG0023169	0	2	0	0	1	3
OG0023170	0	3	0	0	0	3
OG0023171	0	3	0	0	0	3
OG0023172	0	3	0	0	0	3
OG0023173	0	3	0	0	0	3
OG0023174	0	3	0	0	0	3
OG0023175	0	3	0	0	0	3
OG0023176	0	3	0	0	0	3
OG0023177	0	1	2	0	0	3
OG0023178	0	3	0	0	0	3
OG0023179	0	3	0	0	0	3
OG0023180	0	2	1	0	0	3
OG0023181	0	3	0	0	0	3
OG0023182	0	3	0	0	0	3
OG0023183	0	3	0	0	0	3
OG0023184	0	3	0	0	0	3
OG0023185	0	2	0	1	0	3
OG0023186	0	3	0	0	0	3
OG0023187	0	3	0	0	0	3
OG0023188	0	3	0	0	0	3
OG0023189	0	3	0	0	0	3
OG0023190	0	3	0	0	0	3
OG0023191	0	3	0	0	0	3
OG0023192	0	3	0	0	0	3
OG0023193	0	3	0	0	0	3
OG0023194	0	1	2	0	0	3
OG0023195	0	3	0	0	0	3
OG0023196	0	3	0	0	0	3
OG0023197	0	3	0	0	0	3
OG0023198	0	3	0	0	0	3
OG0023199	0	3	0	0	0	3
OG0023200	0	3	0	0	0	3
OG0023201	0	3	0	0	0	3
OG0023202	0	3	0	0	0	3
OG0023203	0	3	0	0	0	3
OG0023204	0	3	0	0	0	3
OG0023205	0	3	0	0	0	3
OG0023206	0	3	0	0	0	3
OG0023207	0	1	2	0	0	3
OG0023208	0	3	0	0	0	3
OG0023209	0	1	0	1	1	3
OG0023210	0	3	0	0	0	3
OG0023211	0	3	0	0	0	3
OG0023212	0	3	0	0	0	3
OG0023213	0	3	0	0	0	3
OG0023214	0	3	0	0	0	3
OG0023215	0	3	0	0	0	3
OG0023216	0	3	0	0	0	3
OG0023217	0	3	0	0	0	3
OG0023218	0	3	0	0	0	3
OG0023219	0	3	0	0	0	3
OG0023220	0	3	0	0	0	3
OG0023221	0	1	1	1	0	3
OG0023222	0	3	0	0	0	3
OG0023223	0	3	0	0	0	3
OG0023224	0	3	0	0	0	3
OG0023225	0	3	0	0	0	3
OG0023226	0	3	0	0	0	3
OG0023227	0	3	0	0	0	3
OG0023228	0	3	0	0	0	3
OG0023229	0	1	2	0	0	3
OG0023230	0	3	0	0	0	3
OG0023231	0	3	0	0	0	3
OG0023232	0	3	0	0	0	3
OG0023233	0	3	0	0	0	3
OG0023234	0	3	0	0	0	3
OG0023235	0	3	0	0	0	3
OG0023236	0	3	0	0	0	3
OG0023237	0	3	0	0	0	3
OG0023238	0	3	0	0	0	3
OG0023239	0	3	0	0	0	3
OG0023240	0	3	0	0	0	3
OG0023241	0	3	0	0	0	3
OG0023242	0	3	0	0	0	3
OG0023243	0	3	0	0	0	3
OG0023244	0	3	0	0	0	3
OG0023245	0	3	0	0	0	3
OG0023246	0	3	0	0	0	3
OG0023247	0	3	0	0	0	3
OG0023248	0	1	2	0	0	3
OG0023249	0	3	0	0	0	3
OG0023250	0	3	0	0	0	3
OG0023251	0	3	0	0	0	3
OG0023252	0	3	0	0	0	3
OG0023253	0	3	0	0	0	3
OG0023254	0	3	0	0	0	3
OG0023255	0	3	0	0	0	3
OG0023256	0	3	0	0	0	3
OG0023257	0	3	0	0	0	3
OG0023258	0	3	0	0	0	3
OG0023259	0	3	0	0	0	3
OG0023260	0	2	1	0	0	3
OG0023261	0	3	0	0	0	3
OG0023262	0	3	0	0	0	3
OG0023263	0	3	0	0	0	3
OG0023264	0	3	0	0	0	3
OG0023265	0	2	0	1	0	3
OG0023266	0	3	0	0	0	3
OG0023267	0	3	0	0	0	3
OG0023268	0	3	0	0	0	3
OG0023269	0	3	0	0	0	3
OG0023270	0	3	0	0	0	3
OG0023271	0	3	0	0	0	3
OG0023272	0	3	0	0	0	3
OG0023273	0	3	0	0	0	3
OG0023274	0	3	0	0	0	3
OG0023275	0	3	0	0	0	3
OG0023276	0	3	0	0	0	3
OG0023277	0	3	0	0	0	3
OG0023278	0	3	0	0	0	3
OG0023279	0	3	0	0	0	3
OG0023280	0	1	0	1	1	3
OG0023281	0	3	0	0	0	3
OG0023282	0	3	0	0	0	3
OG0023283	0	3	0	0	0	3
OG0023284	0	3	0	0	0	3
OG0023285	0	3	0	0	0	3
OG0023286	0	2	0	1	0	3
OG0023287	0	3	0	0	0	3
OG0023288	0	2	1	0	0	3
OG0023289	0	3	0	0	0	3
OG0023290	0	3	0	0	0	3
OG0023291	0	3	0	0	0	3
OG0023292	0	3	0	0	0	3
OG0023293	0	3	0	0	0	3
OG0023294	0	2	0	1	0	3
OG0023295	0	3	0	0	0	3
OG0023296	0	3	0	0	0	3
OG0023297	0	2	1	0	0	3
OG0023298	0	3	0	0	0	3
OG0023299	0	1	0	0	2	3
OG0023300	0	3	0	0	0	3
OG0023301	0	3	0	0	0	3
OG0023302	0	3	0	0	0	3
OG0023303	0	3	0	0	0	3
OG0023304	0	3	0	0	0	3
OG0023305	0	3	0	0	0	3
OG0023306	0	3	0	0	0	3
OG0023307	0	3	0	0	0	3
OG0023308	0	1	1	0	1	3
OG0023309	0	3	0	0	0	3
OG0023310	0	2	1	0	0	3
OG0023311	0	3	0	0	0	3
OG0023312	0	3	0	0	0	3
OG0023313	0	3	0	0	0	3
OG0023314	0	3	0	0	0	3
OG0023315	0	3	0	0	0	3
OG0023316	0	3	0	0	0	3
OG0023317	0	2	0	1	0	3
OG0023318	0	1	1	1	0	3
OG0023319	0	3	0	0	0	3
OG0023320	0	3	0	0	0	3
OG0023321	0	1	0	0	2	3
OG0023322	0	3	0	0	0	3
OG0023323	0	3	0	0	0	3
OG0023324	0	2	1	0	0	3
OG0023325	0	3	0	0	0	3
OG0023326	0	3	0	0	0	3
OG0023327	0	2	0	1	0	3
OG0023328	0	3	0	0	0	3
OG0023329	0	3	0	0	0	3
OG0023330	0	3	0	0	0	3
OG0023331	0	3	0	0	0	3
OG0023332	0	3	0	0	0	3
OG0023333	0	2	1	0	0	3
OG0023334	0	3	0	0	0	3
OG0023335	0	3	0	0	0	3
OG0023336	0	2	0	1	0	3
OG0023337	0	3	0	0	0	3
OG0023338	0	3	0	0	0	3
OG0023339	0	3	0	0	0	3
OG0023340	0	3	0	0	0	3
OG0023341	0	2	0	1	0	3
OG0023342	0	2	1	0	0	3
OG0023343	0	2	0	1	0	3
OG0023344	0	3	0	0	0	3
OG0023345	0	2	1	0	0	3
OG0023346	0	3	0	0	0	3
OG0023347	0	2	1	0	0	3
OG0023348	0	3	0	0	0	3
OG0023349	0	1	1	0	1	3
OG0023350	0	3	0	0	0	3
OG0023351	0	3	0	0	0	3
OG0023352	0	3	0	0	0	3
OG0023353	0	3	0	0	0	3
OG0023354	0	1	0	1	1	3
OG0023355	0	3	0	0	0	3
OG0023356	0	2	0	1	0	3
OG0023357	0	3	0	0	0	3
OG0023358	0	2	0	1	0	3
OG0023359	0	2	0	0	1	3
OG0023360	0	3	0	0	0	3
OG0023361	0	2	0	1	0	3
OG0023362	0	3	0	0	0	3
OG0023363	0	3	0	0	0	3
OG0023364	0	3	0	0	0	3
OG0023365	0	3	0	0	0	3
OG0023366	0	3	0	0	0	3
OG0023367	0	3	0	0	0	3
OG0023368	0	3	0	0	0	3
OG0023369	0	2	0	1	0	3
OG0023370	0	3	0	0	0	3
OG0023371	0	3	0	0	0	3
OG0023372	0	3	0	0	0	3
OG0023373	0	3	0	0	0	3
OG0023374	0	3	0	0	0	3
OG0023375	0	2	1	0	0	3
OG0023376	0	1	1	0	1	3
OG0023377	0	3	0	0	0	3
OG0023378	0	3	0	0	0	3
OG0023379	0	3	0	0	0	3
OG0023380	0	3	0	0	0	3
OG0023381	0	2	0	0	1	3
OG0023382	0	3	0	0	0	3
OG0023383	0	2	1	0	0	3
OG0023384	0	3	0	0	0	3
OG0023385	0	3	0	0	0	3
OG0023386	0	3	0	0	0	3
OG0023387	0	3	0	0	0	3
OG0023388	0	3	0	0	0	3
OG0023389	0	3	0	0	0	3
OG0023390	0	3	0	0	0	3
OG0023391	0	1	1	1	0	3
OG0023392	0	1	2	0	0	3
OG0023393	0	3	0	0	0	3
OG0023394	0	3	0	0	0	3
OG0023395	0	2	1	0	0	3
OG0023396	0	3	0	0	0	3
OG0023397	0	3	0	0	0	3
OG0023398	0	3	0	0	0	3
OG0023399	0	3	0	0	0	3
OG0023400	0	3	0	0	0	3
OG0023401	0	3	0	0	0	3
OG0023402	0	3	0	0	0	3
OG0023403	0	3	0	0	0	3
OG0023404	0	3	0	0	0	3
OG0023405	0	3	0	0	0	3
OG0023406	0	3	0	0	0	3
OG0023407	0	3	0	0	0	3
OG0023408	0	1	1	1	0	3
OG0023409	0	3	0	0	0	3
OG0023410	0	2	0	1	0	3
OG0023411	0	3	0	0	0	3
OG0023412	0	3	0	0	0	3
OG0023413	0	2	0	1	0	3
OG0023414	0	3	0	0	0	3
OG0023415	0	2	0	0	1	3
OG0023416	0	2	0	1	0	3
OG0023417	0	3	0	0	0	3
OG0023418	0	3	0	0	0	3
OG0023419	0	2	1	0	0	3
OG0023420	0	3	0	0	0	3
OG0023421	0	3	0	0	0	3
OG0023422	0	3	0	0	0	3
OG0023423	0	3	0	0	0	3
OG0023424	0	1	0	1	1	3
OG0023425	0	1	1	1	0	3
OG0023426	0	3	0	0	0	3
OG0023427	0	3	0	0	0	3
OG0023428	0	2	1	0	0	3
OG0023429	0	2	0	1	0	3
OG0023430	0	3	0	0	0	3
OG0023431	0	3	0	0	0	3
OG0023432	0	3	0	0	0	3
OG0023433	0	3	0	0	0	3
OG0023434	0	3	0	0	0	3
OG0023435	0	3	0	0	0	3
OG0023436	0	3	0	0	0	3
OG0023437	0	3	0	0	0	3
OG0023438	0	3	0	0	0	3
OG0023439	0	3	0	0	0	3
OG0023440	0	3	0	0	0	3
OG0023441	0	3	0	0	0	3
OG0023442	0	3	0	0	0	3
OG0023443	0	3	0	0	0	3
OG0023444	0	3	0	0	0	3
OG0023445	0	3	0	0	0	3
OG0023446	0	3	0	0	0	3
OG0023447	0	3	0	0	0	3
OG0023448	0	3	0	0	0	3
OG0023449	0	1	2	0	0	3
OG0023450	0	3	0	0	0	3
OG0023451	0	3	0	0	0	3
OG0023452	0	3	0	0	0	3
OG0023453	0	3	0	0	0	3
OG0023454	0	2	0	0	1	3
OG0023455	0	3	0	0	0	3
OG0023456	0	3	0	0	0	3
OG0023457	0	2	0	0	1	3
OG0023458	0	3	0	0	0	3
OG0023459	0	3	0	0	0	3
OG0023460	0	3	0	0	0	3
OG0023461	0	1	2	0	0	3
OG0023462	0	2	0	0	1	3
OG0023463	0	1	2	0	0	3
OG0023464	0	3	0	0	0	3
OG0023465	0	1	1	1	0	3
OG0023466	0	3	0	0	0	3
OG0023467	0	3	0	0	0	3
OG0023468	0	1	2	0	0	3
OG0023469	0	3	0	0	0	3
OG0023470	0	3	0	0	0	3
OG0023471	0	3	0	0	0	3
OG0023472	0	3	0	0	0	3
OG0023473	0	3	0	0	0	3
OG0023474	0	3	0	0	0	3
OG0023475	0	2	0	1	0	3
OG0023476	0	2	0	1	0	3
OG0023477	0	1	2	0	0	3
OG0023478	0	3	0	0	0	3
OG0023479	0	3	0	0	0	3
OG0023480	0	3	0	0	0	3
OG0023481	0	3	0	0	0	3
OG0023482	0	3	0	0	0	3
OG0023483	0	2	1	0	0	3
OG0023484	0	3	0	0	0	3
OG0023485	0	3	0	0	0	3
OG0023486	0	3	0	0	0	3
OG0023487	0	3	0	0	0	3
OG0023488	0	3	0	0	0	3
OG0023489	0	1	2	0	0	3
OG0023490	0	3	0	0	0	3
OG0023491	0	3	0	0	0	3
OG0023492	0	3	0	0	0	3
OG0023493	0	1	1	0	1	3
OG0023494	0	3	0	0	0	3
OG0023495	0	3	0	0	0	3
OG0023496	0	3	0	0	0	3
OG0023497	0	1	0	2	0	3
OG0023498	0	1	2	0	0	3
OG0023499	0	3	0	0	0	3
OG0023500	0	2	0	1	0	3
OG0023501	0	3	0	0	0	3
OG0023502	0	3	0	0	0	3
OG0023503	0	1	2	0	0	3
OG0023504	0	3	0	0	0	3
OG0023505	0	3	0	0	0	3
OG0023506	0	3	0	0	0	3
OG0023507	0	3	0	0	0	3
OG0023508	0	2	0	1	0	3
OG0023509	0	1	2	0	0	3
OG0023510	0	3	0	0	0	3
OG0023511	0	3	0	0	0	3
OG0023512	0	3	0	0	0	3
OG0023513	0	3	0	0	0	3
OG0023514	0	1	0	1	1	3
OG0023515	0	3	0	0	0	3
OG0023516	0	1	1	0	1	3
OG0023517	0	3	0	0	0	3
OG0023518	0	3	0	0	0	3
OG0023519	0	2	0	1	0	3
OG0023520	0	3	0	0	0	3
OG0023521	0	1	0	1	1	3
OG0023522	0	3	0	0	0	3
OG0023523	0	1	0	1	1	3
OG0023524	0	1	1	1	0	3
OG0023525	0	1	0	2	0	3
OG0023526	0	3	0	0	0	3
OG0023527	0	3	0	0	0	3
OG0023528	0	1	2	0	0	3
OG0023529	0	1	1	0	1	3
OG0023530	0	1	2	0	0	3
OG0023531	0	1	0	0	2	3
OG0023532	0	1	2	0	0	3
OG0023533	0	2	1	0	0	3
OG0023534	0	1	0	0	2	3
OG0023535	0	3	0	0	0	3
OG0023536	0	1	1	0	1	3
OG0023537	0	1	2	0	0	3
OG0023538	0	1	0	2	0	3
OG0023539	0	1	2	0	0	3
OG0023540	0	0	2	0	1	3
OG0023541	0	0	1	1	1	3
OG0023542	0	0	1	1	1	3
OG0023543	0	0	2	0	1	3
OG0023544	0	0	1	1	1	3
OG0023545	0	0	1	1	1	3
OG0023546	0	0	3	0	0	3
OG0023547	0	0	1	2	0	3
OG0023548	0	0	2	0	1	3
OG0023549	0	0	3	0	0	3
OG0023550	0	0	3	0	0	3
OG0023551	0	0	1	0	2	3
OG0023552	0	0	1	1	1	3
OG0023553	0	0	3	0	0	3
OG0023554	0	0	3	0	0	3
OG0023555	0	0	1	1	1	3
OG0023556	0	0	2	0	1	3
OG0023557	0	0	1	1	1	3
OG0023558	0	0	1	1	1	3
OG0023559	0	0	1	1	1	3
OG0023560	0	0	2	0	1	3
OG0023561	0	0	3	0	0	3
OG0023562	0	0	3	0	0	3
OG0023563	0	0	3	0	0	3
OG0023564	0	0	2	1	0	3
OG0023565	0	0	3	0	0	3
OG0023566	0	0	2	0	1	3
OG0023567	0	0	3	0	0	3
OG0023568	0	0	1	0	2	3
OG0023569	0	0	2	0	1	3
OG0023570	0	0	3	0	0	3
OG0023571	0	0	3	0	0	3
OG0023572	0	0	3	0	0	3
OG0023573	0	0	2	0	1	3
OG0023574	0	0	3	0	0	3
OG0023575	0	0	1	0	2	3
OG0023576	0	0	3	0	0	3
OG0023577	0	0	2	0	1	3
OG0023578	0	0	1	1	1	3
OG0023579	0	0	3	0	0	3
OG0023580	0	0	2	0	1	3
OG0023581	0	0	1	1	1	3
OG0023582	0	0	2	0	1	3
OG0023583	0	0	3	0	0	3
OG0023584	0	0	3	0	0	3
OG0023585	0	0	3	0	0	3
OG0023586	0	0	2	1	0	3
OG0023587	0	0	1	1	1	3
OG0023588	0	0	1	0	2	3
OG0023589	0	0	1	0	2	3
OG0023590	0	0	3	0	0	3
OG0023591	0	0	3	0	0	3
OG0023592	0	0	1	1	1	3
OG0023593	0	0	1	1	1	3
OG0023594	0	0	3	0	0	3
OG0023595	0	0	1	1	1	3
OG0023596	0	0	1	1	1	3
OG0023597	0	0	1	0	2	3
OG0023598	0	0	3	0	0	3
OG0023599	0	0	1	1	1	3
OG0023600	0	0	1	1	1	3
OG0023601	0	0	3	0	0	3
OG0023602	0	0	3	0	0	3
OG0023603	0	0	2	0	1	3
OG0023604	0	0	1	0	2	3
OG0023605	0	0	1	0	2	3
OG0023606	0	0	1	0	2	3
OG0023607	0	0	3	0	0	3
OG0023608	0	0	1	0	2	3
OG0023609	0	0	1	1	1	3
OG0023610	0	0	1	1	1	3
OG0023611	0	0	3	0	0	3
OG0023612	0	0	1	0	2	3
OG0023613	0	0	1	0	2	3
OG0023614	0	0	2	0	1	3
OG0023615	0	0	3	0	0	3
OG0023616	0	0	1	1	1	3
OG0023617	0	0	3	0	0	3
OG0023618	0	0	2	0	1	3
OG0023619	0	0	3	0	0	3
OG0023620	0	0	1	1	1	3
OG0023621	0	0	3	0	0	3
OG0023622	0	0	2	0	1	3
OG0023623	0	0	1	0	2	3
OG0023624	0	0	3	0	0	3
OG0023625	0	0	2	0	1	3
OG0023626	0	0	1	0	2	3
OG0023627	0	0	1	0	2	3
OG0023628	0	0	3	0	0	3
OG0023629	0	0	1	1	1	3
OG0023630	0	0	2	1	0	3
OG0023631	0	0	3	0	0	3
OG0023632	0	0	3	0	0	3
OG0023633	0	0	3	0	0	3
OG0023634	0	0	3	0	0	3
OG0023635	0	0	1	1	1	3
OG0023636	0	0	3	0	0	3
OG0023637	0	0	1	1	1	3
OG0023638	0	0	3	0	0	3
OG0023639	0	0	2	0	1	3
OG0023640	0	0	1	1	1	3
OG0023641	0	0	1	0	2	3
OG0023642	0	0	1	1	1	3
OG0023643	0	0	1	1	1	3
OG0023644	0	0	1	1	1	3
OG0023645	0	0	1	1	1	3
OG0023646	0	0	3	0	0	3
OG0023647	0	0	2	0	1	3
OG0023648	0	0	2	0	1	3
OG0023649	0	0	2	0	1	3
OG0023650	0	0	3	0	0	3
OG0023651	0	0	1	1	1	3
OG0023652	0	0	1	1	1	3
OG0023653	0	0	1	1	1	3
OG0023654	0	0	2	0	1	3
OG0023655	0	0	3	0	0	3
OG0023656	0	0	3	0	0	3
OG0023657	0	0	1	1	1	3
OG0023658	0	0	2	0	1	3
OG0023659	0	0	2	0	1	3
OG0023660	0	0	1	0	2	3
OG0023661	0	0	1	0	2	3
OG0023662	0	0	1	1	1	3
OG0023663	0	0	1	1	1	3
OG0023664	0	0	1	1	1	3
OG0023665	0	0	1	0	2	3
OG0023666	0	0	1	1	1	3
OG0023667	0	0	2	0	1	3
OG0023668	0	0	2	0	1	3
OG0023669	0	0	2	0	1	3
OG0023670	0	0	1	1	1	3
OG0023671	0	0	1	1	1	3
OG0023672	0	0	1	1	1	3
OG0023673	0	0	2	0	1	3
OG0023674	0	0	1	1	1	3
OG0023675	0	0	1	0	2	3
OG0023676	0	0	3	0	0	3
OG0023677	0	0	1	0	2	3
OG0023678	0	0	1	0	2	3
OG0023679	0	0	1	0	2	3
OG0023680	0	0	2	0	1	3
OG0023681	0	0	3	0	0	3
OG0023682	0	0	3	0	0	3
OG0023683	0	0	2	0	1	3
OG0023684	0	0	2	0	1	3
OG0023685	0	0	3	0	0	3
OG0023686	0	0	1	1	1	3
OG0023687	0	0	1	1	1	3
OG0023688	0	0	1	0	2	3
OG0023689	0	0	1	1	1	3
OG0023690	0	0	2	1	0	3
OG0023691	0	0	3	0	0	3
OG0023692	0	0	3	0	0	3
OG0023693	0	0	1	0	2	3
OG0023694	0	0	1	1	1	3
OG0023695	0	0	1	0	2	3
OG0023696	0	0	1	0	2	3
OG0023697	0	0	1	1	1	3
OG0023698	0	0	1	1	1	3
OG0023699	0	0	1	1	1	3
OG0023700	0	0	1	1	1	3
OG0023701	0	0	1	0	2	3
OG0023702	0	0	1	1	1	3
OG0023703	0	0	3	0	0	3
OG0023704	0	0	2	0	1	3
OG0023705	0	0	3	0	0	3
OG0023706	0	0	2	0	1	3
OG0023707	0	0	2	0	1	3
OG0023708	0	0	3	0	0	3
OG0023709	0	0	2	0	1	3
OG0023710	0	0	1	0	2	3
OG0023711	0	0	1	0	2	3
OG0023712	0	0	1	0	2	3
OG0023713	0	0	2	0	1	3
OG0023714	0	0	3	0	0	3
OG0023715	0	0	2	0	1	3
OG0023716	0	0	1	1	1	3
OG0023717	0	0	2	0	1	3
OG0023718	0	0	1	1	1	3
OG0023719	0	0	1	1	1	3
OG0023720	0	0	1	1	1	3
OG0023721	0	0	1	1	1	3
OG0023722	0	0	1	0	2	3
OG0023723	0	0	2	0	1	3
OG0023724	0	0	1	1	1	3
OG0023725	0	0	1	1	1	3
OG0023726	0	0	3	0	0	3
OG0023727	0	0	1	1	1	3
OG0023728	0	0	1	0	2	3
OG0023729	0	0	1	1	1	3
OG0023730	0	0	1	0	2	3
OG0023731	0	0	2	0	1	3
OG0023732	0	0	2	0	1	3
OG0023733	0	0	1	0	2	3
OG0023734	0	0	1	1	1	3
OG0023735	0	0	1	1	1	3
OG0023736	0	0	3	0	0	3
OG0023737	0	0	3	0	0	3
OG0023738	0	0	3	0	0	3
OG0023739	0	0	1	1	1	3
OG0023740	0	0	1	1	1	3
OG0023741	0	0	2	0	1	3
OG0023742	0	0	3	0	0	3
OG0023743	0	0	1	0	2	3
OG0023744	0	0	2	0	1	3
OG0023745	0	0	3	0	0	3
OG0023746	0	0	3	0	0	3
OG0023747	0	0	1	1	1	3
OG0023748	0	0	1	1	1	3
OG0023749	0	0	2	0	1	3
OG0023750	0	0	1	1	1	3
OG0023751	0	0	3	0	0	3
OG0023752	0	0	2	0	1	3
OG0023753	0	0	1	1	1	3
OG0023754	0	0	1	1	1	3
OG0023755	0	0	1	1	1	3
OG0023756	0	0	2	0	1	3
OG0023757	0	0	1	1	1	3
OG0023758	0	0	3	0	0	3
OG0023759	0	0	1	1	1	3
OG0023760	0	0	1	1	1	3
OG0023761	0	0	3	0	0	3
OG0023762	0	0	1	0	2	3
OG0023763	0	0	1	1	1	3
OG0023764	0	0	2	0	1	3
OG0023765	0	0	1	0	2	3
OG0023766	0	0	1	1	1	3
OG0023767	0	0	3	0	0	3
OG0023768	0	0	2	0	1	3
OG0023769	0	0	2	0	1	3
OG0023770	0	0	3	0	0	3
OG0023771	0	0	1	0	2	3
OG0023772	0	0	3	0	0	3
OG0023773	0	0	1	1	1	3
OG0023774	0	0	1	0	2	3
OG0023775	0	0	3	0	0	3
OG0023776	0	0	2	0	1	3
OG0023777	0	0	1	1	1	3
OG0023778	0	0	3	0	0	3
OG0023779	0	0	1	1	1	3
OG0023780	0	0	1	0	2	3
OG0023781	0	0	1	0	2	3
OG0023782	0	0	3	0	0	3
OG0023783	0	0	3	0	0	3
OG0023784	0	0	3	0	0	3
OG0023785	0	0	3	0	0	3
OG0023786	0	0	1	0	2	3
OG0023787	0	0	3	0	0	3
OG0023788	0	0	1	0	2	3
OG0023789	0	0	1	1	1	3
OG0023790	0	0	1	1	1	3
OG0023791	0	0	1	1	1	3
OG0023792	0	0	3	0	0	3
OG0023793	0	0	1	0	2	3
OG0023794	0	0	3	0	0	3
OG0023795	0	0	1	0	2	3
OG0023796	0	0	1	0	2	3
OG0023797	0	0	3	0	0	3
OG0023798	0	0	2	0	1	3
OG0023799	0	0	1	1	1	3
OG0023800	0	0	1	1	1	3
OG0023801	0	0	3	0	0	3
OG0023802	0	0	1	0	2	3
OG0023803	0	0	3	0	0	3
OG0023804	0	0	3	0	0	3
OG0023805	0	0	3	0	0	3
OG0023806	0	0	2	0	1	3
OG0023807	0	0	2	0	1	3
OG0023808	0	0	1	0	2	3
OG0023809	0	0	1	1	1	3
OG0023810	0	0	3	0	0	3
OG0023811	0	0	1	1	1	3
OG0023812	0	0	2	0	1	3
OG0023813	0	0	1	0	2	3
OG0023814	0	0	2	0	1	3
OG0023815	0	0	2	0	1	3
OG0023816	0	0	1	0	2	3
OG0023817	0	0	3	0	0	3
OG0023818	0	0	2	0	1	3
OG0023819	0	0	1	0	2	3
OG0023820	0	0	2	0	1	3
OG0023821	0	0	3	0	0	3
OG0023822	0	0	1	0	2	3
OG0023823	0	0	3	0	0	3
OG0023824	0	0	1	1	1	3
OG0023825	0	0	3	0	0	3
OG0023826	0	0	1	2	0	3
OG0023827	0	0	3	0	0	3
OG0023828	0	0	1	1	1	3
OG0023829	0	0	1	0	2	3
OG0023830	0	0	1	1	1	3
OG0023831	0	0	1	1	1	3
OG0023832	0	0	1	1	1	3
OG0023833	0	0	1	1	1	3
OG0023834	0	0	3	0	0	3
OG0023835	0	0	1	1	1	3
OG0023836	0	0	2	0	1	3
OG0023837	0	0	1	0	2	3
OG0023838	0	0	1	0	2	3
OG0023839	0	0	2	0	1	3
OG0023840	0	0	1	1	1	3
OG0023841	0	0	2	0	1	3
OG0023842	0	0	2	0	1	3
OG0023843	0	0	1	1	1	3
OG0023844	0	0	2	0	1	3
OG0023845	0	0	1	1	1	3
OG0023846	0	0	1	0	2	3
OG0023847	0	0	3	0	0	3
OG0023848	0	0	3	0	0	3
OG0023849	0	0	1	0	2	3
OG0023850	0	0	1	0	2	3
OG0023851	0	0	1	0	2	3
OG0023852	0	0	2	0	1	3
OG0023853	0	0	1	1	1	3
OG0023854	0	0	2	0	1	3
OG0023855	0	0	1	1	1	3
OG0023856	0	0	2	0	1	3
OG0023857	0	0	1	1	1	3
OG0023858	0	0	1	0	2	3
OG0023859	0	0	3	0	0	3
OG0023860	0	0	1	0	2	3
OG0023861	0	0	2	0	1	3
OG0023862	0	0	3	0	0	3
OG0023863	0	0	1	1	1	3
OG0023864	0	0	1	0	2	3
OG0023865	0	0	2	0	1	3
OG0023866	0	0	3	0	0	3
OG0023867	0	0	2	0	1	3
OG0023868	0	0	1	1	1	3
OG0023869	0	0	1	1	1	3
OG0023870	0	0	1	1	1	3
OG0023871	0	0	1	1	1	3
OG0023872	0	0	1	1	1	3
OG0023873	0	0	1	0	2	3
OG0023874	0	0	1	1	1	3
OG0023875	0	0	2	0	1	3
OG0023876	0	0	2	0	1	3
OG0023877	0	0	3	0	0	3
OG0023878	0	0	1	0	2	3
OG0023879	0	0	3	0	0	3
OG0023880	0	0	2	0	1	3
OG0023881	0	0	2	0	1	3
OG0023882	0	0	1	1	1	3
OG0023883	0	0	2	0	1	3
OG0023884	0	0	1	1	1	3
OG0023885	0	0	1	1	1	3
OG0023886	0	0	3	0	0	3
OG0023887	0	0	1	0	2	3
OG0023888	0	0	3	0	0	3
OG0023889	0	0	1	0	2	3
OG0023890	0	0	3	0	0	3
OG0023891	0	0	1	1	1	3
OG0023892	0	0	1	1	1	3
OG0023893	0	0	1	1	1	3
OG0023894	0	0	1	1	1	3
OG0023895	0	0	1	1	1	3
OG0023896	0	0	1	0	2	3
OG0023897	0	0	2	0	1	3
OG0023898	0	0	1	2	0	3
OG0023899	0	0	3	0	0	3
OG0023900	0	0	1	0	2	3
OG0023901	0	0	1	1	1	3
OG0023902	0	0	1	0	2	3
OG0023903	0	0	3	0	0	3
OG0023904	0	0	1	1	1	3
OG0023905	0	0	1	0	2	3
OG0023906	0	0	1	0	2	3
OG0023907	0	0	1	1	1	3
OG0023908	0	0	1	1	1	3
OG0023909	0	0	1	1	1	3
OG0023910	0	0	2	0	1	3
OG0023911	0	0	3	0	0	3
OG0023912	0	0	3	0	0	3
OG0023913	0	0	3	0	0	3
OG0023914	0	0	1	1	1	3
OG0023915	0	0	3	0	0	3
OG0023916	0	0	3	0	0	3
OG0023917	0	0	3	0	0	3
OG0023918	0	0	2	0	1	3
OG0023919	0	0	3	0	0	3
OG0023920	0	0	3	0	0	3
OG0023921	0	0	2	0	1	3
OG0023922	0	0	3	0	0	3
OG0023923	0	0	1	0	2	3
OG0023924	0	0	1	0	2	3
OG0023925	0	0	2	0	1	3
OG0023926	0	0	1	1	1	3
OG0023927	0	0	2	0	1	3
OG0023928	0	0	1	0	2	3
OG0023929	0	0	1	1	1	3
OG0023930	0	0	1	1	1	3
OG0023931	0	0	2	0	1	3
OG0023932	0	0	1	0	2	3
OG0023933	0	0	3	0	0	3
OG0023934	0	0	1	0	2	3
OG0023935	0	0	1	0	2	3
OG0023936	0	0	2	0	1	3
OG0023937	0	0	2	0	1	3
OG0023938	0	0	2	0	1	3
OG0023939	0	0	3	0	0	3
OG0023940	0	0	1	1	1	3
OG0023941	0	0	2	1	0	3
OG0023942	0	0	1	0	2	3
OG0023943	0	0	1	0	2	3
OG0023944	0	0	1	1	1	3
OG0023945	0	0	2	0	1	3
OG0023946	0	0	1	0	2	3
OG0023947	0	0	2	0	1	3
OG0023948	0	0	1	1	1	3
OG0023949	0	0	2	0	1	3
OG0023950	0	0	3	0	0	3
OG0023951	0	0	1	0	2	3
OG0023952	0	0	2	0	1	3
OG0023953	0	0	1	0	2	3
OG0023954	0	0	1	0	2	3
OG0023955	0	0	1	1	1	3
OG0023956	0	0	1	1	1	3
OG0023957	0	0	1	1	1	3
OG0023958	0	0	1	1	1	3
OG0023959	0	0	1	1	1	3
OG0023960	0	0	1	1	1	3
OG0023961	0	0	1	0	2	3
OG0023962	0	0	1	1	1	3
OG0023963	0	0	1	0	2	3
OG0023964	0	0	2	0	1	3
OG0023965	0	0	1	0	2	3
OG0023966	0	0	1	1	1	3
OG0023967	0	0	1	1	1	3
OG0023968	0	0	1	1	1	3
OG0023969	0	0	1	0	2	3
OG0023970	0	0	1	0	2	3
OG0023971	0	0	1	1	1	3
OG0023972	0	0	1	0	2	3
OG0023973	0	0	1	1	1	3
OG0023974	0	0	2	1	0	3
OG0023975	0	0	3	0	0	3
OG0023976	0	0	2	0	1	3
OG0023977	0	0	2	0	1	3
OG0023978	0	0	1	0	2	3
OG0023979	0	0	1	1	1	3
OG0023980	0	0	1	0	2	3
OG0023981	0	0	2	0	1	3
OG0023982	0	0	1	0	2	3
OG0023983	0	0	1	1	1	3
OG0023984	0	0	1	1	1	3
OG0023985	0	0	1	1	1	3
OG0023986	0	0	1	0	2	3
OG0023987	0	0	1	1	1	3
OG0023988	0	0	2	0	1	3
OG0023989	0	0	3	0	0	3
OG0023990	0	0	1	0	2	3
OG0023991	0	0	1	1	1	3
OG0023992	0	0	1	0	2	3
OG0023993	0	0	1	0	2	3
OG0023994	0	0	1	2	0	3
OG0023995	0	0	3	0	0	3
OG0023996	0	0	3	0	0	3
OG0023997	0	0	1	1	1	3
OG0023998	0	0	1	1	1	3
OG0023999	0	0	1	0	2	3
OG0024000	0	0	1	0	2	3
OG0024001	0	0	2	0	1	3
OG0024002	0	0	1	0	2	3
OG0024003	0	0	2	0	1	3
OG0024004	0	0	3	0	0	3
OG0024005	0	0	2	1	0	3
OG0024006	0	0	1	1	1	3
OG0024007	0	0	2	0	1	3
OG0024008	0	0	1	0	2	3
OG0024009	0	0	1	2	0	3
OG0024010	0	0	2	0	1	3
OG0024011	0	0	1	1	1	3
OG0024012	0	0	2	0	1	3
OG0024013	0	0	2	1	0	3
OG0024014	0	0	3	0	0	3
OG0024015	0	0	1	0	2	3
OG0024016	0	0	1	0	2	3
OG0024017	0	0	1	1	1	3
OG0024018	0	0	3	0	0	3
OG0024019	0	0	2	0	1	3
OG0024020	0	0	3	0	0	3
OG0024021	0	0	1	1	1	3
OG0024022	0	0	1	0	2	3
OG0024023	0	0	1	0	2	3
OG0024024	0	0	1	1	1	3
OG0024025	0	0	1	1	1	3
OG0024026	0	0	1	1	1	3
OG0024027	0	0	1	1	1	3
OG0024028	0	0	2	0	1	3
OG0024029	0	0	3	0	0	3
OG0024030	0	0	1	1	1	3
OG0024031	0	0	1	1	1	3
OG0024032	0	0	1	1	1	3
OG0024033	0	0	1	0	2	3
OG0024034	0	0	3	0	0	3
OG0024035	0	0	1	0	2	3
OG0024036	0	0	1	1	1	3
OG0024037	0	0	1	0	2	3
OG0024038	0	0	3	0	0	3
OG0024039	0	0	1	0	2	3
OG0024040	0	0	1	1	1	3
OG0024041	0	0	1	1	1	3
OG0024042	0	0	1	0	2	3
OG0024043	0	0	3	0	0	3
OG0024044	0	0	1	1	1	3
OG0024045	0	0	2	0	1	3
OG0024046	0	0	1	1	1	3
OG0024047	0	0	2	0	1	3
OG0024048	0	0	2	0	1	3
OG0024049	0	0	1	0	2	3
OG0024050	0	0	1	0	2	3
OG0024051	0	0	1	0	2	3
OG0024052	0	0	1	1	1	3
OG0024053	0	0	1	1	1	3
OG0024054	0	0	2	0	1	3
OG0024055	0	0	1	1	1	3
OG0024056	0	0	1	1	1	3
OG0024057	0	0	2	0	1	3
OG0024058	0	0	3	0	0	3
OG0024059	0	0	2	0	1	3
OG0024060	0	0	2	0	1	3
OG0024061	0	0	1	1	1	3
OG0024062	0	0	1	1	1	3
OG0024063	0	0	1	0	2	3
OG0024064	0	0	1	0	2	3
OG0024065	0	0	2	0	1	3
OG0024066	0	0	2	0	1	3
OG0024067	0	0	2	0	1	3
OG0024068	0	0	1	0	2	3
OG0024069	0	0	1	1	1	3
OG0024070	0	0	3	0	0	3
OG0024071	0	0	1	1	1	3
OG0024072	0	0	3	0	0	3
OG0024073	0	0	3	0	0	3
OG0024074	0	0	1	0	2	3
OG0024075	0	0	1	1	1	3
OG0024076	0	0	2	0	1	3
OG0024077	0	0	1	1	1	3
OG0024078	0	0	1	1	1	3
OG0024079	0	0	2	0	1	3
OG0024080	0	0	1	2	0	3
OG0024081	0	0	2	0	1	3
OG0024082	0	0	2	0	1	3
OG0024083	0	0	1	1	1	3
OG0024084	0	0	2	0	1	3
OG0024085	0	0	1	0	2	3
OG0024086	0	0	1	1	1	3
OG0024087	0	0	1	0	2	3
OG0024088	0	0	1	0	2	3
OG0024089	0	0	1	1	1	3
OG0024090	0	0	2	1	0	3
OG0024091	0	0	1	1	1	3
OG0024092	0	0	1	1	1	3
OG0024093	0	0	1	1	1	3
OG0024094	0	0	1	0	2	3
OG0024095	0	0	1	0	2	3
OG0024096	0	0	1	1	1	3
OG0024097	0	0	1	0	2	3
OG0024098	0	0	1	1	1	3
OG0024099	0	0	1	1	1	3
OG0024100	0	0	1	1	1	3
OG0024101	0	0	1	1	1	3
OG0024102	0	0	1	1	1	3
OG0024103	0	0	3	0	0	3
OG0024104	0	0	2	0	1	3
OG0024105	0	0	1	0	2	3
OG0024106	0	0	1	1	1	3
OG0024107	0	0	1	1	1	3
OG0024108	0	0	1	0	2	3
OG0024109	0	0	2	0	1	3
OG0024110	0	0	2	0	1	3
OG0024111	0	0	1	1	1	3
OG0024112	0	0	1	2	0	3
OG0024113	0	0	1	0	2	3
OG0024114	0	0	1	1	1	3
OG0024115	0	0	2	0	1	3
OG0024116	0	0	3	0	0	3
OG0024117	0	0	3	0	0	3
OG0024118	0	0	1	0	2	3
OG0024119	0	0	1	1	1	3
OG0024120	0	0	1	0	2	3
OG0024121	0	0	3	0	0	3
OG0024122	0	0	1	1	1	3
OG0024123	0	0	1	1	1	3
OG0024124	0	0	2	0	1	3
OG0024125	0	0	1	0	2	3
OG0024126	0	0	1	1	1	3
OG0024127	0	0	1	1	1	3
OG0024128	0	0	1	0	2	3
OG0024129	0	0	1	0	2	3
OG0024130	0	0	1	1	1	3
OG0024131	0	0	1	0	2	3
OG0024132	0	0	1	1	1	3
OG0024133	0	0	1	0	2	3
OG0024134	0	0	1	1	1	3
OG0024135	0	0	2	0	1	3
OG0024136	0	0	2	0	1	3
OG0024137	0	0	1	1	1	3
OG0024138	0	0	3	0	0	3
OG0024139	0	0	1	1	1	3
OG0024140	0	0	1	0	2	3
OG0024141	0	0	2	0	1	3
OG0024142	0	0	1	1	1	3
OG0024143	0	0	1	0	2	3
OG0024144	0	0	1	1	1	3
OG0024145	0	0	1	1	1	3
OG0024146	0	0	1	0	2	3
OG0024147	0	0	1	0	2	3
OG0024148	0	0	1	0	2	3
OG0024149	0	0	1	1	1	3
OG0024150	0	0	0	3	0	3
OG0024151	0	0	0	2	1	3
OG0024152	0	0	0	3	0	3
OG0024153	0	0	0	3	0	3
OG0024154	0	0	0	3	0	3
OG0024155	0	0	0	3	0	3
OG0024156	0	0	0	3	0	3
OG0024157	0	0	0	3	0	3
OG0024158	0	0	0	3	0	3
OG0024159	0	0	0	3	0	3
OG0024160	0	0	0	3	0	3
OG0024161	0	0	0	3	0	3
OG0024162	0	0	0	3	0	3
OG0024163	0	0	0	3	0	3
OG0024164	0	0	0	3	0	3
OG0024165	0	0	0	1	2	3
OG0024166	0	0	0	3	0	3
OG0024167	0	0	0	3	0	3
OG0024168	0	0	0	3	0	3
OG0024169	0	0	0	3	0	3
OG0024170	0	0	0	3	0	3
OG0024171	0	0	0	3	0	3
OG0024172	0	0	0	3	0	3
OG0024173	0	0	0	3	0	3
OG0024174	0	0	0	3	0	3
OG0024175	0	0	0	3	0	3
OG0024176	0	0	0	3	0	3
OG0024177	0	0	0	3	0	3
OG0024178	0	0	0	3	0	3
OG0024179	0	0	0	2	1	3
OG0024180	0	0	0	3	0	3
OG0024181	0	0	0	3	0	3
OG0024182	0	0	0	3	0	3
OG0024183	0	0	0	3	0	3
OG0024184	0	0	0	3	0	3
OG0024185	0	0	0	3	0	3
OG0024186	0	0	0	3	0	3
OG0024187	0	0	0	3	0	3
OG0024188	0	0	0	3	0	3
OG0024189	0	0	0	3	0	3
OG0024190	0	0	0	3	0	3
OG0024191	0	0	0	3	0	3
OG0024192	0	0	0	3	0	3
OG0024193	0	0	0	3	0	3
OG0024194	0	0	0	3	0	3
OG0024195	0	0	0	3	0	3
OG0024196	0	0	0	3	0	3
OG0024197	0	0	0	3	0	3
OG0024198	0	0	0	3	0	3
OG0024199	0	0	0	3	0	3
OG0024200	0	0	0	3	0	3
OG0024201	0	0	0	3	0	3
OG0024202	0	0	0	3	0	3
OG0024203	0	0	0	3	0	3
OG0024204	0	0	0	3	0	3
OG0024205	0	0	0	3	0	3
OG0024206	0	0	0	3	0	3
OG0024207	0	0	0	3	0	3
OG0024208	0	0	0	3	0	3
OG0024209	0	0	0	3	0	3
OG0024210	0	0	0	3	0	3
OG0024211	0	0	0	3	0	3
OG0024212	0	0	0	3	0	3
OG0024213	0	0	0	3	0	3
OG0024214	0	0	0	3	0	3
OG0024215	0	0	0	3	0	3
OG0024216	0	0	0	3	0	3
OG0024217	0	0	0	3	0	3
OG0024218	0	0	0	3	0	3
OG0024219	0	0	0	3	0	3
OG0024220	0	0	0	3	0	3
OG0024221	0	0	0	3	0	3
OG0024222	0	0	0	3	0	3
OG0024223	0	0	0	3	0	3
OG0024224	0	0	0	3	0	3
OG0024225	0	0	0	3	0	3
OG0024226	0	0	0	3	0	3
OG0024227	0	0	0	3	0	3
OG0024228	0	0	0	3	0	3
OG0024229	0	0	0	3	0	3
OG0024230	0	0	0	3	0	3
OG0024231	0	0	0	2	1	3
OG0024232	0	0	0	3	0	3
OG0024233	0	0	0	3	0	3
OG0024234	0	0	0	3	0	3
OG0024235	0	0	0	3	0	3
OG0024236	0	0	0	1	2	3
OG0024237	0	0	0	3	0	3
OG0024238	0	0	0	1	2	3
OG0024239	0	0	0	3	0	3
OG0024240	0	0	0	2	1	3
OG0024241	0	0	0	1	2	3
OG0024242	0	0	0	3	0	3
OG0024243	0	0	0	3	0	3
OG0024244	0	0	0	3	0	3
OG0024245	0	0	0	3	0	3
OG0024246	0	0	0	3	0	3
OG0024247	0	0	0	3	0	3
OG0024248	0	0	0	3	0	3
OG0024249	0	0	0	3	0	3
OG0024250	0	0	0	3	0	3
OG0024251	0	0	0	3	0	3
OG0024252	0	0	0	3	0	3
OG0024253	0	0	0	3	0	3
OG0024254	0	0	0	3	0	3
OG0024255	0	0	0	3	0	3
OG0024256	0	0	0	3	0	3
OG0024257	0	0	0	3	0	3
OG0024258	0	0	0	1	2	3
OG0024259	0	0	0	3	0	3
OG0024260	0	0	0	3	0	3
OG0024261	0	0	0	1	2	3
OG0024262	0	0	0	3	0	3
OG0024263	0	0	0	1	2	3
OG0024264	0	0	0	3	0	3
OG0024265	0	0	0	3	0	3
OG0024266	0	0	0	3	0	3
OG0024267	0	0	0	3	0	3
OG0024268	0	0	0	2	1	3
OG0024269	0	0	0	3	0	3
OG0024270	0	0	0	3	0	3
OG0024271	0	0	0	3	0	3
OG0024272	0	0	0	3	0	3
OG0024273	0	0	0	3	0	3
OG0024274	0	0	0	3	0	3
OG0024275	0	0	0	3	0	3
OG0024276	0	0	0	3	0	3
OG0024277	0	0	0	3	0	3
OG0024278	0	0	0	3	0	3
OG0024279	0	0	0	3	0	3
OG0024280	0	0	0	1	2	3
OG0024281	0	0	0	3	0	3
OG0024282	0	0	0	3	0	3
OG0024283	0	0	0	1	2	3
OG0024284	0	0	0	0	3	3
OG0024285	0	0	0	0	3	3
OG0024286	0	0	0	0	3	3
OG0024287	0	0	0	0	3	3
OG0024288	0	0	0	0	3	3
OG0024289	0	0	0	0	3	3
OG0024290	0	0	0	0	3	3
OG0024291	0	0	0	0	3	3
OG0024292	0	0	0	0	3	3
OG0024293	0	0	0	0	3	3
OG0024294	0	0	0	0	3	3
OG0024295	0	0	0	0	3	3
OG0024296	0	0	0	0	3	3
OG0024297	0	0	0	0	3	3
OG0024298	0	0	0	0	3	3
OG0024299	0	0	0	0	3	3
OG0024300	0	0	0	0	3	3
OG0024301	0	0	0	0	3	3
OG0024302	0	0	0	0	3	3
OG0024303	0	0	0	0	3	3
OG0024304	0	0	0	0	3	3
OG0024305	0	0	0	0	3	3
OG0024306	0	0	0	0	3	3
OG0024307	0	0	0	0	3	3
OG0024308	0	0	0	0	3	3
OG0024309	0	0	0	0	3	3
OG0024310	0	0	0	0	3	3
OG0024311	0	0	0	0	3	3
OG0024312	0	0	0	0	3	3
OG0024313	0	0	0	0	3	3
OG0024314	0	0	0	0	3	3
OG0024315	0	0	0	0	3	3
OG0024316	0	0	0	0	3	3
OG0024317	0	0	0	0	3	3
OG0024318	0	0	0	0	3	3
OG0024319	0	0	0	0	3	3
OG0024320	0	0	0	0	3	3
OG0024321	0	0	0	0	3	3
OG0024322	0	0	0	0	3	3
OG0024323	0	0	0	0	3	3
OG0024324	0	0	0	0	3	3
OG0024325	0	0	0	0	3	3
OG0024326	0	0	0	0	3	3
OG0024327	0	0	0	0	3	3
OG0024328	0	0	0	0	3	3
OG0024329	0	0	0	0	3	3
OG0024330	0	0	0	0	3	3
OG0024331	0	0	0	0	3	3
OG0024332	0	0	0	0	3	3
OG0024333	0	0	0	0	3	3
OG0024334	0	0	0	0	3	3
OG0024335	0	0	0	0	3	3
OG0024336	0	0	0	0	3	3
OG0024337	0	0	0	0	3	3
OG0024338	0	0	0	0	3	3
OG0024339	0	0	0	0	3	3
OG0024340	0	0	0	0	3	3
OG0024341	0	0	0	0	3	3
OG0024342	0	0	0	0	3	3
OG0024343	0	0	0	0	3	3
OG0024344	0	0	0	0	3	3
OG0024345	0	0	0	0	3	3
OG0024346	0	0	0	0	3	3
OG0024347	0	0	0	0	3	3
OG0024348	0	0	0	0	3	3
OG0024349	0	0	0	0	3	3
OG0024350	0	0	0	0	3	3
OG0024351	0	0	0	0	3	3
OG0024352	0	0	0	0	3	3
OG0024353	0	0	0	0	3	3
OG0024354	0	0	0	0	3	3
OG0024355	0	0	0	0	3	3
OG0024356	0	0	0	0	3	3
OG0024357	0	0	0	0	3	3
OG0024358	0	0	0	0	3	3
OG0024359	0	0	0	0	3	3
OG0024360	0	0	0	0	3	3
OG0024361	0	0	0	0	3	3
OG0024362	0	0	0	0	3	3
OG0024363	0	0	0	0	3	3
OG0024364	0	0	0	0	3	3
OG0024365	0	0	0	0	3	3
OG0024366	0	0	0	0	3	3
OG0024367	0	0	0	0	3	3
OG0024368	0	0	0	0	3	3
OG0024369	0	0	0	0	3	3
OG0024370	0	0	0	0	3	3
OG0024371	0	0	0	0	3	3
OG0024372	0	0	0	0	3	3
OG0024373	0	0	0	0	3	3
OG0024374	0	0	0	0	3	3
OG0024375	0	0	0	0	3	3
OG0024376	0	0	0	0	3	3
OG0024377	0	0	0	0	3	3
OG0024378	0	0	0	0	3	3
OG0024379	0	0	0	0	3	3
OG0024380	0	0	0	0	3	3
OG0024381	0	0	0	0	3	3
OG0024382	0	0	0	0	3	3
OG0024383	0	0	0	0	3	3
OG0024384	0	0	0	0	3	3
OG0024385	0	0	0	0	3	3
OG0024386	0	0	0	0	3	3
OG0024387	0	0	0	0	3	3
OG0024388	0	0	0	0	3	3
OG0024389	0	0	0	0	3	3
OG0024390	0	0	0	0	3	3
OG0024391	0	0	0	0	3	3
OG0024392	0	0	0	0	3	3
OG0024393	0	0	0	0	3	3
OG0024394	0	0	0	0	3	3
OG0024395	0	0	0	0	3	3
OG0024396	0	0	0	0	3	3
OG0024397	0	0	0	0	3	3
OG0024398	0	0	0	0	3	3
OG0024399	0	0	0	0	3	3
OG0024400	0	0	0	0	3	3
OG0024401	0	0	0	0	3	3
OG0024402	0	0	0	0	3	3
OG0024403	0	0	0	0	3	3
OG0024404	0	0	0	0	3	3
OG0024405	0	0	0	0	3	3
OG0024406	0	0	0	0	3	3
OG0024407	0	0	0	0	3	3
OG0024408	0	0	0	0	3	3
OG0024409	0	0	0	0	3	3
OG0024410	0	0	0	0	3	3
OG0024411	0	0	0	0	3	3
OG0024412	0	0	0	0	3	3
OG0024413	0	0	0	0	3	3
OG0024414	0	0	0	0	3	3
OG0024415	0	0	0	0	3	3
OG0024416	0	0	0	0	3	3
OG0024417	0	0	0	0	3	3
OG0024418	0	0	0	0	3	3
OG0024419	0	0	0	0	3	3
OG0024420	0	0	0	0	3	3
OG0024421	0	0	0	0	3	3
OG0024422	0	0	0	0	3	3
OG0024423	0	0	0	0	3	3
OG0024424	0	0	0	0	3	3
OG0024425	0	0	0	0	3	3
OG0024426	0	0	0	0	3	3
OG0024427	0	0	0	0	3	3
OG0024428	0	0	0	0	3	3
OG0024429	0	0	0	0	3	3
OG0024430	0	0	0	0	3	3
OG0024431	0	0	0	0	3	3
OG0024432	0	0	0	0	3	3
OG0024433	0	0	0	0	3	3
OG0024434	0	0	0	0	3	3
OG0024435	0	0	0	0	3	3
OG0024436	0	0	0	0	3	3
OG0024437	0	0	0	0	3	3
OG0024438	0	0	0	0	3	3
OG0024439	0	0	0	0	3	3
OG0024440	0	0	0	0	3	3
OG0024441	0	0	0	0	3	3
OG0024442	0	0	0	0	3	3
OG0024443	0	0	0	0	3	3
OG0024444	0	0	0	0	3	3
OG0024445	0	0	0	0	3	3
OG0024446	0	0	0	0	3	3
OG0024447	0	0	0	0	3	3
OG0024448	0	0	0	0	3	3
OG0024449	0	0	0	0	3	3
OG0024450	0	0	0	0	3	3
OG0024451	0	0	0	0	3	3
OG0024452	0	0	0	0	3	3
OG0024453	0	0	0	0	3	3
OG0024454	0	0	0	0	3	3
OG0024455	0	0	0	0	3	3
OG0024456	0	0	0	0	3	3
OG0024457	0	0	0	0	3	3
OG0024458	0	0	0	0	3	3
OG0024459	0	0	0	0	3	3
OG0024460	0	0	0	0	3	3
OG0024461	0	0	0	0	3	3
OG0024462	0	0	0	0	3	3
OG0024463	0	0	0	0	3	3
OG0024464	0	0	0	0	3	3
OG0024465	0	0	0	0	3	3
OG0024466	0	0	0	0	3	3
OG0024467	0	0	0	0	3	3
OG0024468	0	0	0	0	3	3
OG0024469	0	0	0	0	3	3
OG0024470	0	0	0	0	3	3
OG0024471	0	0	0	0	3	3
OG0024472	0	0	0	0	3	3
OG0024473	0	0	0	0	3	3
OG0024474	0	0	0	0	3	3
OG0024475	0	0	0	0	3	3
OG0024476	0	0	0	0	3	3
OG0024477	0	0	0	0	3	3
OG0024478	0	0	0	0	3	3
OG0024479	0	0	0	0	3	3
OG0024480	0	0	0	0	3	3
OG0024481	0	0	0	0	3	3
OG0024482	0	0	0	0	3	3
OG0024483	0	0	0	0	3	3
OG0024484	0	0	0	0	3	3
OG0024485	0	0	0	0	3	3
OG0024486	0	0	0	0	3	3
OG0024487	0	0	0	0	3	3
OG0024488	0	0	0	0	3	3
OG0024489	0	0	0	0	3	3
OG0024490	0	0	0	0	3	3
OG0024491	0	0	0	0	3	3
OG0024492	0	0	0	0	3	3
OG0024493	0	0	0	0	3	3
OG0024494	0	0	0	0	3	3
OG0024495	0	0	0	0	3	3
OG0024496	0	0	0	0	3	3
OG0024497	0	0	0	0	3	3
OG0024498	0	0	0	0	3	3
OG0024499	0	0	0	0	3	3
OG0024500	0	0	0	0	3	3
OG0024501	0	0	0	0	3	3
OG0024502	0	0	0	0	3	3
OG0024503	0	0	0	0	3	3
OG0024504	0	0	0	0	3	3
OG0024505	0	0	0	0	3	3
OG0024506	0	0	0	0	3	3
OG0024507	0	0	0	0	3	3
OG0024508	0	0	0	0	3	3
OG0024509	0	0	0	0	3	3
OG0024510	0	0	0	0	3	3
OG0024511	0	0	0	0	3	3
OG0024512	0	0	0	0	3	3
OG0024513	0	0	0	0	3	3
OG0024514	0	0	0	0	3	3
OG0024515	0	0	0	0	3	3
OG0024516	2	0	0	0	0	2
OG0024517	2	0	0	0	0	2
OG0024518	2	0	0	0	0	2
OG0024519	2	0	0	0	0	2
OG0024520	2	0	0	0	0	2
OG0024521	2	0	0	0	0	2
OG0024522	2	0	0	0	0	2
OG0024523	2	0	0	0	0	2
OG0024524	2	0	0	0	0	2
OG0024525	2	0	0	0	0	2
OG0024526	2	0	0	0	0	2
OG0024527	2	0	0	0	0	2
OG0024528	2	0	0	0	0	2
OG0024529	2	0	0	0	0	2
OG0024530	2	0	0	0	0	2
OG0024531	2	0	0	0	0	2
OG0024532	2	0	0	0	0	2
OG0024533	2	0	0	0	0	2
OG0024534	2	0	0	0	0	2
OG0024535	1	1	0	0	0	2
OG0024536	2	0	0	0	0	2
OG0024537	2	0	0	0	0	2
OG0024538	2	0	0	0	0	2
OG0024539	2	0	0	0	0	2
OG0024540	2	0	0	0	0	2
OG0024541	2	0	0	0	0	2
OG0024542	2	0	0	0	0	2
OG0024543	2	0	0	0	0	2
OG0024544	2	0	0	0	0	2
OG0024545	2	0	0	0	0	2
OG0024546	2	0	0	0	0	2
OG0024547	1	1	0	0	0	2
OG0024548	2	0	0	0	0	2
OG0024549	2	0	0	0	0	2
OG0024550	2	0	0	0	0	2
OG0024551	2	0	0	0	0	2
OG0024552	2	0	0	0	0	2
OG0024553	2	0	0	0	0	2
OG0024554	2	0	0	0	0	2
OG0024555	2	0	0	0	0	2
OG0024556	2	0	0	0	0	2
OG0024557	2	0	0	0	0	2
OG0024558	2	0	0	0	0	2
OG0024559	2	0	0	0	0	2
OG0024560	1	0	0	0	1	2
OG0024561	2	0	0	0	0	2
OG0024562	2	0	0	0	0	2
OG0024563	2	0	0	0	0	2
OG0024564	2	0	0	0	0	2
OG0024565	2	0	0	0	0	2
OG0024566	2	0	0	0	0	2
OG0024567	2	0	0	0	0	2
OG0024568	2	0	0	0	0	2
OG0024569	2	0	0	0	0	2
OG0024570	2	0	0	0	0	2
OG0024571	2	0	0	0	0	2
OG0024572	2	0	0	0	0	2
OG0024573	2	0	0	0	0	2
OG0024574	2	0	0	0	0	2
OG0024575	2	0	0	0	0	2
OG0024576	2	0	0	0	0	2
OG0024577	2	0	0	0	0	2
OG0024578	2	0	0	0	0	2
OG0024579	2	0	0	0	0	2
OG0024580	2	0	0	0	0	2
OG0024581	2	0	0	0	0	2
OG0024582	2	0	0	0	0	2
OG0024583	2	0	0	0	0	2
OG0024584	2	0	0	0	0	2
OG0024585	2	0	0	0	0	2
OG0024586	2	0	0	0	0	2
OG0024587	2	0	0	0	0	2
OG0024588	2	0	0	0	0	2
OG0024589	2	0	0	0	0	2
OG0024590	2	0	0	0	0	2
OG0024591	2	0	0	0	0	2
OG0024592	2	0	0	0	0	2
OG0024593	2	0	0	0	0	2
OG0024594	2	0	0	0	0	2
OG0024595	2	0	0	0	0	2
OG0024596	2	0	0	0	0	2
OG0024597	2	0	0	0	0	2
OG0024598	2	0	0	0	0	2
OG0024599	2	0	0	0	0	2
OG0024600	2	0	0	0	0	2
OG0024601	2	0	0	0	0	2
OG0024602	2	0	0	0	0	2
OG0024603	2	0	0	0	0	2
OG0024604	2	0	0	0	0	2
OG0024605	2	0	0	0	0	2
OG0024606	2	0	0	0	0	2
OG0024607	2	0	0	0	0	2
OG0024608	2	0	0	0	0	2
OG0024609	2	0	0	0	0	2
OG0024610	2	0	0	0	0	2
OG0024611	1	1	0	0	0	2
OG0024612	2	0	0	0	0	2
OG0024613	2	0	0	0	0	2
OG0024614	2	0	0	0	0	2
OG0024615	2	0	0	0	0	2
OG0024616	2	0	0	0	0	2
OG0024617	2	0	0	0	0	2
OG0024618	2	0	0	0	0	2
OG0024619	2	0	0	0	0	2
OG0024620	2	0	0	0	0	2
OG0024621	2	0	0	0	0	2
OG0024622	2	0	0	0	0	2
OG0024623	2	0	0	0	0	2
OG0024624	2	0	0	0	0	2
OG0024625	2	0	0	0	0	2
OG0024626	2	0	0	0	0	2
OG0024627	1	0	1	0	0	2
OG0024628	2	0	0	0	0	2
OG0024629	2	0	0	0	0	2
OG0024630	2	0	0	0	0	2
OG0024631	2	0	0	0	0	2
OG0024632	2	0	0	0	0	2
OG0024633	2	0	0	0	0	2
OG0024634	2	0	0	0	0	2
OG0024635	2	0	0	0	0	2
OG0024636	2	0	0	0	0	2
OG0024637	2	0	0	0	0	2
OG0024638	2	0	0	0	0	2
OG0024639	2	0	0	0	0	2
OG0024640	2	0	0	0	0	2
OG0024641	2	0	0	0	0	2
OG0024642	2	0	0	0	0	2
OG0024643	2	0	0	0	0	2
OG0024644	2	0	0	0	0	2
OG0024645	2	0	0	0	0	2
OG0024646	2	0	0	0	0	2
OG0024647	2	0	0	0	0	2
OG0024648	2	0	0	0	0	2
OG0024649	2	0	0	0	0	2
OG0024650	2	0	0	0	0	2
OG0024651	2	0	0	0	0	2
OG0024652	2	0	0	0	0	2
OG0024653	2	0	0	0	0	2
OG0024654	2	0	0	0	0	2
OG0024655	2	0	0	0	0	2
OG0024656	2	0	0	0	0	2
OG0024657	2	0	0	0	0	2
OG0024658	2	0	0	0	0	2
OG0024659	2	0	0	0	0	2
OG0024660	2	0	0	0	0	2
OG0024661	2	0	0	0	0	2
OG0024662	2	0	0	0	0	2
OG0024663	2	0	0	0	0	2
OG0024664	2	0	0	0	0	2
OG0024665	2	0	0	0	0	2
OG0024666	2	0	0	0	0	2
OG0024667	2	0	0	0	0	2
OG0024668	2	0	0	0	0	2
OG0024669	2	0	0	0	0	2
OG0024670	2	0	0	0	0	2
OG0024671	2	0	0	0	0	2
OG0024672	2	0	0	0	0	2
OG0024673	1	0	0	1	0	2
OG0024674	2	0	0	0	0	2
OG0024675	2	0	0	0	0	2
OG0024676	2	0	0	0	0	2
OG0024677	2	0	0	0	0	2
OG0024678	2	0	0	0	0	2
OG0024679	1	0	0	0	1	2
OG0024680	2	0	0	0	0	2
OG0024681	2	0	0	0	0	2
OG0024682	2	0	0	0	0	2
OG0024683	1	0	1	0	0	2
OG0024684	2	0	0	0	0	2
OG0024685	2	0	0	0	0	2
OG0024686	2	0	0	0	0	2
OG0024687	2	0	0	0	0	2
OG0024688	2	0	0	0	0	2
OG0024689	2	0	0	0	0	2
OG0024690	2	0	0	0	0	2
OG0024691	2	0	0	0	0	2
OG0024692	2	0	0	0	0	2
OG0024693	2	0	0	0	0	2
OG0024694	2	0	0	0	0	2
OG0024695	2	0	0	0	0	2
OG0024696	2	0	0	0	0	2
OG0024697	2	0	0	0	0	2
OG0024698	2	0	0	0	0	2
OG0024699	2	0	0	0	0	2
OG0024700	2	0	0	0	0	2
OG0024701	1	1	0	0	0	2
OG0024702	2	0	0	0	0	2
OG0024703	2	0	0	0	0	2
OG0024704	2	0	0	0	0	2
OG0024705	1	1	0	0	0	2
OG0024706	2	0	0	0	0	2
OG0024707	2	0	0	0	0	2
OG0024708	2	0	0	0	0	2
OG0024709	2	0	0	0	0	2
OG0024710	1	0	0	1	0	2
OG0024711	2	0	0	0	0	2
OG0024712	2	0	0	0	0	2
OG0024713	2	0	0	0	0	2
OG0024714	2	0	0	0	0	2
OG0024715	2	0	0	0	0	2
OG0024716	2	0	0	0	0	2
OG0024717	2	0	0	0	0	2
OG0024718	2	0	0	0	0	2
OG0024719	2	0	0	0	0	2
OG0024720	2	0	0	0	0	2
OG0024721	2	0	0	0	0	2
OG0024722	2	0	0	0	0	2
OG0024723	2	0	0	0	0	2
OG0024724	2	0	0	0	0	2
OG0024725	2	0	0	0	0	2
OG0024726	2	0	0	0	0	2
OG0024727	2	0	0	0	0	2
OG0024728	2	0	0	0	0	2
OG0024729	2	0	0	0	0	2
OG0024730	2	0	0	0	0	2
OG0024731	2	0	0	0	0	2
OG0024732	2	0	0	0	0	2
OG0024733	2	0	0	0	0	2
OG0024734	2	0	0	0	0	2
OG0024735	2	0	0	0	0	2
OG0024736	2	0	0	0	0	2
OG0024737	2	0	0	0	0	2
OG0024738	2	0	0	0	0	2
OG0024739	1	0	0	1	0	2
OG0024740	2	0	0	0	0	2
OG0024741	2	0	0	0	0	2
OG0024742	2	0	0	0	0	2
OG0024743	2	0	0	0	0	2
OG0024744	2	0	0	0	0	2
OG0024745	2	0	0	0	0	2
OG0024746	2	0	0	0	0	2
OG0024747	2	0	0	0	0	2
OG0024748	2	0	0	0	0	2
OG0024749	2	0	0	0	0	2
OG0024750	2	0	0	0	0	2
OG0024751	2	0	0	0	0	2
OG0024752	2	0	0	0	0	2
OG0024753	2	0	0	0	0	2
OG0024754	2	0	0	0	0	2
OG0024755	2	0	0	0	0	2
OG0024756	1	0	1	0	0	2
OG0024757	1	0	0	0	1	2
OG0024758	2	0	0	0	0	2
OG0024759	2	0	0	0	0	2
OG0024760	2	0	0	0	0	2
OG0024761	1	1	0	0	0	2
OG0024762	2	0	0	0	0	2
OG0024763	2	0	0	0	0	2
OG0024764	2	0	0	0	0	2
OG0024765	2	0	0	0	0	2
OG0024766	2	0	0	0	0	2
OG0024767	2	0	0	0	0	2
OG0024768	2	0	0	0	0	2
OG0024769	2	0	0	0	0	2
OG0024770	2	0	0	0	0	2
OG0024771	2	0	0	0	0	2
OG0024772	2	0	0	0	0	2
OG0024773	2	0	0	0	0	2
OG0024774	2	0	0	0	0	2
OG0024775	2	0	0	0	0	2
OG0024776	2	0	0	0	0	2
OG0024777	2	0	0	0	0	2
OG0024778	2	0	0	0	0	2
OG0024779	2	0	0	0	0	2
OG0024780	2	0	0	0	0	2
OG0024781	2	0	0	0	0	2
OG0024782	2	0	0	0	0	2
OG0024783	2	0	0	0	0	2
OG0024784	2	0	0	0	0	2
OG0024785	2	0	0	0	0	2
OG0024786	2	0	0	0	0	2
OG0024787	2	0	0	0	0	2
OG0024788	2	0	0	0	0	2
OG0024789	2	0	0	0	0	2
OG0024790	2	0	0	0	0	2
OG0024791	2	0	0	0	0	2
OG0024792	2	0	0	0	0	2
OG0024793	2	0	0	0	0	2
OG0024794	2	0	0	0	0	2
OG0024795	2	0	0	0	0	2
OG0024796	2	0	0	0	0	2
OG0024797	2	0	0	0	0	2
OG0024798	2	0	0	0	0	2
OG0024799	2	0	0	0	0	2
OG0024800	2	0	0	0	0	2
OG0024801	2	0	0	0	0	2
OG0024802	2	0	0	0	0	2
OG0024803	2	0	0	0	0	2
OG0024804	2	0	0	0	0	2
OG0024805	2	0	0	0	0	2
OG0024806	2	0	0	0	0	2
OG0024807	2	0	0	0	0	2
OG0024808	2	0	0	0	0	2
OG0024809	2	0	0	0	0	2
OG0024810	2	0	0	0	0	2
OG0024811	2	0	0	0	0	2
OG0024812	2	0	0	0	0	2
OG0024813	2	0	0	0	0	2
OG0024814	2	0	0	0	0	2
OG0024815	2	0	0	0	0	2
OG0024816	2	0	0	0	0	2
OG0024817	2	0	0	0	0	2
OG0024818	2	0	0	0	0	2
OG0024819	2	0	0	0	0	2
OG0024820	2	0	0	0	0	2
OG0024821	2	0	0	0	0	2
OG0024822	2	0	0	0	0	2
OG0024823	2	0	0	0	0	2
OG0024824	2	0	0	0	0	2
OG0024825	2	0	0	0	0	2
OG0024826	2	0	0	0	0	2
OG0024827	2	0	0	0	0	2
OG0024828	2	0	0	0	0	2
OG0024829	2	0	0	0	0	2
OG0024830	2	0	0	0	0	2
OG0024831	1	0	0	1	0	2
OG0024832	2	0	0	0	0	2
OG0024833	2	0	0	0	0	2
OG0024834	2	0	0	0	0	2
OG0024835	2	0	0	0	0	2
OG0024836	2	0	0	0	0	2
OG0024837	2	0	0	0	0	2
OG0024838	2	0	0	0	0	2
OG0024839	2	0	0	0	0	2
OG0024840	2	0	0	0	0	2
OG0024841	2	0	0	0	0	2
OG0024842	1	1	0	0	0	2
OG0024843	2	0	0	0	0	2
OG0024844	2	0	0	0	0	2
OG0024845	1	0	1	0	0	2
OG0024846	2	0	0	0	0	2
OG0024847	2	0	0	0	0	2
OG0024848	2	0	0	0	0	2
OG0024849	2	0	0	0	0	2
OG0024850	2	0	0	0	0	2
OG0024851	2	0	0	0	0	2
OG0024852	2	0	0	0	0	2
OG0024853	2	0	0	0	0	2
OG0024854	2	0	0	0	0	2
OG0024855	2	0	0	0	0	2
OG0024856	2	0	0	0	0	2
OG0024857	2	0	0	0	0	2
OG0024858	2	0	0	0	0	2
OG0024859	2	0	0	0	0	2
OG0024860	2	0	0	0	0	2
OG0024861	2	0	0	0	0	2
OG0024862	2	0	0	0	0	2
OG0024863	2	0	0	0	0	2
OG0024864	2	0	0	0	0	2
OG0024865	2	0	0	0	0	2
OG0024866	2	0	0	0	0	2
OG0024867	2	0	0	0	0	2
OG0024868	2	0	0	0	0	2
OG0024869	2	0	0	0	0	2
OG0024870	2	0	0	0	0	2
OG0024871	2	0	0	0	0	2
OG0024872	2	0	0	0	0	2
OG0024873	1	1	0	0	0	2
OG0024874	2	0	0	0	0	2
OG0024875	2	0	0	0	0	2
OG0024876	2	0	0	0	0	2
OG0024877	2	0	0	0	0	2
OG0024878	2	0	0	0	0	2
OG0024879	2	0	0	0	0	2
OG0024880	2	0	0	0	0	2
OG0024881	2	0	0	0	0	2
OG0024882	2	0	0	0	0	2
OG0024883	2	0	0	0	0	2
OG0024884	2	0	0	0	0	2
OG0024885	2	0	0	0	0	2
OG0024886	1	0	0	1	0	2
OG0024887	2	0	0	0	0	2
OG0024888	2	0	0	0	0	2
OG0024889	2	0	0	0	0	2
OG0024890	2	0	0	0	0	2
OG0024891	2	0	0	0	0	2
OG0024892	2	0	0	0	0	2
OG0024893	2	0	0	0	0	2
OG0024894	2	0	0	0	0	2
OG0024895	2	0	0	0	0	2
OG0024896	2	0	0	0	0	2
OG0024897	2	0	0	0	0	2
OG0024898	1	0	0	1	0	2
OG0024899	2	0	0	0	0	2
OG0024900	2	0	0	0	0	2
OG0024901	1	0	1	0	0	2
OG0024902	2	0	0	0	0	2
OG0024903	2	0	0	0	0	2
OG0024904	2	0	0	0	0	2
OG0024905	2	0	0	0	0	2
OG0024906	2	0	0	0	0	2
OG0024907	2	0	0	0	0	2
OG0024908	2	0	0	0	0	2
OG0024909	2	0	0	0	0	2
OG0024910	2	0	0	0	0	2
OG0024911	2	0	0	0	0	2
OG0024912	2	0	0	0	0	2
OG0024913	2	0	0	0	0	2
OG0024914	2	0	0	0	0	2
OG0024915	2	0	0	0	0	2
OG0024916	2	0	0	0	0	2
OG0024917	2	0	0	0	0	2
OG0024918	2	0	0	0	0	2
OG0024919	2	0	0	0	0	2
OG0024920	2	0	0	0	0	2
OG0024921	2	0	0	0	0	2
OG0024922	2	0	0	0	0	2
OG0024923	2	0	0	0	0	2
OG0024924	2	0	0	0	0	2
OG0024925	2	0	0	0	0	2
OG0024926	2	0	0	0	0	2
OG0024927	2	0	0	0	0	2
OG0024928	2	0	0	0	0	2
OG0024929	2	0	0	0	0	2
OG0024930	2	0	0	0	0	2
OG0024931	2	0	0	0	0	2
OG0024932	2	0	0	0	0	2
OG0024933	2	0	0	0	0	2
OG0024934	2	0	0	0	0	2
OG0024935	2	0	0	0	0	2
OG0024936	2	0	0	0	0	2
OG0024937	2	0	0	0	0	2
OG0024938	2	0	0	0	0	2
OG0024939	2	0	0	0	0	2
OG0024940	2	0	0	0	0	2
OG0024941	2	0	0	0	0	2
OG0024942	2	0	0	0	0	2
OG0024943	2	0	0	0	0	2
OG0024944	2	0	0	0	0	2
OG0024945	2	0	0	0	0	2
OG0024946	2	0	0	0	0	2
OG0024947	2	0	0	0	0	2
OG0024948	2	0	0	0	0	2
OG0024949	2	0	0	0	0	2
OG0024950	2	0	0	0	0	2
OG0024951	2	0	0	0	0	2
OG0024952	2	0	0	0	0	2
OG0024953	2	0	0	0	0	2
OG0024954	2	0	0	0	0	2
OG0024955	2	0	0	0	0	2
OG0024956	2	0	0	0	0	2
OG0024957	2	0	0	0	0	2
OG0024958	2	0	0	0	0	2
OG0024959	2	0	0	0	0	2
OG0024960	2	0	0	0	0	2
OG0024961	2	0	0	0	0	2
OG0024962	1	0	1	0	0	2
OG0024963	2	0	0	0	0	2
OG0024964	2	0	0	0	0	2
OG0024965	2	0	0	0	0	2
OG0024966	2	0	0	0	0	2
OG0024967	2	0	0	0	0	2
OG0024968	2	0	0	0	0	2
OG0024969	2	0	0	0	0	2
OG0024970	2	0	0	0	0	2
OG0024971	2	0	0	0	0	2
OG0024972	2	0	0	0	0	2
OG0024973	2	0	0	0	0	2
OG0024974	2	0	0	0	0	2
OG0024975	2	0	0	0	0	2
OG0024976	2	0	0	0	0	2
OG0024977	2	0	0	0	0	2
OG0024978	2	0	0	0	0	2
OG0024979	2	0	0	0	0	2
OG0024980	2	0	0	0	0	2
OG0024981	2	0	0	0	0	2
OG0024982	2	0	0	0	0	2
OG0024983	2	0	0	0	0	2
OG0024984	2	0	0	0	0	2
OG0024985	2	0	0	0	0	2
OG0024986	2	0	0	0	0	2
OG0024987	2	0	0	0	0	2
OG0024988	2	0	0	0	0	2
OG0024989	2	0	0	0	0	2
OG0024990	2	0	0	0	0	2
OG0024991	2	0	0	0	0	2
OG0024992	2	0	0	0	0	2
OG0024993	2	0	0	0	0	2
OG0024994	2	0	0	0	0	2
OG0024995	2	0	0	0	0	2
OG0024996	2	0	0	0	0	2
OG0024997	2	0	0	0	0	2
OG0024998	2	0	0	0	0	2
OG0024999	2	0	0	0	0	2
OG0025000	2	0	0	0	0	2
OG0025001	2	0	0	0	0	2
OG0025002	2	0	0	0	0	2
OG0025003	2	0	0	0	0	2
OG0025004	2	0	0	0	0	2
OG0025005	2	0	0	0	0	2
OG0025006	2	0	0	0	0	2
OG0025007	2	0	0	0	0	2
OG0025008	2	0	0	0	0	2
OG0025009	2	0	0	0	0	2
OG0025010	2	0	0	0	0	2
OG0025011	1	0	0	1	0	2
OG0025012	2	0	0	0	0	2
OG0025013	2	0	0	0	0	2
OG0025014	2	0	0	0	0	2
OG0025015	2	0	0	0	0	2
OG0025016	2	0	0	0	0	2
OG0025017	2	0	0	0	0	2
OG0025018	2	0	0	0	0	2
OG0025019	2	0	0	0	0	2
OG0025020	2	0	0	0	0	2
OG0025021	2	0	0	0	0	2
OG0025022	2	0	0	0	0	2
OG0025023	2	0	0	0	0	2
OG0025024	2	0	0	0	0	2
OG0025025	2	0	0	0	0	2
OG0025026	2	0	0	0	0	2
OG0025027	2	0	0	0	0	2
OG0025028	2	0	0	0	0	2
OG0025029	2	0	0	0	0	2
OG0025030	2	0	0	0	0	2
OG0025031	2	0	0	0	0	2
OG0025032	2	0	0	0	0	2
OG0025033	2	0	0	0	0	2
OG0025034	2	0	0	0	0	2
OG0025035	2	0	0	0	0	2
OG0025036	2	0	0	0	0	2
OG0025037	2	0	0	0	0	2
OG0025038	2	0	0	0	0	2
OG0025039	2	0	0	0	0	2
OG0025040	2	0	0	0	0	2
OG0025041	2	0	0	0	0	2
OG0025042	2	0	0	0	0	2
OG0025043	2	0	0	0	0	2
OG0025044	2	0	0	0	0	2
OG0025045	2	0	0	0	0	2
OG0025046	2	0	0	0	0	2
OG0025047	2	0	0	0	0	2
OG0025048	2	0	0	0	0	2
OG0025049	2	0	0	0	0	2
OG0025050	2	0	0	0	0	2
OG0025051	2	0	0	0	0	2
OG0025052	2	0	0	0	0	2
OG0025053	2	0	0	0	0	2
OG0025054	2	0	0	0	0	2
OG0025055	2	0	0	0	0	2
OG0025056	1	1	0	0	0	2
OG0025057	2	0	0	0	0	2
OG0025058	2	0	0	0	0	2
OG0025059	2	0	0	0	0	2
OG0025060	2	0	0	0	0	2
OG0025061	2	0	0	0	0	2
OG0025062	2	0	0	0	0	2
OG0025063	2	0	0	0	0	2
OG0025064	2	0	0	0	0	2
OG0025065	2	0	0	0	0	2
OG0025066	2	0	0	0	0	2
OG0025067	2	0	0	0	0	2
OG0025068	2	0	0	0	0	2
OG0025069	2	0	0	0	0	2
OG0025070	2	0	0	0	0	2
OG0025071	2	0	0	0	0	2
OG0025072	2	0	0	0	0	2
OG0025073	2	0	0	0	0	2
OG0025074	2	0	0	0	0	2
OG0025075	2	0	0	0	0	2
OG0025076	2	0	0	0	0	2
OG0025077	2	0	0	0	0	2
OG0025078	2	0	0	0	0	2
OG0025079	2	0	0	0	0	2
OG0025080	2	0	0	0	0	2
OG0025081	2	0	0	0	0	2
OG0025082	2	0	0	0	0	2
OG0025083	2	0	0	0	0	2
OG0025084	2	0	0	0	0	2
OG0025085	2	0	0	0	0	2
OG0025086	2	0	0	0	0	2
OG0025087	2	0	0	0	0	2
OG0025088	2	0	0	0	0	2
OG0025089	2	0	0	0	0	2
OG0025090	2	0	0	0	0	2
OG0025091	2	0	0	0	0	2
OG0025092	2	0	0	0	0	2
OG0025093	2	0	0	0	0	2
OG0025094	2	0	0	0	0	2
OG0025095	2	0	0	0	0	2
OG0025096	2	0	0	0	0	2
OG0025097	2	0	0	0	0	2
OG0025098	2	0	0	0	0	2
OG0025099	1	0	0	0	1	2
OG0025100	2	0	0	0	0	2
OG0025101	2	0	0	0	0	2
OG0025102	2	0	0	0	0	2
OG0025103	1	1	0	0	0	2
OG0025104	2	0	0	0	0	2
OG0025105	2	0	0	0	0	2
OG0025106	2	0	0	0	0	2
OG0025107	2	0	0	0	0	2
OG0025108	2	0	0	0	0	2
OG0025109	2	0	0	0	0	2
OG0025110	2	0	0	0	0	2
OG0025111	2	0	0	0	0	2
OG0025112	2	0	0	0	0	2
OG0025113	2	0	0	0	0	2
OG0025114	2	0	0	0	0	2
OG0025115	2	0	0	0	0	2
OG0025116	2	0	0	0	0	2
OG0025117	1	0	0	1	0	2
OG0025118	2	0	0	0	0	2
OG0025119	2	0	0	0	0	2
OG0025120	2	0	0	0	0	2
OG0025121	2	0	0	0	0	2
OG0025122	2	0	0	0	0	2
OG0025123	2	0	0	0	0	2
OG0025124	2	0	0	0	0	2
OG0025125	2	0	0	0	0	2
OG0025126	2	0	0	0	0	2
OG0025127	2	0	0	0	0	2
OG0025128	2	0	0	0	0	2
OG0025129	2	0	0	0	0	2
OG0025130	2	0	0	0	0	2
OG0025131	2	0	0	0	0	2
OG0025132	2	0	0	0	0	2
OG0025133	2	0	0	0	0	2
OG0025134	2	0	0	0	0	2
OG0025135	2	0	0	0	0	2
OG0025136	2	0	0	0	0	2
OG0025137	2	0	0	0	0	2
OG0025138	2	0	0	0	0	2
OG0025139	2	0	0	0	0	2
OG0025140	2	0	0	0	0	2
OG0025141	2	0	0	0	0	2
OG0025142	2	0	0	0	0	2
OG0025143	2	0	0	0	0	2
OG0025144	2	0	0	0	0	2
OG0025145	2	0	0	0	0	2
OG0025146	2	0	0	0	0	2
OG0025147	2	0	0	0	0	2
OG0025148	2	0	0	0	0	2
OG0025149	2	0	0	0	0	2
OG0025150	2	0	0	0	0	2
OG0025151	2	0	0	0	0	2
OG0025152	2	0	0	0	0	2
OG0025153	2	0	0	0	0	2
OG0025154	2	0	0	0	0	2
OG0025155	2	0	0	0	0	2
OG0025156	2	0	0	0	0	2
OG0025157	1	0	0	1	0	2
OG0025158	2	0	0	0	0	2
OG0025159	2	0	0	0	0	2
OG0025160	2	0	0	0	0	2
OG0025161	2	0	0	0	0	2
OG0025162	2	0	0	0	0	2
OG0025163	2	0	0	0	0	2
OG0025164	2	0	0	0	0	2
OG0025165	2	0	0	0	0	2
OG0025166	2	0	0	0	0	2
OG0025167	2	0	0	0	0	2
OG0025168	2	0	0	0	0	2
OG0025169	2	0	0	0	0	2
OG0025170	2	0	0	0	0	2
OG0025171	2	0	0	0	0	2
OG0025172	2	0	0	0	0	2
OG0025173	2	0	0	0	0	2
OG0025174	2	0	0	0	0	2
OG0025175	2	0	0	0	0	2
OG0025176	2	0	0	0	0	2
OG0025177	2	0	0	0	0	2
OG0025178	2	0	0	0	0	2
OG0025179	2	0	0	0	0	2
OG0025180	2	0	0	0	0	2
OG0025181	2	0	0	0	0	2
OG0025182	2	0	0	0	0	2
OG0025183	2	0	0	0	0	2
OG0025184	2	0	0	0	0	2
OG0025185	2	0	0	0	0	2
OG0025186	2	0	0	0	0	2
OG0025187	2	0	0	0	0	2
OG0025188	2	0	0	0	0	2
OG0025189	2	0	0	0	0	2
OG0025190	2	0	0	0	0	2
OG0025191	2	0	0	0	0	2
OG0025192	2	0	0	0	0	2
OG0025193	2	0	0	0	0	2
OG0025194	2	0	0	0	0	2
OG0025195	2	0	0	0	0	2
OG0025196	2	0	0	0	0	2
OG0025197	2	0	0	0	0	2
OG0025198	2	0	0	0	0	2
OG0025199	2	0	0	0	0	2
OG0025200	2	0	0	0	0	2
OG0025201	2	0	0	0	0	2
OG0025202	2	0	0	0	0	2
OG0025203	2	0	0	0	0	2
OG0025204	1	0	1	0	0	2
OG0025205	2	0	0	0	0	2
OG0025206	1	0	0	1	0	2
OG0025207	2	0	0	0	0	2
OG0025208	2	0	0	0	0	2
OG0025209	1	0	1	0	0	2
OG0025210	2	0	0	0	0	2
OG0025211	2	0	0	0	0	2
OG0025212	2	0	0	0	0	2
OG0025213	2	0	0	0	0	2
OG0025214	2	0	0	0	0	2
OG0025215	2	0	0	0	0	2
OG0025216	2	0	0	0	0	2
OG0025217	2	0	0	0	0	2
OG0025218	2	0	0	0	0	2
OG0025219	2	0	0	0	0	2
OG0025220	2	0	0	0	0	2
OG0025221	2	0	0	0	0	2
OG0025222	2	0	0	0	0	2
OG0025223	1	0	0	1	0	2
OG0025224	2	0	0	0	0	2
OG0025225	2	0	0	0	0	2
OG0025226	2	0	0	0	0	2
OG0025227	2	0	0	0	0	2
OG0025228	2	0	0	0	0	2
OG0025229	2	0	0	0	0	2
OG0025230	2	0	0	0	0	2
OG0025231	2	0	0	0	0	2
OG0025232	2	0	0	0	0	2
OG0025233	2	0	0	0	0	2
OG0025234	2	0	0	0	0	2
OG0025235	2	0	0	0	0	2
OG0025236	2	0	0	0	0	2
OG0025237	2	0	0	0	0	2
OG0025238	2	0	0	0	0	2
OG0025239	1	0	1	0	0	2
OG0025240	2	0	0	0	0	2
OG0025241	2	0	0	0	0	2
OG0025242	2	0	0	0	0	2
OG0025243	2	0	0	0	0	2
OG0025244	2	0	0	0	0	2
OG0025245	2	0	0	0	0	2
OG0025246	2	0	0	0	0	2
OG0025247	2	0	0	0	0	2
OG0025248	2	0	0	0	0	2
OG0025249	2	0	0	0	0	2
OG0025250	2	0	0	0	0	2
OG0025251	2	0	0	0	0	2
OG0025252	2	0	0	0	0	2
OG0025253	2	0	0	0	0	2
OG0025254	2	0	0	0	0	2
OG0025255	2	0	0	0	0	2
OG0025256	2	0	0	0	0	2
OG0025257	2	0	0	0	0	2
OG0025258	2	0	0	0	0	2
OG0025259	2	0	0	0	0	2
OG0025260	2	0	0	0	0	2
OG0025261	2	0	0	0	0	2
OG0025262	2	0	0	0	0	2
OG0025263	2	0	0	0	0	2
OG0025264	2	0	0	0	0	2
OG0025265	2	0	0	0	0	2
OG0025266	2	0	0	0	0	2
OG0025267	2	0	0	0	0	2
OG0025268	2	0	0	0	0	2
OG0025269	2	0	0	0	0	2
OG0025270	2	0	0	0	0	2
OG0025271	2	0	0	0	0	2
OG0025272	2	0	0	0	0	2
OG0025273	2	0	0	0	0	2
OG0025274	2	0	0	0	0	2
OG0025275	2	0	0	0	0	2
OG0025276	2	0	0	0	0	2
OG0025277	2	0	0	0	0	2
OG0025278	1	0	0	0	1	2
OG0025279	2	0	0	0	0	2
OG0025280	2	0	0	0	0	2
OG0025281	2	0	0	0	0	2
OG0025282	2	0	0	0	0	2
OG0025283	2	0	0	0	0	2
OG0025284	2	0	0	0	0	2
OG0025285	2	0	0	0	0	2
OG0025286	2	0	0	0	0	2
OG0025287	2	0	0	0	0	2
OG0025288	2	0	0	0	0	2
OG0025289	2	0	0	0	0	2
OG0025290	2	0	0	0	0	2
OG0025291	2	0	0	0	0	2
OG0025292	2	0	0	0	0	2
OG0025293	2	0	0	0	0	2
OG0025294	2	0	0	0	0	2
OG0025295	2	0	0	0	0	2
OG0025296	2	0	0	0	0	2
OG0025297	2	0	0	0	0	2
OG0025298	2	0	0	0	0	2
OG0025299	2	0	0	0	0	2
OG0025300	1	1	0	0	0	2
OG0025301	2	0	0	0	0	2
OG0025302	2	0	0	0	0	2
OG0025303	2	0	0	0	0	2
OG0025304	1	1	0	0	0	2
OG0025305	2	0	0	0	0	2
OG0025306	1	1	0	0	0	2
OG0025307	2	0	0	0	0	2
OG0025308	2	0	0	0	0	2
OG0025309	2	0	0	0	0	2
OG0025310	2	0	0	0	0	2
OG0025311	2	0	0	0	0	2
OG0025312	2	0	0	0	0	2
OG0025313	2	0	0	0	0	2
OG0025314	2	0	0	0	0	2
OG0025315	2	0	0	0	0	2
OG0025316	2	0	0	0	0	2
OG0025317	2	0	0	0	0	2
OG0025318	2	0	0	0	0	2
OG0025319	2	0	0	0	0	2
OG0025320	2	0	0	0	0	2
OG0025321	2	0	0	0	0	2
OG0025322	2	0	0	0	0	2
OG0025323	2	0	0	0	0	2
OG0025324	2	0	0	0	0	2
OG0025325	2	0	0	0	0	2
OG0025326	2	0	0	0	0	2
OG0025327	2	0	0	0	0	2
OG0025328	2	0	0	0	0	2
OG0025329	2	0	0	0	0	2
OG0025330	2	0	0	0	0	2
OG0025331	2	0	0	0	0	2
OG0025332	2	0	0	0	0	2
OG0025333	2	0	0	0	0	2
OG0025334	2	0	0	0	0	2
OG0025335	2	0	0	0	0	2
OG0025336	2	0	0	0	0	2
OG0025337	2	0	0	0	0	2
OG0025338	2	0	0	0	0	2
OG0025339	2	0	0	0	0	2
OG0025340	2	0	0	0	0	2
OG0025341	2	0	0	0	0	2
OG0025342	2	0	0	0	0	2
OG0025343	2	0	0	0	0	2
OG0025344	2	0	0	0	0	2
OG0025345	2	0	0	0	0	2
OG0025346	2	0	0	0	0	2
OG0025347	2	0	0	0	0	2
OG0025348	2	0	0	0	0	2
OG0025349	2	0	0	0	0	2
OG0025350	2	0	0	0	0	2
OG0025351	2	0	0	0	0	2
OG0025352	2	0	0	0	0	2
OG0025353	2	0	0	0	0	2
OG0025354	2	0	0	0	0	2
OG0025355	2	0	0	0	0	2
OG0025356	2	0	0	0	0	2
OG0025357	2	0	0	0	0	2
OG0025358	2	0	0	0	0	2
OG0025359	2	0	0	0	0	2
OG0025360	2	0	0	0	0	2
OG0025361	2	0	0	0	0	2
OG0025362	2	0	0	0	0	2
OG0025363	2	0	0	0	0	2
OG0025364	2	0	0	0	0	2
OG0025365	2	0	0	0	0	2
OG0025366	2	0	0	0	0	2
OG0025367	2	0	0	0	0	2
OG0025368	2	0	0	0	0	2
OG0025369	2	0	0	0	0	2
OG0025370	2	0	0	0	0	2
OG0025371	2	0	0	0	0	2
OG0025372	2	0	0	0	0	2
OG0025373	2	0	0	0	0	2
OG0025374	2	0	0	0	0	2
OG0025375	2	0	0	0	0	2
OG0025376	2	0	0	0	0	2
OG0025377	2	0	0	0	0	2
OG0025378	2	0	0	0	0	2
OG0025379	2	0	0	0	0	2
OG0025380	2	0	0	0	0	2
OG0025381	2	0	0	0	0	2
OG0025382	2	0	0	0	0	2
OG0025383	2	0	0	0	0	2
OG0025384	2	0	0	0	0	2
OG0025385	2	0	0	0	0	2
OG0025386	2	0	0	0	0	2
OG0025387	2	0	0	0	0	2
OG0025388	2	0	0	0	0	2
OG0025389	2	0	0	0	0	2
OG0025390	2	0	0	0	0	2
OG0025391	2	0	0	0	0	2
OG0025392	2	0	0	0	0	2
OG0025393	2	0	0	0	0	2
OG0025394	2	0	0	0	0	2
OG0025395	2	0	0	0	0	2
OG0025396	2	0	0	0	0	2
OG0025397	2	0	0	0	0	2
OG0025398	2	0	0	0	0	2
OG0025399	2	0	0	0	0	2
OG0025400	2	0	0	0	0	2
OG0025401	2	0	0	0	0	2
OG0025402	2	0	0	0	0	2
OG0025403	2	0	0	0	0	2
OG0025404	2	0	0	0	0	2
OG0025405	2	0	0	0	0	2
OG0025406	2	0	0	0	0	2
OG0025407	2	0	0	0	0	2
OG0025408	2	0	0	0	0	2
OG0025409	2	0	0	0	0	2
OG0025410	2	0	0	0	0	2
OG0025411	2	0	0	0	0	2
OG0025412	2	0	0	0	0	2
OG0025413	2	0	0	0	0	2
OG0025414	2	0	0	0	0	2
OG0025415	2	0	0	0	0	2
OG0025416	2	0	0	0	0	2
OG0025417	2	0	0	0	0	2
OG0025418	2	0	0	0	0	2
OG0025419	2	0	0	0	0	2
OG0025420	2	0	0	0	0	2
OG0025421	2	0	0	0	0	2
OG0025422	2	0	0	0	0	2
OG0025423	2	0	0	0	0	2
OG0025424	2	0	0	0	0	2
OG0025425	2	0	0	0	0	2
OG0025426	2	0	0	0	0	2
OG0025427	2	0	0	0	0	2
OG0025428	2	0	0	0	0	2
OG0025429	2	0	0	0	0	2
OG0025430	2	0	0	0	0	2
OG0025431	2	0	0	0	0	2
OG0025432	2	0	0	0	0	2
OG0025433	2	0	0	0	0	2
OG0025434	2	0	0	0	0	2
OG0025435	2	0	0	0	0	2
OG0025436	2	0	0	0	0	2
OG0025437	2	0	0	0	0	2
OG0025438	2	0	0	0	0	2
OG0025439	2	0	0	0	0	2
OG0025440	2	0	0	0	0	2
OG0025441	2	0	0	0	0	2
OG0025442	2	0	0	0	0	2
OG0025443	2	0	0	0	0	2
OG0025444	2	0	0	0	0	2
OG0025445	2	0	0	0	0	2
OG0025446	2	0	0	0	0	2
OG0025447	2	0	0	0	0	2
OG0025448	2	0	0	0	0	2
OG0025449	2	0	0	0	0	2
OG0025450	2	0	0	0	0	2
OG0025451	2	0	0	0	0	2
OG0025452	2	0	0	0	0	2
OG0025453	2	0	0	0	0	2
OG0025454	2	0	0	0	0	2
OG0025455	2	0	0	0	0	2
OG0025456	2	0	0	0	0	2
OG0025457	2	0	0	0	0	2
OG0025458	2	0	0	0	0	2
OG0025459	2	0	0	0	0	2
OG0025460	2	0	0	0	0	2
OG0025461	2	0	0	0	0	2
OG0025462	1	0	1	0	0	2
OG0025463	2	0	0	0	0	2
OG0025464	2	0	0	0	0	2
OG0025465	2	0	0	0	0	2
OG0025466	2	0	0	0	0	2
OG0025467	2	0	0	0	0	2
OG0025468	2	0	0	0	0	2
OG0025469	2	0	0	0	0	2
OG0025470	2	0	0	0	0	2
OG0025471	2	0	0	0	0	2
OG0025472	2	0	0	0	0	2
OG0025473	2	0	0	0	0	2
OG0025474	2	0	0	0	0	2
OG0025475	2	0	0	0	0	2
OG0025476	2	0	0	0	0	2
OG0025477	2	0	0	0	0	2
OG0025478	2	0	0	0	0	2
OG0025479	2	0	0	0	0	2
OG0025480	2	0	0	0	0	2
OG0025481	2	0	0	0	0	2
OG0025482	2	0	0	0	0	2
OG0025483	2	0	0	0	0	2
OG0025484	2	0	0	0	0	2
OG0025485	2	0	0	0	0	2
OG0025486	2	0	0	0	0	2
OG0025487	2	0	0	0	0	2
OG0025488	2	0	0	0	0	2
OG0025489	2	0	0	0	0	2
OG0025490	2	0	0	0	0	2
OG0025491	2	0	0	0	0	2
OG0025492	2	0	0	0	0	2
OG0025493	2	0	0	0	0	2
OG0025494	2	0	0	0	0	2
OG0025495	2	0	0	0	0	2
OG0025496	2	0	0	0	0	2
OG0025497	2	0	0	0	0	2
OG0025498	2	0	0	0	0	2
OG0025499	2	0	0	0	0	2
OG0025500	1	1	0	0	0	2
OG0025501	2	0	0	0	0	2
OG0025502	2	0	0	0	0	2
OG0025503	2	0	0	0	0	2
OG0025504	2	0	0	0	0	2
OG0025505	2	0	0	0	0	2
OG0025506	2	0	0	0	0	2
OG0025507	2	0	0	0	0	2
OG0025508	2	0	0	0	0	2
OG0025509	2	0	0	0	0	2
OG0025510	2	0	0	0	0	2
OG0025511	2	0	0	0	0	2
OG0025512	2	0	0	0	0	2
OG0025513	2	0	0	0	0	2
OG0025514	2	0	0	0	0	2
OG0025515	2	0	0	0	0	2
OG0025516	2	0	0	0	0	2
OG0025517	2	0	0	0	0	2
OG0025518	2	0	0	0	0	2
OG0025519	2	0	0	0	0	2
OG0025520	2	0	0	0	0	2
OG0025521	1	0	0	1	0	2
OG0025522	2	0	0	0	0	2
OG0025523	2	0	0	0	0	2
OG0025524	2	0	0	0	0	2
OG0025525	2	0	0	0	0	2
OG0025526	2	0	0	0	0	2
OG0025527	2	0	0	0	0	2
OG0025528	2	0	0	0	0	2
OG0025529	2	0	0	0	0	2
OG0025530	2	0	0	0	0	2
OG0025531	2	0	0	0	0	2
OG0025532	2	0	0	0	0	2
OG0025533	2	0	0	0	0	2
OG0025534	2	0	0	0	0	2
OG0025535	2	0	0	0	0	2
OG0025536	2	0	0	0	0	2
OG0025537	2	0	0	0	0	2
OG0025538	2	0	0	0	0	2
OG0025539	2	0	0	0	0	2
OG0025540	2	0	0	0	0	2
OG0025541	2	0	0	0	0	2
OG0025542	2	0	0	0	0	2
OG0025543	2	0	0	0	0	2
OG0025544	2	0	0	0	0	2
OG0025545	2	0	0	0	0	2
OG0025546	2	0	0	0	0	2
OG0025547	2	0	0	0	0	2
OG0025548	2	0	0	0	0	2
OG0025549	2	0	0	0	0	2
OG0025550	2	0	0	0	0	2
OG0025551	2	0	0	0	0	2
OG0025552	2	0	0	0	0	2
OG0025553	2	0	0	0	0	2
OG0025554	2	0	0	0	0	2
OG0025555	2	0	0	0	0	2
OG0025556	2	0	0	0	0	2
OG0025557	2	0	0	0	0	2
OG0025558	2	0	0	0	0	2
OG0025559	2	0	0	0	0	2
OG0025560	2	0	0	0	0	2
OG0025561	1	1	0	0	0	2
OG0025562	2	0	0	0	0	2
OG0025563	2	0	0	0	0	2
OG0025564	2	0	0	0	0	2
OG0025565	2	0	0	0	0	2
OG0025566	2	0	0	0	0	2
OG0025567	2	0	0	0	0	2
OG0025568	2	0	0	0	0	2
OG0025569	2	0	0	0	0	2
OG0025570	2	0	0	0	0	2
OG0025571	2	0	0	0	0	2
OG0025572	2	0	0	0	0	2
OG0025573	2	0	0	0	0	2
OG0025574	2	0	0	0	0	2
OG0025575	2	0	0	0	0	2
OG0025576	2	0	0	0	0	2
OG0025577	2	0	0	0	0	2
OG0025578	2	0	0	0	0	2
OG0025579	2	0	0	0	0	2
OG0025580	2	0	0	0	0	2
OG0025581	2	0	0	0	0	2
OG0025582	2	0	0	0	0	2
OG0025583	2	0	0	0	0	2
OG0025584	2	0	0	0	0	2
OG0025585	2	0	0	0	0	2
OG0025586	2	0	0	0	0	2
OG0025587	2	0	0	0	0	2
OG0025588	2	0	0	0	0	2
OG0025589	2	0	0	0	0	2
OG0025590	2	0	0	0	0	2
OG0025591	2	0	0	0	0	2
OG0025592	2	0	0	0	0	2
OG0025593	2	0	0	0	0	2
OG0025594	2	0	0	0	0	2
OG0025595	2	0	0	0	0	2
OG0025596	2	0	0	0	0	2
OG0025597	2	0	0	0	0	2
OG0025598	2	0	0	0	0	2
OG0025599	2	0	0	0	0	2
OG0025600	2	0	0	0	0	2
OG0025601	2	0	0	0	0	2
OG0025602	2	0	0	0	0	2
OG0025603	2	0	0	0	0	2
OG0025604	2	0	0	0	0	2
OG0025605	2	0	0	0	0	2
OG0025606	2	0	0	0	0	2
OG0025607	2	0	0	0	0	2
OG0025608	2	0	0	0	0	2
OG0025609	2	0	0	0	0	2
OG0025610	2	0	0	0	0	2
OG0025611	2	0	0	0	0	2
OG0025612	2	0	0	0	0	2
OG0025613	2	0	0	0	0	2
OG0025614	2	0	0	0	0	2
OG0025615	1	1	0	0	0	2
OG0025616	2	0	0	0	0	2
OG0025617	2	0	0	0	0	2
OG0025618	2	0	0	0	0	2
OG0025619	2	0	0	0	0	2
OG0025620	2	0	0	0	0	2
OG0025621	2	0	0	0	0	2
OG0025622	2	0	0	0	0	2
OG0025623	2	0	0	0	0	2
OG0025624	2	0	0	0	0	2
OG0025625	2	0	0	0	0	2
OG0025626	2	0	0	0	0	2
OG0025627	2	0	0	0	0	2
OG0025628	2	0	0	0	0	2
OG0025629	2	0	0	0	0	2
OG0025630	2	0	0	0	0	2
OG0025631	2	0	0	0	0	2
OG0025632	2	0	0	0	0	2
OG0025633	2	0	0	0	0	2
OG0025634	2	0	0	0	0	2
OG0025635	2	0	0	0	0	2
OG0025636	2	0	0	0	0	2
OG0025637	2	0	0	0	0	2
OG0025638	2	0	0	0	0	2
OG0025639	2	0	0	0	0	2
OG0025640	2	0	0	0	0	2
OG0025641	2	0	0	0	0	2
OG0025642	2	0	0	0	0	2
OG0025643	2	0	0	0	0	2
OG0025644	2	0	0	0	0	2
OG0025645	2	0	0	0	0	2
OG0025646	2	0	0	0	0	2
OG0025647	2	0	0	0	0	2
OG0025648	2	0	0	0	0	2
OG0025649	2	0	0	0	0	2
OG0025650	2	0	0	0	0	2
OG0025651	2	0	0	0	0	2
OG0025652	2	0	0	0	0	2
OG0025653	2	0	0	0	0	2
OG0025654	2	0	0	0	0	2
OG0025655	2	0	0	0	0	2
OG0025656	2	0	0	0	0	2
OG0025657	2	0	0	0	0	2
OG0025658	2	0	0	0	0	2
OG0025659	2	0	0	0	0	2
OG0025660	2	0	0	0	0	2
OG0025661	2	0	0	0	0	2
OG0025662	2	0	0	0	0	2
OG0025663	2	0	0	0	0	2
OG0025664	2	0	0	0	0	2
OG0025665	2	0	0	0	0	2
OG0025666	2	0	0	0	0	2
OG0025667	2	0	0	0	0	2
OG0025668	2	0	0	0	0	2
OG0025669	2	0	0	0	0	2
OG0025670	2	0	0	0	0	2
OG0025671	2	0	0	0	0	2
OG0025672	2	0	0	0	0	2
OG0025673	2	0	0	0	0	2
OG0025674	1	0	1	0	0	2
OG0025675	2	0	0	0	0	2
OG0025676	2	0	0	0	0	2
OG0025677	2	0	0	0	0	2
OG0025678	2	0	0	0	0	2
OG0025679	2	0	0	0	0	2
OG0025680	2	0	0	0	0	2
OG0025681	2	0	0	0	0	2
OG0025682	2	0	0	0	0	2
OG0025683	2	0	0	0	0	2
OG0025684	2	0	0	0	0	2
OG0025685	2	0	0	0	0	2
OG0025686	2	0	0	0	0	2
OG0025687	2	0	0	0	0	2
OG0025688	2	0	0	0	0	2
OG0025689	2	0	0	0	0	2
OG0025690	2	0	0	0	0	2
OG0025691	2	0	0	0	0	2
OG0025692	2	0	0	0	0	2
OG0025693	2	0	0	0	0	2
OG0025694	2	0	0	0	0	2
OG0025695	2	0	0	0	0	2
OG0025696	2	0	0	0	0	2
OG0025697	2	0	0	0	0	2
OG0025698	2	0	0	0	0	2
OG0025699	2	0	0	0	0	2
OG0025700	2	0	0	0	0	2
OG0025701	2	0	0	0	0	2
OG0025702	2	0	0	0	0	2
OG0025703	2	0	0	0	0	2
OG0025704	2	0	0	0	0	2
OG0025705	2	0	0	0	0	2
OG0025706	2	0	0	0	0	2
OG0025707	2	0	0	0	0	2
OG0025708	2	0	0	0	0	2
OG0025709	2	0	0	0	0	2
OG0025710	2	0	0	0	0	2
OG0025711	2	0	0	0	0	2
OG0025712	2	0	0	0	0	2
OG0025713	2	0	0	0	0	2
OG0025714	2	0	0	0	0	2
OG0025715	2	0	0	0	0	2
OG0025716	2	0	0	0	0	2
OG0025717	2	0	0	0	0	2
OG0025718	2	0	0	0	0	2
OG0025719	2	0	0	0	0	2
OG0025720	2	0	0	0	0	2
OG0025721	2	0	0	0	0	2
OG0025722	2	0	0	0	0	2
OG0025723	2	0	0	0	0	2
OG0025724	2	0	0	0	0	2
OG0025725	2	0	0	0	0	2
OG0025726	2	0	0	0	0	2
OG0025727	2	0	0	0	0	2
OG0025728	2	0	0	0	0	2
OG0025729	2	0	0	0	0	2
OG0025730	2	0	0	0	0	2
OG0025731	2	0	0	0	0	2
OG0025732	2	0	0	0	0	2
OG0025733	2	0	0	0	0	2
OG0025734	2	0	0	0	0	2
OG0025735	2	0	0	0	0	2
OG0025736	2	0	0	0	0	2
OG0025737	2	0	0	0	0	2
OG0025738	2	0	0	0	0	2
OG0025739	2	0	0	0	0	2
OG0025740	2	0	0	0	0	2
OG0025741	2	0	0	0	0	2
OG0025742	2	0	0	0	0	2
OG0025743	2	0	0	0	0	2
OG0025744	2	0	0	0	0	2
OG0025745	1	1	0	0	0	2
OG0025746	2	0	0	0	0	2
OG0025747	2	0	0	0	0	2
OG0025748	2	0	0	0	0	2
OG0025749	2	0	0	0	0	2
OG0025750	2	0	0	0	0	2
OG0025751	2	0	0	0	0	2
OG0025752	2	0	0	0	0	2
OG0025753	2	0	0	0	0	2
OG0025754	2	0	0	0	0	2
OG0025755	2	0	0	0	0	2
OG0025756	2	0	0	0	0	2
OG0025757	2	0	0	0	0	2
OG0025758	2	0	0	0	0	2
OG0025759	2	0	0	0	0	2
OG0025760	2	0	0	0	0	2
OG0025761	2	0	0	0	0	2
OG0025762	2	0	0	0	0	2
OG0025763	2	0	0	0	0	2
OG0025764	2	0	0	0	0	2
OG0025765	2	0	0	0	0	2
OG0025766	2	0	0	0	0	2
OG0025767	2	0	0	0	0	2
OG0025768	2	0	0	0	0	2
OG0025769	2	0	0	0	0	2
OG0025770	2	0	0	0	0	2
OG0025771	2	0	0	0	0	2
OG0025772	2	0	0	0	0	2
OG0025773	2	0	0	0	0	2
OG0025774	2	0	0	0	0	2
OG0025775	2	0	0	0	0	2
OG0025776	2	0	0	0	0	2
OG0025777	2	0	0	0	0	2
OG0025778	2	0	0	0	0	2
OG0025779	2	0	0	0	0	2
OG0025780	2	0	0	0	0	2
OG0025781	2	0	0	0	0	2
OG0025782	2	0	0	0	0	2
OG0025783	2	0	0	0	0	2
OG0025784	2	0	0	0	0	2
OG0025785	2	0	0	0	0	2
OG0025786	2	0	0	0	0	2
OG0025787	2	0	0	0	0	2
OG0025788	2	0	0	0	0	2
OG0025789	2	0	0	0	0	2
OG0025790	2	0	0	0	0	2
OG0025791	2	0	0	0	0	2
OG0025792	2	0	0	0	0	2
OG0025793	2	0	0	0	0	2
OG0025794	2	0	0	0	0	2
OG0025795	2	0	0	0	0	2
OG0025796	2	0	0	0	0	2
OG0025797	2	0	0	0	0	2
OG0025798	2	0	0	0	0	2
OG0025799	2	0	0	0	0	2
OG0025800	2	0	0	0	0	2
OG0025801	2	0	0	0	0	2
OG0025802	2	0	0	0	0	2
OG0025803	2	0	0	0	0	2
OG0025804	2	0	0	0	0	2
OG0025805	2	0	0	0	0	2
OG0025806	2	0	0	0	0	2
OG0025807	2	0	0	0	0	2
OG0025808	2	0	0	0	0	2
OG0025809	2	0	0	0	0	2
OG0025810	2	0	0	0	0	2
OG0025811	2	0	0	0	0	2
OG0025812	2	0	0	0	0	2
OG0025813	2	0	0	0	0	2
OG0025814	2	0	0	0	0	2
OG0025815	2	0	0	0	0	2
OG0025816	2	0	0	0	0	2
OG0025817	2	0	0	0	0	2
OG0025818	2	0	0	0	0	2
OG0025819	2	0	0	0	0	2
OG0025820	2	0	0	0	0	2
OG0025821	2	0	0	0	0	2
OG0025822	2	0	0	0	0	2
OG0025823	2	0	0	0	0	2
OG0025824	2	0	0	0	0	2
OG0025825	2	0	0	0	0	2
OG0025826	2	0	0	0	0	2
OG0025827	2	0	0	0	0	2
OG0025828	2	0	0	0	0	2
OG0025829	2	0	0	0	0	2
OG0025830	2	0	0	0	0	2
OG0025831	1	0	1	0	0	2
OG0025832	2	0	0	0	0	2
OG0025833	2	0	0	0	0	2
OG0025834	1	0	0	0	1	2
OG0025835	2	0	0	0	0	2
OG0025836	2	0	0	0	0	2
OG0025837	2	0	0	0	0	2
OG0025838	2	0	0	0	0	2
OG0025839	2	0	0	0	0	2
OG0025840	2	0	0	0	0	2
OG0025841	2	0	0	0	0	2
OG0025842	2	0	0	0	0	2
OG0025843	2	0	0	0	0	2
OG0025844	1	0	0	0	1	2
OG0025845	2	0	0	0	0	2
OG0025846	2	0	0	0	0	2
OG0025847	2	0	0	0	0	2
OG0025848	2	0	0	0	0	2
OG0025849	2	0	0	0	0	2
OG0025850	2	0	0	0	0	2
OG0025851	2	0	0	0	0	2
OG0025852	2	0	0	0	0	2
OG0025853	2	0	0	0	0	2
OG0025854	2	0	0	0	0	2
OG0025855	2	0	0	0	0	2
OG0025856	2	0	0	0	0	2
OG0025857	2	0	0	0	0	2
OG0025858	2	0	0	0	0	2
OG0025859	2	0	0	0	0	2
OG0025860	2	0	0	0	0	2
OG0025861	2	0	0	0	0	2
OG0025862	2	0	0	0	0	2
OG0025863	2	0	0	0	0	2
OG0025864	1	0	0	0	1	2
OG0025865	2	0	0	0	0	2
OG0025866	2	0	0	0	0	2
OG0025867	2	0	0	0	0	2
OG0025868	2	0	0	0	0	2
OG0025869	2	0	0	0	0	2
OG0025870	2	0	0	0	0	2
OG0025871	2	0	0	0	0	2
OG0025872	2	0	0	0	0	2
OG0025873	2	0	0	0	0	2
OG0025874	2	0	0	0	0	2
OG0025875	2	0	0	0	0	2
OG0025876	2	0	0	0	0	2
OG0025877	2	0	0	0	0	2
OG0025878	2	0	0	0	0	2
OG0025879	2	0	0	0	0	2
OG0025880	2	0	0	0	0	2
OG0025881	2	0	0	0	0	2
OG0025882	2	0	0	0	0	2
OG0025883	2	0	0	0	0	2
OG0025884	2	0	0	0	0	2
OG0025885	2	0	0	0	0	2
OG0025886	2	0	0	0	0	2
OG0025887	2	0	0	0	0	2
OG0025888	2	0	0	0	0	2
OG0025889	2	0	0	0	0	2
OG0025890	2	0	0	0	0	2
OG0025891	2	0	0	0	0	2
OG0025892	2	0	0	0	0	2
OG0025893	2	0	0	0	0	2
OG0025894	2	0	0	0	0	2
OG0025895	2	0	0	0	0	2
OG0025896	2	0	0	0	0	2
OG0025897	2	0	0	0	0	2
OG0025898	2	0	0	0	0	2
OG0025899	1	1	0	0	0	2
OG0025900	2	0	0	0	0	2
OG0025901	2	0	0	0	0	2
OG0025902	2	0	0	0	0	2
OG0025903	2	0	0	0	0	2
OG0025904	2	0	0	0	0	2
OG0025905	2	0	0	0	0	2
OG0025906	2	0	0	0	0	2
OG0025907	2	0	0	0	0	2
OG0025908	2	0	0	0	0	2
OG0025909	2	0	0	0	0	2
OG0025910	2	0	0	0	0	2
OG0025911	2	0	0	0	0	2
OG0025912	2	0	0	0	0	2
OG0025913	2	0	0	0	0	2
OG0025914	2	0	0	0	0	2
OG0025915	2	0	0	0	0	2
OG0025916	2	0	0	0	0	2
OG0025917	2	0	0	0	0	2
OG0025918	2	0	0	0	0	2
OG0025919	2	0	0	0	0	2
OG0025920	2	0	0	0	0	2
OG0025921	2	0	0	0	0	2
OG0025922	2	0	0	0	0	2
OG0025923	2	0	0	0	0	2
OG0025924	2	0	0	0	0	2
OG0025925	2	0	0	0	0	2
OG0025926	2	0	0	0	0	2
OG0025927	2	0	0	0	0	2
OG0025928	2	0	0	0	0	2
OG0025929	2	0	0	0	0	2
OG0025930	2	0	0	0	0	2
OG0025931	2	0	0	0	0	2
OG0025932	2	0	0	0	0	2
OG0025933	2	0	0	0	0	2
OG0025934	2	0	0	0	0	2
OG0025935	2	0	0	0	0	2
OG0025936	2	0	0	0	0	2
OG0025937	1	0	0	0	1	2
OG0025938	2	0	0	0	0	2
OG0025939	2	0	0	0	0	2
OG0025940	2	0	0	0	0	2
OG0025941	2	0	0	0	0	2
OG0025942	2	0	0	0	0	2
OG0025943	2	0	0	0	0	2
OG0025944	2	0	0	0	0	2
OG0025945	2	0	0	0	0	2
OG0025946	2	0	0	0	0	2
OG0025947	2	0	0	0	0	2
OG0025948	2	0	0	0	0	2
OG0025949	2	0	0	0	0	2
OG0025950	1	0	1	0	0	2
OG0025951	2	0	0	0	0	2
OG0025952	2	0	0	0	0	2
OG0025953	2	0	0	0	0	2
OG0025954	2	0	0	0	0	2
OG0025955	2	0	0	0	0	2
OG0025956	2	0	0	0	0	2
OG0025957	2	0	0	0	0	2
OG0025958	2	0	0	0	0	2
OG0025959	2	0	0	0	0	2
OG0025960	2	0	0	0	0	2
OG0025961	2	0	0	0	0	2
OG0025962	2	0	0	0	0	2
OG0025963	2	0	0	0	0	2
OG0025964	2	0	0	0	0	2
OG0025965	2	0	0	0	0	2
OG0025966	2	0	0	0	0	2
OG0025967	2	0	0	0	0	2
OG0025968	2	0	0	0	0	2
OG0025969	2	0	0	0	0	2
OG0025970	2	0	0	0	0	2
OG0025971	2	0	0	0	0	2
OG0025972	2	0	0	0	0	2
OG0025973	2	0	0	0	0	2
OG0025974	2	0	0	0	0	2
OG0025975	2	0	0	0	0	2
OG0025976	2	0	0	0	0	2
OG0025977	2	0	0	0	0	2
OG0025978	2	0	0	0	0	2
OG0025979	2	0	0	0	0	2
OG0025980	2	0	0	0	0	2
OG0025981	2	0	0	0	0	2
OG0025982	2	0	0	0	0	2
OG0025983	2	0	0	0	0	2
OG0025984	2	0	0	0	0	2
OG0025985	2	0	0	0	0	2
OG0025986	2	0	0	0	0	2
OG0025987	2	0	0	0	0	2
OG0025988	2	0	0	0	0	2
OG0025989	2	0	0	0	0	2
OG0025990	2	0	0	0	0	2
OG0025991	2	0	0	0	0	2
OG0025992	2	0	0	0	0	2
OG0025993	1	1	0	0	0	2
OG0025994	2	0	0	0	0	2
OG0025995	2	0	0	0	0	2
OG0025996	2	0	0	0	0	2
OG0025997	2	0	0	0	0	2
OG0025998	2	0	0	0	0	2
OG0025999	2	0	0	0	0	2
OG0026000	2	0	0	0	0	2
OG0026001	2	0	0	0	0	2
OG0026002	2	0	0	0	0	2
OG0026003	2	0	0	0	0	2
OG0026004	2	0	0	0	0	2
OG0026005	2	0	0	0	0	2
OG0026006	2	0	0	0	0	2
OG0026007	2	0	0	0	0	2
OG0026008	2	0	0	0	0	2
OG0026009	2	0	0	0	0	2
OG0026010	1	0	1	0	0	2
OG0026011	2	0	0	0	0	2
OG0026012	2	0	0	0	0	2
OG0026013	2	0	0	0	0	2
OG0026014	2	0	0	0	0	2
OG0026015	2	0	0	0	0	2
OG0026016	2	0	0	0	0	2
OG0026017	2	0	0	0	0	2
OG0026018	2	0	0	0	0	2
OG0026019	2	0	0	0	0	2
OG0026020	2	0	0	0	0	2
OG0026021	2	0	0	0	0	2
OG0026022	2	0	0	0	0	2
OG0026023	2	0	0	0	0	2
OG0026024	2	0	0	0	0	2
OG0026025	2	0	0	0	0	2
OG0026026	2	0	0	0	0	2
OG0026027	2	0	0	0	0	2
OG0026028	2	0	0	0	0	2
OG0026029	2	0	0	0	0	2
OG0026030	2	0	0	0	0	2
OG0026031	2	0	0	0	0	2
OG0026032	2	0	0	0	0	2
OG0026033	2	0	0	0	0	2
OG0026034	2	0	0	0	0	2
OG0026035	2	0	0	0	0	2
OG0026036	2	0	0	0	0	2
OG0026037	1	0	1	0	0	2
OG0026038	2	0	0	0	0	2
OG0026039	2	0	0	0	0	2
OG0026040	2	0	0	0	0	2
OG0026041	2	0	0	0	0	2
OG0026042	2	0	0	0	0	2
OG0026043	2	0	0	0	0	2
OG0026044	2	0	0	0	0	2
OG0026045	2	0	0	0	0	2
OG0026046	2	0	0	0	0	2
OG0026047	2	0	0	0	0	2
OG0026048	2	0	0	0	0	2
OG0026049	2	0	0	0	0	2
OG0026050	2	0	0	0	0	2
OG0026051	2	0	0	0	0	2
OG0026052	1	0	1	0	0	2
OG0026053	2	0	0	0	0	2
OG0026054	2	0	0	0	0	2
OG0026055	2	0	0	0	0	2
OG0026056	2	0	0	0	0	2
OG0026057	2	0	0	0	0	2
OG0026058	2	0	0	0	0	2
OG0026059	2	0	0	0	0	2
OG0026060	2	0	0	0	0	2
OG0026061	2	0	0	0	0	2
OG0026062	2	0	0	0	0	2
OG0026063	2	0	0	0	0	2
OG0026064	2	0	0	0	0	2
OG0026065	2	0	0	0	0	2
OG0026066	2	0	0	0	0	2
OG0026067	2	0	0	0	0	2
OG0026068	2	0	0	0	0	2
OG0026069	2	0	0	0	0	2
OG0026070	2	0	0	0	0	2
OG0026071	2	0	0	0	0	2
OG0026072	1	0	0	1	0	2
OG0026073	2	0	0	0	0	2
OG0026074	2	0	0	0	0	2
OG0026075	2	0	0	0	0	2
OG0026076	2	0	0	0	0	2
OG0026077	2	0	0	0	0	2
OG0026078	2	0	0	0	0	2
OG0026079	2	0	0	0	0	2
OG0026080	2	0	0	0	0	2
OG0026081	2	0	0	0	0	2
OG0026082	2	0	0	0	0	2
OG0026083	2	0	0	0	0	2
OG0026084	2	0	0	0	0	2
OG0026085	2	0	0	0	0	2
OG0026086	2	0	0	0	0	2
OG0026087	2	0	0	0	0	2
OG0026088	2	0	0	0	0	2
OG0026089	2	0	0	0	0	2
OG0026090	2	0	0	0	0	2
OG0026091	2	0	0	0	0	2
OG0026092	2	0	0	0	0	2
OG0026093	2	0	0	0	0	2
OG0026094	2	0	0	0	0	2
OG0026095	2	0	0	0	0	2
OG0026096	2	0	0	0	0	2
OG0026097	2	0	0	0	0	2
OG0026098	2	0	0	0	0	2
OG0026099	2	0	0	0	0	2
OG0026100	2	0	0	0	0	2
OG0026101	2	0	0	0	0	2
OG0026102	2	0	0	0	0	2
OG0026103	2	0	0	0	0	2
OG0026104	2	0	0	0	0	2
OG0026105	2	0	0	0	0	2
OG0026106	2	0	0	0	0	2
OG0026107	2	0	0	0	0	2
OG0026108	2	0	0	0	0	2
OG0026109	2	0	0	0	0	2
OG0026110	2	0	0	0	0	2
OG0026111	2	0	0	0	0	2
OG0026112	2	0	0	0	0	2
OG0026113	2	0	0	0	0	2
OG0026114	2	0	0	0	0	2
OG0026115	2	0	0	0	0	2
OG0026116	2	0	0	0	0	2
OG0026117	2	0	0	0	0	2
OG0026118	2	0	0	0	0	2
OG0026119	2	0	0	0	0	2
OG0026120	2	0	0	0	0	2
OG0026121	2	0	0	0	0	2
OG0026122	2	0	0	0	0	2
OG0026123	2	0	0	0	0	2
OG0026124	2	0	0	0	0	2
OG0026125	2	0	0	0	0	2
OG0026126	2	0	0	0	0	2
OG0026127	2	0	0	0	0	2
OG0026128	2	0	0	0	0	2
OG0026129	2	0	0	0	0	2
OG0026130	2	0	0	0	0	2
OG0026131	2	0	0	0	0	2
OG0026132	2	0	0	0	0	2
OG0026133	2	0	0	0	0	2
OG0026134	2	0	0	0	0	2
OG0026135	2	0	0	0	0	2
OG0026136	2	0	0	0	0	2
OG0026137	2	0	0	0	0	2
OG0026138	2	0	0	0	0	2
OG0026139	2	0	0	0	0	2
OG0026140	2	0	0	0	0	2
OG0026141	2	0	0	0	0	2
OG0026142	2	0	0	0	0	2
OG0026143	2	0	0	0	0	2
OG0026144	2	0	0	0	0	2
OG0026145	2	0	0	0	0	2
OG0026146	2	0	0	0	0	2
OG0026147	2	0	0	0	0	2
OG0026148	2	0	0	0	0	2
OG0026149	2	0	0	0	0	2
OG0026150	2	0	0	0	0	2
OG0026151	2	0	0	0	0	2
OG0026152	2	0	0	0	0	2
OG0026153	2	0	0	0	0	2
OG0026154	2	0	0	0	0	2
OG0026155	2	0	0	0	0	2
OG0026156	2	0	0	0	0	2
OG0026157	2	0	0	0	0	2
OG0026158	2	0	0	0	0	2
OG0026159	2	0	0	0	0	2
OG0026160	2	0	0	0	0	2
OG0026161	2	0	0	0	0	2
OG0026162	2	0	0	0	0	2
OG0026163	2	0	0	0	0	2
OG0026164	2	0	0	0	0	2
OG0026165	2	0	0	0	0	2
OG0026166	2	0	0	0	0	2
OG0026167	2	0	0	0	0	2
OG0026168	2	0	0	0	0	2
OG0026169	2	0	0	0	0	2
OG0026170	2	0	0	0	0	2
OG0026171	2	0	0	0	0	2
OG0026172	2	0	0	0	0	2
OG0026173	2	0	0	0	0	2
OG0026174	2	0	0	0	0	2
OG0026175	2	0	0	0	0	2
OG0026176	2	0	0	0	0	2
OG0026177	2	0	0	0	0	2
OG0026178	2	0	0	0	0	2
OG0026179	2	0	0	0	0	2
OG0026180	2	0	0	0	0	2
OG0026181	2	0	0	0	0	2
OG0026182	2	0	0	0	0	2
OG0026183	2	0	0	0	0	2
OG0026184	2	0	0	0	0	2
OG0026185	2	0	0	0	0	2
OG0026186	2	0	0	0	0	2
OG0026187	2	0	0	0	0	2
OG0026188	2	0	0	0	0	2
OG0026189	2	0	0	0	0	2
OG0026190	2	0	0	0	0	2
OG0026191	2	0	0	0	0	2
OG0026192	2	0	0	0	0	2
OG0026193	2	0	0	0	0	2
OG0026194	2	0	0	0	0	2
OG0026195	2	0	0	0	0	2
OG0026196	2	0	0	0	0	2
OG0026197	2	0	0	0	0	2
OG0026198	2	0	0	0	0	2
OG0026199	2	0	0	0	0	2
OG0026200	2	0	0	0	0	2
OG0026201	2	0	0	0	0	2
OG0026202	2	0	0	0	0	2
OG0026203	2	0	0	0	0	2
OG0026204	2	0	0	0	0	2
OG0026205	2	0	0	0	0	2
OG0026206	2	0	0	0	0	2
OG0026207	2	0	0	0	0	2
OG0026208	2	0	0	0	0	2
OG0026209	2	0	0	0	0	2
OG0026210	2	0	0	0	0	2
OG0026211	2	0	0	0	0	2
OG0026212	2	0	0	0	0	2
OG0026213	2	0	0	0	0	2
OG0026214	2	0	0	0	0	2
OG0026215	2	0	0	0	0	2
OG0026216	2	0	0	0	0	2
OG0026217	2	0	0	0	0	2
OG0026218	2	0	0	0	0	2
OG0026219	2	0	0	0	0	2
OG0026220	2	0	0	0	0	2
OG0026221	2	0	0	0	0	2
OG0026222	2	0	0	0	0	2
OG0026223	2	0	0	0	0	2
OG0026224	2	0	0	0	0	2
OG0026225	2	0	0	0	0	2
OG0026226	2	0	0	0	0	2
OG0026227	2	0	0	0	0	2
OG0026228	2	0	0	0	0	2
OG0026229	1	0	1	0	0	2
OG0026230	2	0	0	0	0	2
OG0026231	2	0	0	0	0	2
OG0026232	2	0	0	0	0	2
OG0026233	2	0	0	0	0	2
OG0026234	2	0	0	0	0	2
OG0026235	2	0	0	0	0	2
OG0026236	2	0	0	0	0	2
OG0026237	2	0	0	0	0	2
OG0026238	2	0	0	0	0	2
OG0026239	2	0	0	0	0	2
OG0026240	2	0	0	0	0	2
OG0026241	2	0	0	0	0	2
OG0026242	2	0	0	0	0	2
OG0026243	2	0	0	0	0	2
OG0026244	2	0	0	0	0	2
OG0026245	2	0	0	0	0	2
OG0026246	2	0	0	0	0	2
OG0026247	2	0	0	0	0	2
OG0026248	2	0	0	0	0	2
OG0026249	2	0	0	0	0	2
OG0026250	2	0	0	0	0	2
OG0026251	1	0	1	0	0	2
OG0026252	2	0	0	0	0	2
OG0026253	2	0	0	0	0	2
OG0026254	2	0	0	0	0	2
OG0026255	2	0	0	0	0	2
OG0026256	2	0	0	0	0	2
OG0026257	2	0	0	0	0	2
OG0026258	2	0	0	0	0	2
OG0026259	2	0	0	0	0	2
OG0026260	2	0	0	0	0	2
OG0026261	2	0	0	0	0	2
OG0026262	2	0	0	0	0	2
OG0026263	2	0	0	0	0	2
OG0026264	2	0	0	0	0	2
OG0026265	2	0	0	0	0	2
OG0026266	2	0	0	0	0	2
OG0026267	2	0	0	0	0	2
OG0026268	2	0	0	0	0	2
OG0026269	2	0	0	0	0	2
OG0026270	2	0	0	0	0	2
OG0026271	2	0	0	0	0	2
OG0026272	2	0	0	0	0	2
OG0026273	2	0	0	0	0	2
OG0026274	2	0	0	0	0	2
OG0026275	2	0	0	0	0	2
OG0026276	2	0	0	0	0	2
OG0026277	2	0	0	0	0	2
OG0026278	2	0	0	0	0	2
OG0026279	2	0	0	0	0	2
OG0026280	2	0	0	0	0	2
OG0026281	2	0	0	0	0	2
OG0026282	2	0	0	0	0	2
OG0026283	2	0	0	0	0	2
OG0026284	2	0	0	0	0	2
OG0026285	2	0	0	0	0	2
OG0026286	2	0	0	0	0	2
OG0026287	2	0	0	0	0	2
OG0026288	2	0	0	0	0	2
OG0026289	2	0	0	0	0	2
OG0026290	2	0	0	0	0	2
OG0026291	2	0	0	0	0	2
OG0026292	2	0	0	0	0	2
OG0026293	2	0	0	0	0	2
OG0026294	2	0	0	0	0	2
OG0026295	2	0	0	0	0	2
OG0026296	2	0	0	0	0	2
OG0026297	1	1	0	0	0	2
OG0026298	2	0	0	0	0	2
OG0026299	2	0	0	0	0	2
OG0026300	2	0	0	0	0	2
OG0026301	2	0	0	0	0	2
OG0026302	2	0	0	0	0	2
OG0026303	2	0	0	0	0	2
OG0026304	2	0	0	0	0	2
OG0026305	2	0	0	0	0	2
OG0026306	2	0	0	0	0	2
OG0026307	2	0	0	0	0	2
OG0026308	2	0	0	0	0	2
OG0026309	2	0	0	0	0	2
OG0026310	2	0	0	0	0	2
OG0026311	2	0	0	0	0	2
OG0026312	2	0	0	0	0	2
OG0026313	2	0	0	0	0	2
OG0026314	2	0	0	0	0	2
OG0026315	2	0	0	0	0	2
OG0026316	2	0	0	0	0	2
OG0026317	2	0	0	0	0	2
OG0026318	2	0	0	0	0	2
OG0026319	2	0	0	0	0	2
OG0026320	2	0	0	0	0	2
OG0026321	2	0	0	0	0	2
OG0026322	2	0	0	0	0	2
OG0026323	2	0	0	0	0	2
OG0026324	2	0	0	0	0	2
OG0026325	2	0	0	0	0	2
OG0026326	2	0	0	0	0	2
OG0026327	2	0	0	0	0	2
OG0026328	2	0	0	0	0	2
OG0026329	2	0	0	0	0	2
OG0026330	2	0	0	0	0	2
OG0026331	2	0	0	0	0	2
OG0026332	2	0	0	0	0	2
OG0026333	2	0	0	0	0	2
OG0026334	2	0	0	0	0	2
OG0026335	2	0	0	0	0	2
OG0026336	2	0	0	0	0	2
OG0026337	2	0	0	0	0	2
OG0026338	2	0	0	0	0	2
OG0026339	2	0	0	0	0	2
OG0026340	2	0	0	0	0	2
OG0026341	2	0	0	0	0	2
OG0026342	2	0	0	0	0	2
OG0026343	2	0	0	0	0	2
OG0026344	2	0	0	0	0	2
OG0026345	2	0	0	0	0	2
OG0026346	2	0	0	0	0	2
OG0026347	2	0	0	0	0	2
OG0026348	2	0	0	0	0	2
OG0026349	2	0	0	0	0	2
OG0026350	2	0	0	0	0	2
OG0026351	2	0	0	0	0	2
OG0026352	2	0	0	0	0	2
OG0026353	2	0	0	0	0	2
OG0026354	2	0	0	0	0	2
OG0026355	2	0	0	0	0	2
OG0026356	2	0	0	0	0	2
OG0026357	2	0	0	0	0	2
OG0026358	2	0	0	0	0	2
OG0026359	2	0	0	0	0	2
OG0026360	2	0	0	0	0	2
OG0026361	2	0	0	0	0	2
OG0026362	2	0	0	0	0	2
OG0026363	2	0	0	0	0	2
OG0026364	2	0	0	0	0	2
OG0026365	2	0	0	0	0	2
OG0026366	2	0	0	0	0	2
OG0026367	2	0	0	0	0	2
OG0026368	2	0	0	0	0	2
OG0026369	2	0	0	0	0	2
OG0026370	2	0	0	0	0	2
OG0026371	2	0	0	0	0	2
OG0026372	2	0	0	0	0	2
OG0026373	2	0	0	0	0	2
OG0026374	2	0	0	0	0	2
OG0026375	2	0	0	0	0	2
OG0026376	2	0	0	0	0	2
OG0026377	2	0	0	0	0	2
OG0026378	2	0	0	0	0	2
OG0026379	2	0	0	0	0	2
OG0026380	2	0	0	0	0	2
OG0026381	2	0	0	0	0	2
OG0026382	2	0	0	0	0	2
OG0026383	2	0	0	0	0	2
OG0026384	2	0	0	0	0	2
OG0026385	2	0	0	0	0	2
OG0026386	2	0	0	0	0	2
OG0026387	2	0	0	0	0	2
OG0026388	2	0	0	0	0	2
OG0026389	1	0	1	0	0	2
OG0026390	2	0	0	0	0	2
OG0026391	1	0	0	1	0	2
OG0026392	2	0	0	0	0	2
OG0026393	2	0	0	0	0	2
OG0026394	2	0	0	0	0	2
OG0026395	2	0	0	0	0	2
OG0026396	2	0	0	0	0	2
OG0026397	2	0	0	0	0	2
OG0026398	2	0	0	0	0	2
OG0026399	2	0	0	0	0	2
OG0026400	2	0	0	0	0	2
OG0026401	2	0	0	0	0	2
OG0026402	2	0	0	0	0	2
OG0026403	2	0	0	0	0	2
OG0026404	2	0	0	0	0	2
OG0026405	2	0	0	0	0	2
OG0026406	2	0	0	0	0	2
OG0026407	2	0	0	0	0	2
OG0026408	2	0	0	0	0	2
OG0026409	2	0	0	0	0	2
OG0026410	2	0	0	0	0	2
OG0026411	2	0	0	0	0	2
OG0026412	2	0	0	0	0	2
OG0026413	2	0	0	0	0	2
OG0026414	2	0	0	0	0	2
OG0026415	2	0	0	0	0	2
OG0026416	2	0	0	0	0	2
OG0026417	2	0	0	0	0	2
OG0026418	1	0	0	1	0	2
OG0026419	2	0	0	0	0	2
OG0026420	2	0	0	0	0	2
OG0026421	2	0	0	0	0	2
OG0026422	2	0	0	0	0	2
OG0026423	2	0	0	0	0	2
OG0026424	2	0	0	0	0	2
OG0026425	2	0	0	0	0	2
OG0026426	2	0	0	0	0	2
OG0026427	2	0	0	0	0	2
OG0026428	2	0	0	0	0	2
OG0026429	2	0	0	0	0	2
OG0026430	1	1	0	0	0	2
OG0026431	1	0	0	1	0	2
OG0026432	2	0	0	0	0	2
OG0026433	2	0	0	0	0	2
OG0026434	2	0	0	0	0	2
OG0026435	2	0	0	0	0	2
OG0026436	2	0	0	0	0	2
OG0026437	2	0	0	0	0	2
OG0026438	2	0	0	0	0	2
OG0026439	2	0	0	0	0	2
OG0026440	2	0	0	0	0	2
OG0026441	2	0	0	0	0	2
OG0026442	2	0	0	0	0	2
OG0026443	2	0	0	0	0	2
OG0026444	2	0	0	0	0	2
OG0026445	1	0	1	0	0	2
OG0026446	2	0	0	0	0	2
OG0026447	2	0	0	0	0	2
OG0026448	2	0	0	0	0	2
OG0026449	2	0	0	0	0	2
OG0026450	2	0	0	0	0	2
OG0026451	2	0	0	0	0	2
OG0026452	2	0	0	0	0	2
OG0026453	2	0	0	0	0	2
OG0026454	2	0	0	0	0	2
OG0026455	2	0	0	0	0	2
OG0026456	2	0	0	0	0	2
OG0026457	2	0	0	0	0	2
OG0026458	2	0	0	0	0	2
OG0026459	2	0	0	0	0	2
OG0026460	2	0	0	0	0	2
OG0026461	2	0	0	0	0	2
OG0026462	2	0	0	0	0	2
OG0026463	1	0	1	0	0	2
OG0026464	2	0	0	0	0	2
OG0026465	2	0	0	0	0	2
OG0026466	2	0	0	0	0	2
OG0026467	2	0	0	0	0	2
OG0026468	2	0	0	0	0	2
OG0026469	2	0	0	0	0	2
OG0026470	2	0	0	0	0	2
OG0026471	2	0	0	0	0	2
OG0026472	2	0	0	0	0	2
OG0026473	2	0	0	0	0	2
OG0026474	2	0	0	0	0	2
OG0026475	2	0	0	0	0	2
OG0026476	2	0	0	0	0	2
OG0026477	2	0	0	0	0	2
OG0026478	2	0	0	0	0	2
OG0026479	2	0	0	0	0	2
OG0026480	2	0	0	0	0	2
OG0026481	2	0	0	0	0	2
OG0026482	2	0	0	0	0	2
OG0026483	2	0	0	0	0	2
OG0026484	2	0	0	0	0	2
OG0026485	1	0	1	0	0	2
OG0026486	2	0	0	0	0	2
OG0026487	2	0	0	0	0	2
OG0026488	2	0	0	0	0	2
OG0026489	2	0	0	0	0	2
OG0026490	2	0	0	0	0	2
OG0026491	2	0	0	0	0	2
OG0026492	2	0	0	0	0	2
OG0026493	2	0	0	0	0	2
OG0026494	2	0	0	0	0	2
OG0026495	2	0	0	0	0	2
OG0026496	2	0	0	0	0	2
OG0026497	2	0	0	0	0	2
OG0026498	2	0	0	0	0	2
OG0026499	2	0	0	0	0	2
OG0026500	2	0	0	0	0	2
OG0026501	2	0	0	0	0	2
OG0026502	2	0	0	0	0	2
OG0026503	2	0	0	0	0	2
OG0026504	2	0	0	0	0	2
OG0026505	1	0	1	0	0	2
OG0026506	2	0	0	0	0	2
OG0026507	2	0	0	0	0	2
OG0026508	2	0	0	0	0	2
OG0026509	2	0	0	0	0	2
OG0026510	2	0	0	0	0	2
OG0026511	2	0	0	0	0	2
OG0026512	2	0	0	0	0	2
OG0026513	2	0	0	0	0	2
OG0026514	2	0	0	0	0	2
OG0026515	2	0	0	0	0	2
OG0026516	2	0	0	0	0	2
OG0026517	2	0	0	0	0	2
OG0026518	2	0	0	0	0	2
OG0026519	2	0	0	0	0	2
OG0026520	1	0	1	0	0	2
OG0026521	2	0	0	0	0	2
OG0026522	2	0	0	0	0	2
OG0026523	2	0	0	0	0	2
OG0026524	1	0	0	1	0	2
OG0026525	2	0	0	0	0	2
OG0026526	2	0	0	0	0	2
OG0026527	2	0	0	0	0	2
OG0026528	2	0	0	0	0	2
OG0026529	2	0	0	0	0	2
OG0026530	2	0	0	0	0	2
OG0026531	2	0	0	0	0	2
OG0026532	2	0	0	0	0	2
OG0026533	2	0	0	0	0	2
OG0026534	2	0	0	0	0	2
OG0026535	2	0	0	0	0	2
OG0026536	1	1	0	0	0	2
OG0026537	2	0	0	0	0	2
OG0026538	2	0	0	0	0	2
OG0026539	2	0	0	0	0	2
OG0026540	2	0	0	0	0	2
OG0026541	2	0	0	0	0	2
OG0026542	2	0	0	0	0	2
OG0026543	2	0	0	0	0	2
OG0026544	2	0	0	0	0	2
OG0026545	2	0	0	0	0	2
OG0026546	2	0	0	0	0	2
OG0026547	2	0	0	0	0	2
OG0026548	2	0	0	0	0	2
OG0026549	2	0	0	0	0	2
OG0026550	2	0	0	0	0	2
OG0026551	2	0	0	0	0	2
OG0026552	2	0	0	0	0	2
OG0026553	2	0	0	0	0	2
OG0026554	1	1	0	0	0	2
OG0026555	2	0	0	0	0	2
OG0026556	2	0	0	0	0	2
OG0026557	2	0	0	0	0	2
OG0026558	2	0	0	0	0	2
OG0026559	2	0	0	0	0	2
OG0026560	2	0	0	0	0	2
OG0026561	2	0	0	0	0	2
OG0026562	2	0	0	0	0	2
OG0026563	2	0	0	0	0	2
OG0026564	2	0	0	0	0	2
OG0026565	2	0	0	0	0	2
OG0026566	2	0	0	0	0	2
OG0026567	2	0	0	0	0	2
OG0026568	2	0	0	0	0	2
OG0026569	2	0	0	0	0	2
OG0026570	2	0	0	0	0	2
OG0026571	2	0	0	0	0	2
OG0026572	2	0	0	0	0	2
OG0026573	2	0	0	0	0	2
OG0026574	2	0	0	0	0	2
OG0026575	2	0	0	0	0	2
OG0026576	2	0	0	0	0	2
OG0026577	2	0	0	0	0	2
OG0026578	2	0	0	0	0	2
OG0026579	2	0	0	0	0	2
OG0026580	2	0	0	0	0	2
OG0026581	2	0	0	0	0	2
OG0026582	2	0	0	0	0	2
OG0026583	2	0	0	0	0	2
OG0026584	2	0	0	0	0	2
OG0026585	2	0	0	0	0	2
OG0026586	2	0	0	0	0	2
OG0026587	2	0	0	0	0	2
OG0026588	2	0	0	0	0	2
OG0026589	2	0	0	0	0	2
OG0026590	2	0	0	0	0	2
OG0026591	2	0	0	0	0	2
OG0026592	2	0	0	0	0	2
OG0026593	2	0	0	0	0	2
OG0026594	2	0	0	0	0	2
OG0026595	2	0	0	0	0	2
OG0026596	1	0	1	0	0	2
OG0026597	2	0	0	0	0	2
OG0026598	2	0	0	0	0	2
OG0026599	2	0	0	0	0	2
OG0026600	2	0	0	0	0	2
OG0026601	2	0	0	0	0	2
OG0026602	2	0	0	0	0	2
OG0026603	2	0	0	0	0	2
OG0026604	2	0	0	0	0	2
OG0026605	2	0	0	0	0	2
OG0026606	2	0	0	0	0	2
OG0026607	1	0	0	0	1	2
OG0026608	2	0	0	0	0	2
OG0026609	2	0	0	0	0	2
OG0026610	2	0	0	0	0	2
OG0026611	2	0	0	0	0	2
OG0026612	2	0	0	0	0	2
OG0026613	2	0	0	0	0	2
OG0026614	2	0	0	0	0	2
OG0026615	2	0	0	0	0	2
OG0026616	2	0	0	0	0	2
OG0026617	2	0	0	0	0	2
OG0026618	2	0	0	0	0	2
OG0026619	2	0	0	0	0	2
OG0026620	2	0	0	0	0	2
OG0026621	2	0	0	0	0	2
OG0026622	2	0	0	0	0	2
OG0026623	2	0	0	0	0	2
OG0026624	2	0	0	0	0	2
OG0026625	2	0	0	0	0	2
OG0026626	2	0	0	0	0	2
OG0026627	2	0	0	0	0	2
OG0026628	2	0	0	0	0	2
OG0026629	2	0	0	0	0	2
OG0026630	2	0	0	0	0	2
OG0026631	2	0	0	0	0	2
OG0026632	2	0	0	0	0	2
OG0026633	2	0	0	0	0	2
OG0026634	2	0	0	0	0	2
OG0026635	2	0	0	0	0	2
OG0026636	2	0	0	0	0	2
OG0026637	2	0	0	0	0	2
OG0026638	2	0	0	0	0	2
OG0026639	2	0	0	0	0	2
OG0026640	2	0	0	0	0	2
OG0026641	2	0	0	0	0	2
OG0026642	2	0	0	0	0	2
OG0026643	2	0	0	0	0	2
OG0026644	2	0	0	0	0	2
OG0026645	2	0	0	0	0	2
OG0026646	2	0	0	0	0	2
OG0026647	2	0	0	0	0	2
OG0026648	2	0	0	0	0	2
OG0026649	1	0	1	0	0	2
OG0026650	2	0	0	0	0	2
OG0026651	2	0	0	0	0	2
OG0026652	2	0	0	0	0	2
OG0026653	2	0	0	0	0	2
OG0026654	2	0	0	0	0	2
OG0026655	2	0	0	0	0	2
OG0026656	2	0	0	0	0	2
OG0026657	2	0	0	0	0	2
OG0026658	2	0	0	0	0	2
OG0026659	2	0	0	0	0	2
OG0026660	2	0	0	0	0	2
OG0026661	2	0	0	0	0	2
OG0026662	2	0	0	0	0	2
OG0026663	2	0	0	0	0	2
OG0026664	2	0	0	0	0	2
OG0026665	2	0	0	0	0	2
OG0026666	2	0	0	0	0	2
OG0026667	2	0	0	0	0	2
OG0026668	2	0	0	0	0	2
OG0026669	2	0	0	0	0	2
OG0026670	2	0	0	0	0	2
OG0026671	2	0	0	0	0	2
OG0026672	2	0	0	0	0	2
OG0026673	2	0	0	0	0	2
OG0026674	2	0	0	0	0	2
OG0026675	2	0	0	0	0	2
OG0026676	2	0	0	0	0	2
OG0026677	2	0	0	0	0	2
OG0026678	2	0	0	0	0	2
OG0026679	2	0	0	0	0	2
OG0026680	2	0	0	0	0	2
OG0026681	2	0	0	0	0	2
OG0026682	2	0	0	0	0	2
OG0026683	2	0	0	0	0	2
OG0026684	2	0	0	0	0	2
OG0026685	2	0	0	0	0	2
OG0026686	2	0	0	0	0	2
OG0026687	2	0	0	0	0	2
OG0026688	2	0	0	0	0	2
OG0026689	2	0	0	0	0	2
OG0026690	2	0	0	0	0	2
OG0026691	2	0	0	0	0	2
OG0026692	2	0	0	0	0	2
OG0026693	2	0	0	0	0	2
OG0026694	2	0	0	0	0	2
OG0026695	2	0	0	0	0	2
OG0026696	2	0	0	0	0	2
OG0026697	2	0	0	0	0	2
OG0026698	2	0	0	0	0	2
OG0026699	2	0	0	0	0	2
OG0026700	2	0	0	0	0	2
OG0026701	2	0	0	0	0	2
OG0026702	2	0	0	0	0	2
OG0026703	2	0	0	0	0	2
OG0026704	2	0	0	0	0	2
OG0026705	2	0	0	0	0	2
OG0026706	2	0	0	0	0	2
OG0026707	2	0	0	0	0	2
OG0026708	2	0	0	0	0	2
OG0026709	1	0	0	1	0	2
OG0026710	2	0	0	0	0	2
OG0026711	2	0	0	0	0	2
OG0026712	2	0	0	0	0	2
OG0026713	2	0	0	0	0	2
OG0026714	2	0	0	0	0	2
OG0026715	2	0	0	0	0	2
OG0026716	2	0	0	0	0	2
OG0026717	2	0	0	0	0	2
OG0026718	2	0	0	0	0	2
OG0026719	2	0	0	0	0	2
OG0026720	2	0	0	0	0	2
OG0026721	2	0	0	0	0	2
OG0026722	2	0	0	0	0	2
OG0026723	2	0	0	0	0	2
OG0026724	2	0	0	0	0	2
OG0026725	2	0	0	0	0	2
OG0026726	2	0	0	0	0	2
OG0026727	2	0	0	0	0	2
OG0026728	2	0	0	0	0	2
OG0026729	2	0	0	0	0	2
OG0026730	2	0	0	0	0	2
OG0026731	1	0	1	0	0	2
OG0026732	2	0	0	0	0	2
OG0026733	2	0	0	0	0	2
OG0026734	2	0	0	0	0	2
OG0026735	2	0	0	0	0	2
OG0026736	2	0	0	0	0	2
OG0026737	2	0	0	0	0	2
OG0026738	2	0	0	0	0	2
OG0026739	2	0	0	0	0	2
OG0026740	2	0	0	0	0	2
OG0026741	2	0	0	0	0	2
OG0026742	2	0	0	0	0	2
OG0026743	2	0	0	0	0	2
OG0026744	2	0	0	0	0	2
OG0026745	2	0	0	0	0	2
OG0026746	2	0	0	0	0	2
OG0026747	2	0	0	0	0	2
OG0026748	2	0	0	0	0	2
OG0026749	2	0	0	0	0	2
OG0026750	2	0	0	0	0	2
OG0026751	2	0	0	0	0	2
OG0026752	2	0	0	0	0	2
OG0026753	2	0	0	0	0	2
OG0026754	2	0	0	0	0	2
OG0026755	2	0	0	0	0	2
OG0026756	2	0	0	0	0	2
OG0026757	2	0	0	0	0	2
OG0026758	2	0	0	0	0	2
OG0026759	2	0	0	0	0	2
OG0026760	2	0	0	0	0	2
OG0026761	2	0	0	0	0	2
OG0026762	1	0	1	0	0	2
OG0026763	2	0	0	0	0	2
OG0026764	2	0	0	0	0	2
OG0026765	2	0	0	0	0	2
OG0026766	2	0	0	0	0	2
OG0026767	2	0	0	0	0	2
OG0026768	2	0	0	0	0	2
OG0026769	1	0	0	1	0	2
OG0026770	2	0	0	0	0	2
OG0026771	2	0	0	0	0	2
OG0026772	2	0	0	0	0	2
OG0026773	2	0	0	0	0	2
OG0026774	1	0	1	0	0	2
OG0026775	2	0	0	0	0	2
OG0026776	1	1	0	0	0	2
OG0026777	1	1	0	0	0	2
OG0026778	2	0	0	0	0	2
OG0026779	2	0	0	0	0	2
OG0026780	2	0	0	0	0	2
OG0026781	2	0	0	0	0	2
OG0026782	2	0	0	0	0	2
OG0026783	2	0	0	0	0	2
OG0026784	2	0	0	0	0	2
OG0026785	1	0	1	0	0	2
OG0026786	2	0	0	0	0	2
OG0026787	2	0	0	0	0	2
OG0026788	1	1	0	0	0	2
OG0026789	2	0	0	0	0	2
OG0026790	2	0	0	0	0	2
OG0026791	2	0	0	0	0	2
OG0026792	2	0	0	0	0	2
OG0026793	2	0	0	0	0	2
OG0026794	2	0	0	0	0	2
OG0026795	2	0	0	0	0	2
OG0026796	2	0	0	0	0	2
OG0026797	2	0	0	0	0	2
OG0026798	2	0	0	0	0	2
OG0026799	2	0	0	0	0	2
OG0026800	2	0	0	0	0	2
OG0026801	2	0	0	0	0	2
OG0026802	1	0	1	0	0	2
OG0026803	2	0	0	0	0	2
OG0026804	2	0	0	0	0	2
OG0026805	2	0	0	0	0	2
OG0026806	2	0	0	0	0	2
OG0026807	2	0	0	0	0	2
OG0026808	2	0	0	0	0	2
OG0026809	2	0	0	0	0	2
OG0026810	2	0	0	0	0	2
OG0026811	2	0	0	0	0	2
OG0026812	2	0	0	0	0	2
OG0026813	2	0	0	0	0	2
OG0026814	2	0	0	0	0	2
OG0026815	2	0	0	0	0	2
OG0026816	2	0	0	0	0	2
OG0026817	2	0	0	0	0	2
OG0026818	2	0	0	0	0	2
OG0026819	2	0	0	0	0	2
OG0026820	2	0	0	0	0	2
OG0026821	2	0	0	0	0	2
OG0026822	2	0	0	0	0	2
OG0026823	2	0	0	0	0	2
OG0026824	1	0	0	1	0	2
OG0026825	2	0	0	0	0	2
OG0026826	2	0	0	0	0	2
OG0026827	2	0	0	0	0	2
OG0026828	2	0	0	0	0	2
OG0026829	2	0	0	0	0	2
OG0026830	2	0	0	0	0	2
OG0026831	2	0	0	0	0	2
OG0026832	2	0	0	0	0	2
OG0026833	2	0	0	0	0	2
OG0026834	1	0	0	0	1	2
OG0026835	2	0	0	0	0	2
OG0026836	2	0	0	0	0	2
OG0026837	2	0	0	0	0	2
OG0026838	2	0	0	0	0	2
OG0026839	2	0	0	0	0	2
OG0026840	2	0	0	0	0	2
OG0026841	2	0	0	0	0	2
OG0026842	1	0	0	1	0	2
OG0026843	2	0	0	0	0	2
OG0026844	2	0	0	0	0	2
OG0026845	2	0	0	0	0	2
OG0026846	2	0	0	0	0	2
OG0026847	2	0	0	0	0	2
OG0026848	2	0	0	0	0	2
OG0026849	2	0	0	0	0	2
OG0026850	2	0	0	0	0	2
OG0026851	2	0	0	0	0	2
OG0026852	2	0	0	0	0	2
OG0026853	2	0	0	0	0	2
OG0026854	2	0	0	0	0	2
OG0026855	2	0	0	0	0	2
OG0026856	2	0	0	0	0	2
OG0026857	2	0	0	0	0	2
OG0026858	2	0	0	0	0	2
OG0026859	2	0	0	0	0	2
OG0026860	2	0	0	0	0	2
OG0026861	2	0	0	0	0	2
OG0026862	2	0	0	0	0	2
OG0026863	2	0	0	0	0	2
OG0026864	2	0	0	0	0	2
OG0026865	1	0	0	0	1	2
OG0026866	2	0	0	0	0	2
OG0026867	2	0	0	0	0	2
OG0026868	2	0	0	0	0	2
OG0026869	2	0	0	0	0	2
OG0026870	2	0	0	0	0	2
OG0026871	2	0	0	0	0	2
OG0026872	2	0	0	0	0	2
OG0026873	2	0	0	0	0	2
OG0026874	2	0	0	0	0	2
OG0026875	2	0	0	0	0	2
OG0026876	2	0	0	0	0	2
OG0026877	2	0	0	0	0	2
OG0026878	2	0	0	0	0	2
OG0026879	2	0	0	0	0	2
OG0026880	2	0	0	0	0	2
OG0026881	2	0	0	0	0	2
OG0026882	2	0	0	0	0	2
OG0026883	2	0	0	0	0	2
OG0026884	2	0	0	0	0	2
OG0026885	2	0	0	0	0	2
OG0026886	2	0	0	0	0	2
OG0026887	2	0	0	0	0	2
OG0026888	2	0	0	0	0	2
OG0026889	2	0	0	0	0	2
OG0026890	2	0	0	0	0	2
OG0026891	2	0	0	0	0	2
OG0026892	2	0	0	0	0	2
OG0026893	2	0	0	0	0	2
OG0026894	2	0	0	0	0	2
OG0026895	2	0	0	0	0	2
OG0026896	2	0	0	0	0	2
OG0026897	2	0	0	0	0	2
OG0026898	2	0	0	0	0	2
OG0026899	2	0	0	0	0	2
OG0026900	2	0	0	0	0	2
OG0026901	2	0	0	0	0	2
OG0026902	2	0	0	0	0	2
OG0026903	2	0	0	0	0	2
OG0026904	2	0	0	0	0	2
OG0026905	2	0	0	0	0	2
OG0026906	2	0	0	0	0	2
OG0026907	2	0	0	0	0	2
OG0026908	2	0	0	0	0	2
OG0026909	2	0	0	0	0	2
OG0026910	2	0	0	0	0	2
OG0026911	2	0	0	0	0	2
OG0026912	2	0	0	0	0	2
OG0026913	2	0	0	0	0	2
OG0026914	2	0	0	0	0	2
OG0026915	2	0	0	0	0	2
OG0026916	2	0	0	0	0	2
OG0026917	2	0	0	0	0	2
OG0026918	2	0	0	0	0	2
OG0026919	2	0	0	0	0	2
OG0026920	2	0	0	0	0	2
OG0026921	2	0	0	0	0	2
OG0026922	2	0	0	0	0	2
OG0026923	2	0	0	0	0	2
OG0026924	2	0	0	0	0	2
OG0026925	2	0	0	0	0	2
OG0026926	2	0	0	0	0	2
OG0026927	2	0	0	0	0	2
OG0026928	2	0	0	0	0	2
OG0026929	2	0	0	0	0	2
OG0026930	2	0	0	0	0	2
OG0026931	2	0	0	0	0	2
OG0026932	2	0	0	0	0	2
OG0026933	2	0	0	0	0	2
OG0026934	2	0	0	0	0	2
OG0026935	2	0	0	0	0	2
OG0026936	2	0	0	0	0	2
OG0026937	2	0	0	0	0	2
OG0026938	2	0	0	0	0	2
OG0026939	2	0	0	0	0	2
OG0026940	2	0	0	0	0	2
OG0026941	2	0	0	0	0	2
OG0026942	2	0	0	0	0	2
OG0026943	2	0	0	0	0	2
OG0026944	2	0	0	0	0	2
OG0026945	2	0	0	0	0	2
OG0026946	2	0	0	0	0	2
OG0026947	2	0	0	0	0	2
OG0026948	2	0	0	0	0	2
OG0026949	2	0	0	0	0	2
OG0026950	2	0	0	0	0	2
OG0026951	2	0	0	0	0	2
OG0026952	2	0	0	0	0	2
OG0026953	2	0	0	0	0	2
OG0026954	2	0	0	0	0	2
OG0026955	2	0	0	0	0	2
OG0026956	2	0	0	0	0	2
OG0026957	2	0	0	0	0	2
OG0026958	2	0	0	0	0	2
OG0026959	2	0	0	0	0	2
OG0026960	2	0	0	0	0	2
OG0026961	2	0	0	0	0	2
OG0026962	2	0	0	0	0	2
OG0026963	2	0	0	0	0	2
OG0026964	2	0	0	0	0	2
OG0026965	2	0	0	0	0	2
OG0026966	2	0	0	0	0	2
OG0026967	2	0	0	0	0	2
OG0026968	2	0	0	0	0	2
OG0026969	2	0	0	0	0	2
OG0026970	2	0	0	0	0	2
OG0026971	2	0	0	0	0	2
OG0026972	2	0	0	0	0	2
OG0026973	2	0	0	0	0	2
OG0026974	2	0	0	0	0	2
OG0026975	2	0	0	0	0	2
OG0026976	2	0	0	0	0	2
OG0026977	2	0	0	0	0	2
OG0026978	2	0	0	0	0	2
OG0026979	2	0	0	0	0	2
OG0026980	2	0	0	0	0	2
OG0026981	2	0	0	0	0	2
OG0026982	2	0	0	0	0	2
OG0026983	2	0	0	0	0	2
OG0026984	2	0	0	0	0	2
OG0026985	2	0	0	0	0	2
OG0026986	2	0	0	0	0	2
OG0026987	2	0	0	0	0	2
OG0026988	2	0	0	0	0	2
OG0026989	2	0	0	0	0	2
OG0026990	2	0	0	0	0	2
OG0026991	2	0	0	0	0	2
OG0026992	2	0	0	0	0	2
OG0026993	2	0	0	0	0	2
OG0026994	2	0	0	0	0	2
OG0026995	2	0	0	0	0	2
OG0026996	2	0	0	0	0	2
OG0026997	1	0	1	0	0	2
OG0026998	2	0	0	0	0	2
OG0026999	2	0	0	0	0	2
OG0027000	2	0	0	0	0	2
OG0027001	2	0	0	0	0	2
OG0027002	2	0	0	0	0	2
OG0027003	2	0	0	0	0	2
OG0027004	2	0	0	0	0	2
OG0027005	2	0	0	0	0	2
OG0027006	2	0	0	0	0	2
OG0027007	2	0	0	0	0	2
OG0027008	2	0	0	0	0	2
OG0027009	2	0	0	0	0	2
OG0027010	2	0	0	0	0	2
OG0027011	1	0	0	1	0	2
OG0027012	2	0	0	0	0	2
OG0027013	2	0	0	0	0	2
OG0027014	2	0	0	0	0	2
OG0027015	2	0	0	0	0	2
OG0027016	2	0	0	0	0	2
OG0027017	2	0	0	0	0	2
OG0027018	2	0	0	0	0	2
OG0027019	2	0	0	0	0	2
OG0027020	2	0	0	0	0	2
OG0027021	2	0	0	0	0	2
OG0027022	2	0	0	0	0	2
OG0027023	2	0	0	0	0	2
OG0027024	1	0	1	0	0	2
OG0027025	2	0	0	0	0	2
OG0027026	2	0	0	0	0	2
OG0027027	2	0	0	0	0	2
OG0027028	2	0	0	0	0	2
OG0027029	2	0	0	0	0	2
OG0027030	2	0	0	0	0	2
OG0027031	2	0	0	0	0	2
OG0027032	2	0	0	0	0	2
OG0027033	2	0	0	0	0	2
OG0027034	2	0	0	0	0	2
OG0027035	2	0	0	0	0	2
OG0027036	2	0	0	0	0	2
OG0027037	2	0	0	0	0	2
OG0027038	2	0	0	0	0	2
OG0027039	2	0	0	0	0	2
OG0027040	2	0	0	0	0	2
OG0027041	2	0	0	0	0	2
OG0027042	2	0	0	0	0	2
OG0027043	2	0	0	0	0	2
OG0027044	2	0	0	0	0	2
OG0027045	2	0	0	0	0	2
OG0027046	2	0	0	0	0	2
OG0027047	2	0	0	0	0	2
OG0027048	2	0	0	0	0	2
OG0027049	2	0	0	0	0	2
OG0027050	2	0	0	0	0	2
OG0027051	2	0	0	0	0	2
OG0027052	2	0	0	0	0	2
OG0027053	2	0	0	0	0	2
OG0027054	2	0	0	0	0	2
OG0027055	1	1	0	0	0	2
OG0027056	2	0	0	0	0	2
OG0027057	2	0	0	0	0	2
OG0027058	2	0	0	0	0	2
OG0027059	2	0	0	0	0	2
OG0027060	2	0	0	0	0	2
OG0027061	2	0	0	0	0	2
OG0027062	2	0	0	0	0	2
OG0027063	2	0	0	0	0	2
OG0027064	2	0	0	0	0	2
OG0027065	2	0	0	0	0	2
OG0027066	2	0	0	0	0	2
OG0027067	2	0	0	0	0	2
OG0027068	2	0	0	0	0	2
OG0027069	2	0	0	0	0	2
OG0027070	2	0	0	0	0	2
OG0027071	2	0	0	0	0	2
OG0027072	2	0	0	0	0	2
OG0027073	2	0	0	0	0	2
OG0027074	2	0	0	0	0	2
OG0027075	2	0	0	0	0	2
OG0027076	2	0	0	0	0	2
OG0027077	2	0	0	0	0	2
OG0027078	2	0	0	0	0	2
OG0027079	2	0	0	0	0	2
OG0027080	2	0	0	0	0	2
OG0027081	2	0	0	0	0	2
OG0027082	2	0	0	0	0	2
OG0027083	2	0	0	0	0	2
OG0027084	2	0	0	0	0	2
OG0027085	2	0	0	0	0	2
OG0027086	1	1	0	0	0	2
OG0027087	2	0	0	0	0	2
OG0027088	2	0	0	0	0	2
OG0027089	2	0	0	0	0	2
OG0027090	2	0	0	0	0	2
OG0027091	2	0	0	0	0	2
OG0027092	1	1	0	0	0	2
OG0027093	2	0	0	0	0	2
OG0027094	2	0	0	0	0	2
OG0027095	1	0	0	0	1	2
OG0027096	2	0	0	0	0	2
OG0027097	2	0	0	0	0	2
OG0027098	2	0	0	0	0	2
OG0027099	2	0	0	0	0	2
OG0027100	2	0	0	0	0	2
OG0027101	2	0	0	0	0	2
OG0027102	1	0	1	0	0	2
OG0027103	2	0	0	0	0	2
OG0027104	2	0	0	0	0	2
OG0027105	2	0	0	0	0	2
OG0027106	2	0	0	0	0	2
OG0027107	2	0	0	0	0	2
OG0027108	2	0	0	0	0	2
OG0027109	2	0	0	0	0	2
OG0027110	2	0	0	0	0	2
OG0027111	2	0	0	0	0	2
OG0027112	2	0	0	0	0	2
OG0027113	2	0	0	0	0	2
OG0027114	2	0	0	0	0	2
OG0027115	2	0	0	0	0	2
OG0027116	2	0	0	0	0	2
OG0027117	2	0	0	0	0	2
OG0027118	2	0	0	0	0	2
OG0027119	2	0	0	0	0	2
OG0027120	2	0	0	0	0	2
OG0027121	2	0	0	0	0	2
OG0027122	2	0	0	0	0	2
OG0027123	2	0	0	0	0	2
OG0027124	2	0	0	0	0	2
OG0027125	2	0	0	0	0	2
OG0027126	2	0	0	0	0	2
OG0027127	2	0	0	0	0	2
OG0027128	2	0	0	0	0	2
OG0027129	2	0	0	0	0	2
OG0027130	2	0	0	0	0	2
OG0027131	2	0	0	0	0	2
OG0027132	2	0	0	0	0	2
OG0027133	2	0	0	0	0	2
OG0027134	2	0	0	0	0	2
OG0027135	2	0	0	0	0	2
OG0027136	2	0	0	0	0	2
OG0027137	2	0	0	0	0	2
OG0027138	2	0	0	0	0	2
OG0027139	2	0	0	0	0	2
OG0027140	2	0	0	0	0	2
OG0027141	2	0	0	0	0	2
OG0027142	2	0	0	0	0	2
OG0027143	2	0	0	0	0	2
OG0027144	2	0	0	0	0	2
OG0027145	2	0	0	0	0	2
OG0027146	2	0	0	0	0	2
OG0027147	2	0	0	0	0	2
OG0027148	2	0	0	0	0	2
OG0027149	2	0	0	0	0	2
OG0027150	2	0	0	0	0	2
OG0027151	2	0	0	0	0	2
OG0027152	2	0	0	0	0	2
OG0027153	1	0	0	0	1	2
OG0027154	2	0	0	0	0	2
OG0027155	1	0	1	0	0	2
OG0027156	2	0	0	0	0	2
OG0027157	2	0	0	0	0	2
OG0027158	2	0	0	0	0	2
OG0027159	2	0	0	0	0	2
OG0027160	2	0	0	0	0	2
OG0027161	2	0	0	0	0	2
OG0027162	2	0	0	0	0	2
OG0027163	2	0	0	0	0	2
OG0027164	2	0	0	0	0	2
OG0027165	2	0	0	0	0	2
OG0027166	2	0	0	0	0	2
OG0027167	2	0	0	0	0	2
OG0027168	2	0	0	0	0	2
OG0027169	2	0	0	0	0	2
OG0027170	2	0	0	0	0	2
OG0027171	2	0	0	0	0	2
OG0027172	2	0	0	0	0	2
OG0027173	2	0	0	0	0	2
OG0027174	2	0	0	0	0	2
OG0027175	2	0	0	0	0	2
OG0027176	2	0	0	0	0	2
OG0027177	2	0	0	0	0	2
OG0027178	2	0	0	0	0	2
OG0027179	2	0	0	0	0	2
OG0027180	2	0	0	0	0	2
OG0027181	2	0	0	0	0	2
OG0027182	2	0	0	0	0	2
OG0027183	2	0	0	0	0	2
OG0027184	2	0	0	0	0	2
OG0027185	2	0	0	0	0	2
OG0027186	2	0	0	0	0	2
OG0027187	1	0	1	0	0	2
OG0027188	2	0	0	0	0	2
OG0027189	2	0	0	0	0	2
OG0027190	2	0	0	0	0	2
OG0027191	2	0	0	0	0	2
OG0027192	2	0	0	0	0	2
OG0027193	2	0	0	0	0	2
OG0027194	2	0	0	0	0	2
OG0027195	1	0	1	0	0	2
OG0027196	2	0	0	0	0	2
OG0027197	2	0	0	0	0	2
OG0027198	2	0	0	0	0	2
OG0027199	2	0	0	0	0	2
OG0027200	2	0	0	0	0	2
OG0027201	2	0	0	0	0	2
OG0027202	2	0	0	0	0	2
OG0027203	2	0	0	0	0	2
OG0027204	1	0	0	0	1	2
OG0027205	2	0	0	0	0	2
OG0027206	2	0	0	0	0	2
OG0027207	2	0	0	0	0	2
OG0027208	2	0	0	0	0	2
OG0027209	2	0	0	0	0	2
OG0027210	2	0	0	0	0	2
OG0027211	2	0	0	0	0	2
OG0027212	2	0	0	0	0	2
OG0027213	2	0	0	0	0	2
OG0027214	2	0	0	0	0	2
OG0027215	2	0	0	0	0	2
OG0027216	2	0	0	0	0	2
OG0027217	2	0	0	0	0	2
OG0027218	1	0	0	1	0	2
OG0027219	2	0	0	0	0	2
OG0027220	2	0	0	0	0	2
OG0027221	2	0	0	0	0	2
OG0027222	2	0	0	0	0	2
OG0027223	2	0	0	0	0	2
OG0027224	2	0	0	0	0	2
OG0027225	2	0	0	0	0	2
OG0027226	2	0	0	0	0	2
OG0027227	2	0	0	0	0	2
OG0027228	2	0	0	0	0	2
OG0027229	2	0	0	0	0	2
OG0027230	2	0	0	0	0	2
OG0027231	2	0	0	0	0	2
OG0027232	2	0	0	0	0	2
OG0027233	2	0	0	0	0	2
OG0027234	2	0	0	0	0	2
OG0027235	2	0	0	0	0	2
OG0027236	2	0	0	0	0	2
OG0027237	2	0	0	0	0	2
OG0027238	2	0	0	0	0	2
OG0027239	2	0	0	0	0	2
OG0027240	2	0	0	0	0	2
OG0027241	2	0	0	0	0	2
OG0027242	2	0	0	0	0	2
OG0027243	2	0	0	0	0	2
OG0027244	2	0	0	0	0	2
OG0027245	2	0	0	0	0	2
OG0027246	2	0	0	0	0	2
OG0027247	2	0	0	0	0	2
OG0027248	2	0	0	0	0	2
OG0027249	2	0	0	0	0	2
OG0027250	2	0	0	0	0	2
OG0027251	2	0	0	0	0	2
OG0027252	2	0	0	0	0	2
OG0027253	2	0	0	0	0	2
OG0027254	2	0	0	0	0	2
OG0027255	2	0	0	0	0	2
OG0027256	2	0	0	0	0	2
OG0027257	2	0	0	0	0	2
OG0027258	2	0	0	0	0	2
OG0027259	1	0	0	1	0	2
OG0027260	2	0	0	0	0	2
OG0027261	2	0	0	0	0	2
OG0027262	2	0	0	0	0	2
OG0027263	2	0	0	0	0	2
OG0027264	2	0	0	0	0	2
OG0027265	2	0	0	0	0	2
OG0027266	2	0	0	0	0	2
OG0027267	2	0	0	0	0	2
OG0027268	2	0	0	0	0	2
OG0027269	2	0	0	0	0	2
OG0027270	1	0	1	0	0	2
OG0027271	2	0	0	0	0	2
OG0027272	1	0	1	0	0	2
OG0027273	2	0	0	0	0	2
OG0027274	2	0	0	0	0	2
OG0027275	2	0	0	0	0	2
OG0027276	1	0	1	0	0	2
OG0027277	2	0	0	0	0	2
OG0027278	2	0	0	0	0	2
OG0027279	2	0	0	0	0	2
OG0027280	2	0	0	0	0	2
OG0027281	2	0	0	0	0	2
OG0027282	2	0	0	0	0	2
OG0027283	2	0	0	0	0	2
OG0027284	2	0	0	0	0	2
OG0027285	2	0	0	0	0	2
OG0027286	2	0	0	0	0	2
OG0027287	2	0	0	0	0	2
OG0027288	1	0	1	0	0	2
OG0027289	1	1	0	0	0	2
OG0027290	1	0	1	0	0	2
OG0027291	2	0	0	0	0	2
OG0027292	2	0	0	0	0	2
OG0027293	2	0	0	0	0	2
OG0027294	2	0	0	0	0	2
OG0027295	1	0	1	0	0	2
OG0027296	2	0	0	0	0	2
OG0027297	2	0	0	0	0	2
OG0027298	2	0	0	0	0	2
OG0027299	1	1	0	0	0	2
OG0027300	1	1	0	0	0	2
OG0027301	1	0	0	1	0	2
OG0027302	2	0	0	0	0	2
OG0027303	2	0	0	0	0	2
OG0027304	2	0	0	0	0	2
OG0027305	2	0	0	0	0	2
OG0027306	2	0	0	0	0	2
OG0027307	2	0	0	0	0	2
OG0027308	2	0	0	0	0	2
OG0027309	1	1	0	0	0	2
OG0027310	2	0	0	0	0	2
OG0027311	2	0	0	0	0	2
OG0027312	1	0	1	0	0	2
OG0027313	2	0	0	0	0	2
OG0027314	2	0	0	0	0	2
OG0027315	2	0	0	0	0	2
OG0027316	2	0	0	0	0	2
OG0027317	1	0	0	1	0	2
OG0027318	2	0	0	0	0	2
OG0027319	1	0	0	1	0	2
OG0027320	2	0	0	0	0	2
OG0027321	1	1	0	0	0	2
OG0027322	2	0	0	0	0	2
OG0027323	1	0	0	0	1	2
OG0027324	2	0	0	0	0	2
OG0027325	1	0	0	1	0	2
OG0027326	2	0	0	0	0	2
OG0027327	1	0	0	1	0	2
OG0027328	2	0	0	0	0	2
OG0027329	2	0	0	0	0	2
OG0027330	2	0	0	0	0	2
OG0027331	1	0	0	1	0	2
OG0027332	1	0	1	0	0	2
OG0027333	2	0	0	0	0	2
OG0027334	2	0	0	0	0	2
OG0027335	2	0	0	0	0	2
OG0027336	2	0	0	0	0	2
OG0027337	2	0	0	0	0	2
OG0027338	2	0	0	0	0	2
OG0027339	2	0	0	0	0	2
OG0027340	2	0	0	0	0	2
OG0027341	2	0	0	0	0	2
OG0027342	2	0	0	0	0	2
OG0027343	1	0	0	0	1	2
OG0027344	2	0	0	0	0	2
OG0027345	2	0	0	0	0	2
OG0027346	2	0	0	0	0	2
OG0027347	2	0	0	0	0	2
OG0027348	2	0	0	0	0	2
OG0027349	2	0	0	0	0	2
OG0027350	2	0	0	0	0	2
OG0027351	2	0	0	0	0	2
OG0027352	2	0	0	0	0	2
OG0027353	2	0	0	0	0	2
OG0027354	2	0	0	0	0	2
OG0027355	2	0	0	0	0	2
OG0027356	2	0	0	0	0	2
OG0027357	2	0	0	0	0	2
OG0027358	2	0	0	0	0	2
OG0027359	2	0	0	0	0	2
OG0027360	2	0	0	0	0	2
OG0027361	2	0	0	0	0	2
OG0027362	2	0	0	0	0	2
OG0027363	2	0	0	0	0	2
OG0027364	2	0	0	0	0	2
OG0027365	2	0	0	0	0	2
OG0027366	2	0	0	0	0	2
OG0027367	2	0	0	0	0	2
OG0027368	2	0	0	0	0	2
OG0027369	2	0	0	0	0	2
OG0027370	2	0	0	0	0	2
OG0027371	2	0	0	0	0	2
OG0027372	2	0	0	0	0	2
OG0027373	2	0	0	0	0	2
OG0027374	2	0	0	0	0	2
OG0027375	2	0	0	0	0	2
OG0027376	2	0	0	0	0	2
OG0027377	2	0	0	0	0	2
OG0027378	2	0	0	0	0	2
OG0027379	2	0	0	0	0	2
OG0027380	2	0	0	0	0	2
OG0027381	2	0	0	0	0	2
OG0027382	2	0	0	0	0	2
OG0027383	2	0	0	0	0	2
OG0027384	2	0	0	0	0	2
OG0027385	2	0	0	0	0	2
OG0027386	2	0	0	0	0	2
OG0027387	2	0	0	0	0	2
OG0027388	2	0	0	0	0	2
OG0027389	2	0	0	0	0	2
OG0027390	2	0	0	0	0	2
OG0027391	2	0	0	0	0	2
OG0027392	2	0	0	0	0	2
OG0027393	2	0	0	0	0	2
OG0027394	2	0	0	0	0	2
OG0027395	2	0	0	0	0	2
OG0027396	2	0	0	0	0	2
OG0027397	2	0	0	0	0	2
OG0027398	2	0	0	0	0	2
OG0027399	2	0	0	0	0	2
OG0027400	2	0	0	0	0	2
OG0027401	2	0	0	0	0	2
OG0027402	2	0	0	0	0	2
OG0027403	2	0	0	0	0	2
OG0027404	2	0	0	0	0	2
OG0027405	2	0	0	0	0	2
OG0027406	2	0	0	0	0	2
OG0027407	2	0	0	0	0	2
OG0027408	2	0	0	0	0	2
OG0027409	2	0	0	0	0	2
OG0027410	2	0	0	0	0	2
OG0027411	2	0	0	0	0	2
OG0027412	2	0	0	0	0	2
OG0027413	2	0	0	0	0	2
OG0027414	2	0	0	0	0	2
OG0027415	2	0	0	0	0	2
OG0027416	2	0	0	0	0	2
OG0027417	2	0	0	0	0	2
OG0027418	2	0	0	0	0	2
OG0027419	2	0	0	0	0	2
OG0027420	2	0	0	0	0	2
OG0027421	2	0	0	0	0	2
OG0027422	2	0	0	0	0	2
OG0027423	2	0	0	0	0	2
OG0027424	2	0	0	0	0	2
OG0027425	2	0	0	0	0	2
OG0027426	2	0	0	0	0	2
OG0027427	2	0	0	0	0	2
OG0027428	2	0	0	0	0	2
OG0027429	2	0	0	0	0	2
OG0027430	2	0	0	0	0	2
OG0027431	2	0	0	0	0	2
OG0027432	2	0	0	0	0	2
OG0027433	2	0	0	0	0	2
OG0027434	2	0	0	0	0	2
OG0027435	2	0	0	0	0	2
OG0027436	2	0	0	0	0	2
OG0027437	2	0	0	0	0	2
OG0027438	2	0	0	0	0	2
OG0027439	2	0	0	0	0	2
OG0027440	2	0	0	0	0	2
OG0027441	2	0	0	0	0	2
OG0027442	2	0	0	0	0	2
OG0027443	2	0	0	0	0	2
OG0027444	2	0	0	0	0	2
OG0027445	2	0	0	0	0	2
OG0027446	2	0	0	0	0	2
OG0027447	2	0	0	0	0	2
OG0027448	2	0	0	0	0	2
OG0027449	2	0	0	0	0	2
OG0027450	2	0	0	0	0	2
OG0027451	2	0	0	0	0	2
OG0027452	2	0	0	0	0	2
OG0027453	2	0	0	0	0	2
OG0027454	2	0	0	0	0	2
OG0027455	2	0	0	0	0	2
OG0027456	2	0	0	0	0	2
OG0027457	2	0	0	0	0	2
OG0027458	2	0	0	0	0	2
OG0027459	2	0	0	0	0	2
OG0027460	2	0	0	0	0	2
OG0027461	2	0	0	0	0	2
OG0027462	2	0	0	0	0	2
OG0027463	2	0	0	0	0	2
OG0027464	2	0	0	0	0	2
OG0027465	2	0	0	0	0	2
OG0027466	2	0	0	0	0	2
OG0027467	2	0	0	0	0	2
OG0027468	2	0	0	0	0	2
OG0027469	1	1	0	0	0	2
OG0027470	2	0	0	0	0	2
OG0027471	2	0	0	0	0	2
OG0027472	2	0	0	0	0	2
OG0027473	2	0	0	0	0	2
OG0027474	2	0	0	0	0	2
OG0027475	2	0	0	0	0	2
OG0027476	2	0	0	0	0	2
OG0027477	2	0	0	0	0	2
OG0027478	1	0	1	0	0	2
OG0027479	2	0	0	0	0	2
OG0027480	2	0	0	0	0	2
OG0027481	2	0	0	0	0	2
OG0027482	2	0	0	0	0	2
OG0027483	2	0	0	0	0	2
OG0027484	2	0	0	0	0	2
OG0027485	2	0	0	0	0	2
OG0027486	2	0	0	0	0	2
OG0027487	2	0	0	0	0	2
OG0027488	2	0	0	0	0	2
OG0027489	2	0	0	0	0	2
OG0027490	2	0	0	0	0	2
OG0027491	2	0	0	0	0	2
OG0027492	2	0	0	0	0	2
OG0027493	2	0	0	0	0	2
OG0027494	2	0	0	0	0	2
OG0027495	2	0	0	0	0	2
OG0027496	2	0	0	0	0	2
OG0027497	2	0	0	0	0	2
OG0027498	2	0	0	0	0	2
OG0027499	2	0	0	0	0	2
OG0027500	2	0	0	0	0	2
OG0027501	2	0	0	0	0	2
OG0027502	2	0	0	0	0	2
OG0027503	2	0	0	0	0	2
OG0027504	2	0	0	0	0	2
OG0027505	2	0	0	0	0	2
OG0027506	2	0	0	0	0	2
OG0027507	2	0	0	0	0	2
OG0027508	2	0	0	0	0	2
OG0027509	2	0	0	0	0	2
OG0027510	2	0	0	0	0	2
OG0027511	2	0	0	0	0	2
OG0027512	2	0	0	0	0	2
OG0027513	2	0	0	0	0	2
OG0027514	2	0	0	0	0	2
OG0027515	2	0	0	0	0	2
OG0027516	2	0	0	0	0	2
OG0027517	2	0	0	0	0	2
OG0027518	2	0	0	0	0	2
OG0027519	2	0	0	0	0	2
OG0027520	2	0	0	0	0	2
OG0027521	2	0	0	0	0	2
OG0027522	2	0	0	0	0	2
OG0027523	2	0	0	0	0	2
OG0027524	2	0	0	0	0	2
OG0027525	2	0	0	0	0	2
OG0027526	2	0	0	0	0	2
OG0027527	2	0	0	0	0	2
OG0027528	2	0	0	0	0	2
OG0027529	2	0	0	0	0	2
OG0027530	2	0	0	0	0	2
OG0027531	2	0	0	0	0	2
OG0027532	2	0	0	0	0	2
OG0027533	1	0	1	0	0	2
OG0027534	1	0	1	0	0	2
OG0027535	2	0	0	0	0	2
OG0027536	2	0	0	0	0	2
OG0027537	2	0	0	0	0	2
OG0027538	2	0	0	0	0	2
OG0027539	2	0	0	0	0	2
OG0027540	2	0	0	0	0	2
OG0027541	2	0	0	0	0	2
OG0027542	2	0	0	0	0	2
OG0027543	2	0	0	0	0	2
OG0027544	2	0	0	0	0	2
OG0027545	2	0	0	0	0	2
OG0027546	2	0	0	0	0	2
OG0027547	2	0	0	0	0	2
OG0027548	2	0	0	0	0	2
OG0027549	2	0	0	0	0	2
OG0027550	2	0	0	0	0	2
OG0027551	2	0	0	0	0	2
OG0027552	2	0	0	0	0	2
OG0027553	2	0	0	0	0	2
OG0027554	2	0	0	0	0	2
OG0027555	2	0	0	0	0	2
OG0027556	2	0	0	0	0	2
OG0027557	2	0	0	0	0	2
OG0027558	2	0	0	0	0	2
OG0027559	2	0	0	0	0	2
OG0027560	2	0	0	0	0	2
OG0027561	2	0	0	0	0	2
OG0027562	2	0	0	0	0	2
OG0027563	2	0	0	0	0	2
OG0027564	2	0	0	0	0	2
OG0027565	2	0	0	0	0	2
OG0027566	2	0	0	0	0	2
OG0027567	2	0	0	0	0	2
OG0027568	2	0	0	0	0	2
OG0027569	2	0	0	0	0	2
OG0027570	2	0	0	0	0	2
OG0027571	2	0	0	0	0	2
OG0027572	2	0	0	0	0	2
OG0027573	2	0	0	0	0	2
OG0027574	2	0	0	0	0	2
OG0027575	2	0	0	0	0	2
OG0027576	2	0	0	0	0	2
OG0027577	2	0	0	0	0	2
OG0027578	2	0	0	0	0	2
OG0027579	2	0	0	0	0	2
OG0027580	2	0	0	0	0	2
OG0027581	2	0	0	0	0	2
OG0027582	2	0	0	0	0	2
OG0027583	2	0	0	0	0	2
OG0027584	2	0	0	0	0	2
OG0027585	2	0	0	0	0	2
OG0027586	2	0	0	0	0	2
OG0027587	2	0	0	0	0	2
OG0027588	2	0	0	0	0	2
OG0027589	2	0	0	0	0	2
OG0027590	1	1	0	0	0	2
OG0027591	2	0	0	0	0	2
OG0027592	2	0	0	0	0	2
OG0027593	2	0	0	0	0	2
OG0027594	2	0	0	0	0	2
OG0027595	2	0	0	0	0	2
OG0027596	2	0	0	0	0	2
OG0027597	2	0	0	0	0	2
OG0027598	2	0	0	0	0	2
OG0027599	2	0	0	0	0	2
OG0027600	2	0	0	0	0	2
OG0027601	2	0	0	0	0	2
OG0027602	2	0	0	0	0	2
OG0027603	2	0	0	0	0	2
OG0027604	2	0	0	0	0	2
OG0027605	2	0	0	0	0	2
OG0027606	2	0	0	0	0	2
OG0027607	2	0	0	0	0	2
OG0027608	2	0	0	0	0	2
OG0027609	2	0	0	0	0	2
OG0027610	2	0	0	0	0	2
OG0027611	2	0	0	0	0	2
OG0027612	2	0	0	0	0	2
OG0027613	2	0	0	0	0	2
OG0027614	2	0	0	0	0	2
OG0027615	2	0	0	0	0	2
OG0027616	2	0	0	0	0	2
OG0027617	2	0	0	0	0	2
OG0027618	2	0	0	0	0	2
OG0027619	2	0	0	0	0	2
OG0027620	2	0	0	0	0	2
OG0027621	1	0	1	0	0	2
OG0027622	1	1	0	0	0	2
OG0027623	2	0	0	0	0	2
OG0027624	2	0	0	0	0	2
OG0027625	2	0	0	0	0	2
OG0027626	1	0	1	0	0	2
OG0027627	1	0	0	1	0	2
OG0027628	1	0	0	1	0	2
OG0027629	2	0	0	0	0	2
OG0027630	2	0	0	0	0	2
OG0027631	2	0	0	0	0	2
OG0027632	1	1	0	0	0	2
OG0027633	1	0	1	0	0	2
OG0027634	2	0	0	0	0	2
OG0027635	1	0	1	0	0	2
OG0027636	1	0	0	1	0	2
OG0027637	2	0	0	0	0	2
OG0027638	2	0	0	0	0	2
OG0027639	2	0	0	0	0	2
OG0027640	1	0	0	1	0	2
OG0027641	2	0	0	0	0	2
OG0027642	1	1	0	0	0	2
OG0027643	2	0	0	0	0	2
OG0027644	1	0	1	0	0	2
OG0027645	2	0	0	0	0	2
OG0027646	2	0	0	0	0	2
OG0027647	2	0	0	0	0	2
OG0027648	1	1	0	0	0	2
OG0027649	2	0	0	0	0	2
OG0027650	2	0	0	0	0	2
OG0027651	2	0	0	0	0	2
OG0027652	1	1	0	0	0	2
OG0027653	2	0	0	0	0	2
OG0027654	2	0	0	0	0	2
OG0027655	1	1	0	0	0	2
OG0027656	2	0	0	0	0	2
OG0027657	1	0	1	0	0	2
OG0027658	1	0	0	1	0	2
OG0027659	2	0	0	0	0	2
OG0027660	1	0	1	0	0	2
OG0027661	2	0	0	0	0	2
OG0027662	1	1	0	0	0	2
OG0027663	2	0	0	0	0	2
OG0027664	2	0	0	0	0	2
OG0027665	1	0	0	0	1	2
OG0027666	1	0	0	1	0	2
OG0027667	1	0	1	0	0	2
OG0027668	2	0	0	0	0	2
OG0027669	1	1	0	0	0	2
OG0027670	1	0	0	1	0	2
OG0027671	1	0	0	1	0	2
OG0027672	2	0	0	0	0	2
OG0027673	1	1	0	0	0	2
OG0027674	2	0	0	0	0	2
OG0027675	2	0	0	0	0	2
OG0027676	1	1	0	0	0	2
OG0027677	1	0	0	1	0	2
OG0027678	1	0	0	0	1	2
OG0027679	1	0	0	1	0	2
OG0027680	2	0	0	0	0	2
OG0027681	1	0	1	0	0	2
OG0027682	1	0	1	0	0	2
OG0027683	1	0	1	0	0	2
OG0027684	2	0	0	0	0	2
OG0027685	2	0	0	0	0	2
OG0027686	1	0	1	0	0	2
OG0027687	1	1	0	0	0	2
OG0027688	2	0	0	0	0	2
OG0027689	2	0	0	0	0	2
OG0027690	2	0	0	0	0	2
OG0027691	2	0	0	0	0	2
OG0027692	2	0	0	0	0	2
OG0027693	2	0	0	0	0	2
OG0027694	2	0	0	0	0	2
OG0027695	2	0	0	0	0	2
OG0027696	2	0	0	0	0	2
OG0027697	2	0	0	0	0	2
OG0027698	2	0	0	0	0	2
OG0027699	2	0	0	0	0	2
OG0027700	1	0	1	0	0	2
OG0027701	2	0	0	0	0	2
OG0027702	2	0	0	0	0	2
OG0027703	1	0	1	0	0	2
OG0027704	1	1	0	0	0	2
OG0027705	2	0	0	0	0	2
OG0027706	2	0	0	0	0	2
OG0027707	2	0	0	0	0	2
OG0027708	2	0	0	0	0	2
OG0027709	1	1	0	0	0	2
OG0027710	2	0	0	0	0	2
OG0027711	2	0	0	0	0	2
OG0027712	2	0	0	0	0	2
OG0027713	2	0	0	0	0	2
OG0027714	2	0	0	0	0	2
OG0027715	2	0	0	0	0	2
OG0027716	2	0	0	0	0	2
OG0027717	2	0	0	0	0	2
OG0027718	2	0	0	0	0	2
OG0027719	1	1	0	0	0	2
OG0027720	2	0	0	0	0	2
OG0027721	1	1	0	0	0	2
OG0027722	2	0	0	0	0	2
OG0027723	1	0	1	0	0	2
OG0027724	2	0	0	0	0	2
OG0027725	1	0	1	0	0	2
OG0027726	2	0	0	0	0	2
OG0027727	1	0	0	1	0	2
OG0027728	1	0	1	0	0	2
OG0027729	1	0	1	0	0	2
OG0027730	1	1	0	0	0	2
OG0027731	2	0	0	0	0	2
OG0027732	2	0	0	0	0	2
OG0027733	2	0	0	0	0	2
OG0027734	2	0	0	0	0	2
OG0027735	1	0	0	1	0	2
OG0027736	1	1	0	0	0	2
OG0027737	1	1	0	0	0	2
OG0027738	2	0	0	0	0	2
OG0027739	2	0	0	0	0	2
OG0027740	1	0	1	0	0	2
OG0027741	1	0	1	0	0	2
OG0027742	1	1	0	0	0	2
OG0027743	0	2	0	0	0	2
OG0027744	0	2	0	0	0	2
OG0027745	0	2	0	0	0	2
OG0027746	0	2	0	0	0	2
OG0027747	0	2	0	0	0	2
OG0027748	0	2	0	0	0	2
OG0027749	0	2	0	0	0	2
OG0027750	0	2	0	0	0	2
OG0027751	0	2	0	0	0	2
OG0027752	0	2	0	0	0	2
OG0027753	0	2	0	0	0	2
OG0027754	0	2	0	0	0	2
OG0027755	0	2	0	0	0	2
OG0027756	0	2	0	0	0	2
OG0027757	0	2	0	0	0	2
OG0027758	0	2	0	0	0	2
OG0027759	0	2	0	0	0	2
OG0027760	0	2	0	0	0	2
OG0027761	0	2	0	0	0	2
OG0027762	0	2	0	0	0	2
OG0027763	0	2	0	0	0	2
OG0027764	0	2	0	0	0	2
OG0027765	0	2	0	0	0	2
OG0027766	0	2	0	0	0	2
OG0027767	0	2	0	0	0	2
OG0027768	0	2	0	0	0	2
OG0027769	0	2	0	0	0	2
OG0027770	0	2	0	0	0	2
OG0027771	0	2	0	0	0	2
OG0027772	0	2	0	0	0	2
OG0027773	0	2	0	0	0	2
OG0027774	0	2	0	0	0	2
OG0027775	0	2	0	0	0	2
OG0027776	0	2	0	0	0	2
OG0027777	0	2	0	0	0	2
OG0027778	0	2	0	0	0	2
OG0027779	0	2	0	0	0	2
OG0027780	0	2	0	0	0	2
OG0027781	0	2	0	0	0	2
OG0027782	0	2	0	0	0	2
OG0027783	0	2	0	0	0	2
OG0027784	0	2	0	0	0	2
OG0027785	0	2	0	0	0	2
OG0027786	0	2	0	0	0	2
OG0027787	0	2	0	0	0	2
OG0027788	0	2	0	0	0	2
OG0027789	0	2	0	0	0	2
OG0027790	0	2	0	0	0	2
OG0027791	0	2	0	0	0	2
OG0027792	0	2	0	0	0	2
OG0027793	0	2	0	0	0	2
OG0027794	0	2	0	0	0	2
OG0027795	0	2	0	0	0	2
OG0027796	0	2	0	0	0	2
OG0027797	0	2	0	0	0	2
OG0027798	0	2	0	0	0	2
OG0027799	0	2	0	0	0	2
OG0027800	0	2	0	0	0	2
OG0027801	0	2	0	0	0	2
OG0027802	0	2	0	0	0	2
OG0027803	0	2	0	0	0	2
OG0027804	0	2	0	0	0	2
OG0027805	0	2	0	0	0	2
OG0027806	0	2	0	0	0	2
OG0027807	0	2	0	0	0	2
OG0027808	0	2	0	0	0	2
OG0027809	0	2	0	0	0	2
OG0027810	0	2	0	0	0	2
OG0027811	0	2	0	0	0	2
OG0027812	0	2	0	0	0	2
OG0027813	0	2	0	0	0	2
OG0027814	0	2	0	0	0	2
OG0027815	0	2	0	0	0	2
OG0027816	0	2	0	0	0	2
OG0027817	0	2	0	0	0	2
OG0027818	0	2	0	0	0	2
OG0027819	0	2	0	0	0	2
OG0027820	0	2	0	0	0	2
OG0027821	0	2	0	0	0	2
OG0027822	0	2	0	0	0	2
OG0027823	0	2	0	0	0	2
OG0027824	0	2	0	0	0	2
OG0027825	0	2	0	0	0	2
OG0027826	0	2	0	0	0	2
OG0027827	0	2	0	0	0	2
OG0027828	0	2	0	0	0	2
OG0027829	0	2	0	0	0	2
OG0027830	0	2	0	0	0	2
OG0027831	0	2	0	0	0	2
OG0027832	0	2	0	0	0	2
OG0027833	0	2	0	0	0	2
OG0027834	0	2	0	0	0	2
OG0027835	0	2	0	0	0	2
OG0027836	0	2	0	0	0	2
OG0027837	0	2	0	0	0	2
OG0027838	0	2	0	0	0	2
OG0027839	0	2	0	0	0	2
OG0027840	0	2	0	0	0	2
OG0027841	0	2	0	0	0	2
OG0027842	0	2	0	0	0	2
OG0027843	0	2	0	0	0	2
OG0027844	0	2	0	0	0	2
OG0027845	0	2	0	0	0	2
OG0027846	0	2	0	0	0	2
OG0027847	0	2	0	0	0	2
OG0027848	0	2	0	0	0	2
OG0027849	0	2	0	0	0	2
OG0027850	0	2	0	0	0	2
OG0027851	0	2	0	0	0	2
OG0027852	0	2	0	0	0	2
OG0027853	0	2	0	0	0	2
OG0027854	0	2	0	0	0	2
OG0027855	0	2	0	0	0	2
OG0027856	0	2	0	0	0	2
OG0027857	0	2	0	0	0	2
OG0027858	0	2	0	0	0	2
OG0027859	0	2	0	0	0	2
OG0027860	0	2	0	0	0	2
OG0027861	0	2	0	0	0	2
OG0027862	0	2	0	0	0	2
OG0027863	0	2	0	0	0	2
OG0027864	0	2	0	0	0	2
OG0027865	0	2	0	0	0	2
OG0027866	0	2	0	0	0	2
OG0027867	0	2	0	0	0	2
OG0027868	0	2	0	0	0	2
OG0027869	0	2	0	0	0	2
OG0027870	0	2	0	0	0	2
OG0027871	0	2	0	0	0	2
OG0027872	0	2	0	0	0	2
OG0027873	0	2	0	0	0	2
OG0027874	0	2	0	0	0	2
OG0027875	0	2	0	0	0	2
OG0027876	0	2	0	0	0	2
OG0027877	0	2	0	0	0	2
OG0027878	0	2	0	0	0	2
OG0027879	0	2	0	0	0	2
OG0027880	0	2	0	0	0	2
OG0027881	0	2	0	0	0	2
OG0027882	0	2	0	0	0	2
OG0027883	0	2	0	0	0	2
OG0027884	0	2	0	0	0	2
OG0027885	0	2	0	0	0	2
OG0027886	0	2	0	0	0	2
OG0027887	0	2	0	0	0	2
OG0027888	0	2	0	0	0	2
OG0027889	0	2	0	0	0	2
OG0027890	0	2	0	0	0	2
OG0027891	0	2	0	0	0	2
OG0027892	0	2	0	0	0	2
OG0027893	0	2	0	0	0	2
OG0027894	0	1	1	0	0	2
OG0027895	0	2	0	0	0	2
OG0027896	0	2	0	0	0	2
OG0027897	0	2	0	0	0	2
OG0027898	0	2	0	0	0	2
OG0027899	0	2	0	0	0	2
OG0027900	0	2	0	0	0	2
OG0027901	0	2	0	0	0	2
OG0027902	0	2	0	0	0	2
OG0027903	0	2	0	0	0	2
OG0027904	0	2	0	0	0	2
OG0027905	0	2	0	0	0	2
OG0027906	0	2	0	0	0	2
OG0027907	0	2	0	0	0	2
OG0027908	0	2	0	0	0	2
OG0027909	0	2	0	0	0	2
OG0027910	0	1	1	0	0	2
OG0027911	0	2	0	0	0	2
OG0027912	0	2	0	0	0	2
OG0027913	0	2	0	0	0	2
OG0027914	0	2	0	0	0	2
OG0027915	0	2	0	0	0	2
OG0027916	0	2	0	0	0	2
OG0027917	0	2	0	0	0	2
OG0027918	0	2	0	0	0	2
OG0027919	0	2	0	0	0	2
OG0027920	0	2	0	0	0	2
OG0027921	0	2	0	0	0	2
OG0027922	0	2	0	0	0	2
OG0027923	0	2	0	0	0	2
OG0027924	0	1	1	0	0	2
OG0027925	0	2	0	0	0	2
OG0027926	0	2	0	0	0	2
OG0027927	0	2	0	0	0	2
OG0027928	0	2	0	0	0	2
OG0027929	0	2	0	0	0	2
OG0027930	0	2	0	0	0	2
OG0027931	0	2	0	0	0	2
OG0027932	0	2	0	0	0	2
OG0027933	0	2	0	0	0	2
OG0027934	0	2	0	0	0	2
OG0027935	0	2	0	0	0	2
OG0027936	0	2	0	0	0	2
OG0027937	0	2	0	0	0	2
OG0027938	0	2	0	0	0	2
OG0027939	0	2	0	0	0	2
OG0027940	0	2	0	0	0	2
OG0027941	0	2	0	0	0	2
OG0027942	0	2	0	0	0	2
OG0027943	0	2	0	0	0	2
OG0027944	0	2	0	0	0	2
OG0027945	0	2	0	0	0	2
OG0027946	0	2	0	0	0	2
OG0027947	0	2	0	0	0	2
OG0027948	0	2	0	0	0	2
OG0027949	0	2	0	0	0	2
OG0027950	0	2	0	0	0	2
OG0027951	0	2	0	0	0	2
OG0027952	0	2	0	0	0	2
OG0027953	0	2	0	0	0	2
OG0027954	0	2	0	0	0	2
OG0027955	0	2	0	0	0	2
OG0027956	0	2	0	0	0	2
OG0027957	0	2	0	0	0	2
OG0027958	0	2	0	0	0	2
OG0027959	0	2	0	0	0	2
OG0027960	0	2	0	0	0	2
OG0027961	0	2	0	0	0	2
OG0027962	0	2	0	0	0	2
OG0027963	0	2	0	0	0	2
OG0027964	0	2	0	0	0	2
OG0027965	0	2	0	0	0	2
OG0027966	0	2	0	0	0	2
OG0027967	0	1	0	0	1	2
OG0027968	0	2	0	0	0	2
OG0027969	0	2	0	0	0	2
OG0027970	0	2	0	0	0	2
OG0027971	0	2	0	0	0	2
OG0027972	0	2	0	0	0	2
OG0027973	0	2	0	0	0	2
OG0027974	0	2	0	0	0	2
OG0027975	0	2	0	0	0	2
OG0027976	0	2	0	0	0	2
OG0027977	0	2	0	0	0	2
OG0027978	0	2	0	0	0	2
OG0027979	0	2	0	0	0	2
OG0027980	0	2	0	0	0	2
OG0027981	0	2	0	0	0	2
OG0027982	0	2	0	0	0	2
OG0027983	0	2	0	0	0	2
OG0027984	0	2	0	0	0	2
OG0027985	0	2	0	0	0	2
OG0027986	0	2	0	0	0	2
OG0027987	0	2	0	0	0	2
OG0027988	0	2	0	0	0	2
OG0027989	0	2	0	0	0	2
OG0027990	0	2	0	0	0	2
OG0027991	0	2	0	0	0	2
OG0027992	0	2	0	0	0	2
OG0027993	0	2	0	0	0	2
OG0027994	0	2	0	0	0	2
OG0027995	0	2	0	0	0	2
OG0027996	0	2	0	0	0	2
OG0027997	0	2	0	0	0	2
OG0027998	0	2	0	0	0	2
OG0027999	0	2	0	0	0	2
OG0028000	0	2	0	0	0	2
OG0028001	0	2	0	0	0	2
OG0028002	0	2	0	0	0	2
OG0028003	0	2	0	0	0	2
OG0028004	0	2	0	0	0	2
OG0028005	0	2	0	0	0	2
OG0028006	0	2	0	0	0	2
OG0028007	0	2	0	0	0	2
OG0028008	0	2	0	0	0	2
OG0028009	0	2	0	0	0	2
OG0028010	0	2	0	0	0	2
OG0028011	0	2	0	0	0	2
OG0028012	0	2	0	0	0	2
OG0028013	0	2	0	0	0	2
OG0028014	0	2	0	0	0	2
OG0028015	0	2	0	0	0	2
OG0028016	0	2	0	0	0	2
OG0028017	0	2	0	0	0	2
OG0028018	0	2	0	0	0	2
OG0028019	0	2	0	0	0	2
OG0028020	0	2	0	0	0	2
OG0028021	0	2	0	0	0	2
OG0028022	0	2	0	0	0	2
OG0028023	0	2	0	0	0	2
OG0028024	0	2	0	0	0	2
OG0028025	0	2	0	0	0	2
OG0028026	0	2	0	0	0	2
OG0028027	0	2	0	0	0	2
OG0028028	0	2	0	0	0	2
OG0028029	0	2	0	0	0	2
OG0028030	0	2	0	0	0	2
OG0028031	0	2	0	0	0	2
OG0028032	0	2	0	0	0	2
OG0028033	0	2	0	0	0	2
OG0028034	0	2	0	0	0	2
OG0028035	0	2	0	0	0	2
OG0028036	0	2	0	0	0	2
OG0028037	0	2	0	0	0	2
OG0028038	0	2	0	0	0	2
OG0028039	0	2	0	0	0	2
OG0028040	0	2	0	0	0	2
OG0028041	0	2	0	0	0	2
OG0028042	0	2	0	0	0	2
OG0028043	0	2	0	0	0	2
OG0028044	0	2	0	0	0	2
OG0028045	0	2	0	0	0	2
OG0028046	0	2	0	0	0	2
OG0028047	0	2	0	0	0	2
OG0028048	0	2	0	0	0	2
OG0028049	0	2	0	0	0	2
OG0028050	0	2	0	0	0	2
OG0028051	0	2	0	0	0	2
OG0028052	0	2	0	0	0	2
OG0028053	0	2	0	0	0	2
OG0028054	0	2	0	0	0	2
OG0028055	0	2	0	0	0	2
OG0028056	0	2	0	0	0	2
OG0028057	0	2	0	0	0	2
OG0028058	0	2	0	0	0	2
OG0028059	0	2	0	0	0	2
OG0028060	0	2	0	0	0	2
OG0028061	0	2	0	0	0	2
OG0028062	0	2	0	0	0	2
OG0028063	0	1	1	0	0	2
OG0028064	0	2	0	0	0	2
OG0028065	0	2	0	0	0	2
OG0028066	0	2	0	0	0	2
OG0028067	0	2	0	0	0	2
OG0028068	0	2	0	0	0	2
OG0028069	0	2	0	0	0	2
OG0028070	0	2	0	0	0	2
OG0028071	0	2	0	0	0	2
OG0028072	0	2	0	0	0	2
OG0028073	0	2	0	0	0	2
OG0028074	0	1	1	0	0	2
OG0028075	0	2	0	0	0	2
OG0028076	0	2	0	0	0	2
OG0028077	0	2	0	0	0	2
OG0028078	0	2	0	0	0	2
OG0028079	0	2	0	0	0	2
OG0028080	0	2	0	0	0	2
OG0028081	0	2	0	0	0	2
OG0028082	0	2	0	0	0	2
OG0028083	0	2	0	0	0	2
OG0028084	0	2	0	0	0	2
OG0028085	0	2	0	0	0	2
OG0028086	0	2	0	0	0	2
OG0028087	0	2	0	0	0	2
OG0028088	0	2	0	0	0	2
OG0028089	0	2	0	0	0	2
OG0028090	0	2	0	0	0	2
OG0028091	0	2	0	0	0	2
OG0028092	0	2	0	0	0	2
OG0028093	0	2	0	0	0	2
OG0028094	0	2	0	0	0	2
OG0028095	0	2	0	0	0	2
OG0028096	0	2	0	0	0	2
OG0028097	0	2	0	0	0	2
OG0028098	0	2	0	0	0	2
OG0028099	0	2	0	0	0	2
OG0028100	0	2	0	0	0	2
OG0028101	0	2	0	0	0	2
OG0028102	0	2	0	0	0	2
OG0028103	0	2	0	0	0	2
OG0028104	0	2	0	0	0	2
OG0028105	0	2	0	0	0	2
OG0028106	0	2	0	0	0	2
OG0028107	0	2	0	0	0	2
OG0028108	0	2	0	0	0	2
OG0028109	0	2	0	0	0	2
OG0028110	0	2	0	0	0	2
OG0028111	0	2	0	0	0	2
OG0028112	0	2	0	0	0	2
OG0028113	0	2	0	0	0	2
OG0028114	0	2	0	0	0	2
OG0028115	0	1	1	0	0	2
OG0028116	0	2	0	0	0	2
OG0028117	0	2	0	0	0	2
OG0028118	0	2	0	0	0	2
OG0028119	0	2	0	0	0	2
OG0028120	0	2	0	0	0	2
OG0028121	0	2	0	0	0	2
OG0028122	0	2	0	0	0	2
OG0028123	0	2	0	0	0	2
OG0028124	0	2	0	0	0	2
OG0028125	0	2	0	0	0	2
OG0028126	0	2	0	0	0	2
OG0028127	0	2	0	0	0	2
OG0028128	0	2	0	0	0	2
OG0028129	0	2	0	0	0	2
OG0028130	0	2	0	0	0	2
OG0028131	0	2	0	0	0	2
OG0028132	0	2	0	0	0	2
OG0028133	0	2	0	0	0	2
OG0028134	0	2	0	0	0	2
OG0028135	0	2	0	0	0	2
OG0028136	0	2	0	0	0	2
OG0028137	0	2	0	0	0	2
OG0028138	0	2	0	0	0	2
OG0028139	0	2	0	0	0	2
OG0028140	0	2	0	0	0	2
OG0028141	0	2	0	0	0	2
OG0028142	0	2	0	0	0	2
OG0028143	0	2	0	0	0	2
OG0028144	0	2	0	0	0	2
OG0028145	0	2	0	0	0	2
OG0028146	0	2	0	0	0	2
OG0028147	0	2	0	0	0	2
OG0028148	0	1	1	0	0	2
OG0028149	0	2	0	0	0	2
OG0028150	0	2	0	0	0	2
OG0028151	0	2	0	0	0	2
OG0028152	0	2	0	0	0	2
OG0028153	0	2	0	0	0	2
OG0028154	0	2	0	0	0	2
OG0028155	0	2	0	0	0	2
OG0028156	0	2	0	0	0	2
OG0028157	0	2	0	0	0	2
OG0028158	0	2	0	0	0	2
OG0028159	0	2	0	0	0	2
OG0028160	0	2	0	0	0	2
OG0028161	0	2	0	0	0	2
OG0028162	0	2	0	0	0	2
OG0028163	0	2	0	0	0	2
OG0028164	0	2	0	0	0	2
OG0028165	0	2	0	0	0	2
OG0028166	0	2	0	0	0	2
OG0028167	0	2	0	0	0	2
OG0028168	0	2	0	0	0	2
OG0028169	0	2	0	0	0	2
OG0028170	0	2	0	0	0	2
OG0028171	0	2	0	0	0	2
OG0028172	0	2	0	0	0	2
OG0028173	0	2	0	0	0	2
OG0028174	0	2	0	0	0	2
OG0028175	0	2	0	0	0	2
OG0028176	0	2	0	0	0	2
OG0028177	0	2	0	0	0	2
OG0028178	0	2	0	0	0	2
OG0028179	0	2	0	0	0	2
OG0028180	0	2	0	0	0	2
OG0028181	0	2	0	0	0	2
OG0028182	0	2	0	0	0	2
OG0028183	0	2	0	0	0	2
OG0028184	0	2	0	0	0	2
OG0028185	0	2	0	0	0	2
OG0028186	0	2	0	0	0	2
OG0028187	0	2	0	0	0	2
OG0028188	0	2	0	0	0	2
OG0028189	0	2	0	0	0	2
OG0028190	0	2	0	0	0	2
OG0028191	0	2	0	0	0	2
OG0028192	0	2	0	0	0	2
OG0028193	0	2	0	0	0	2
OG0028194	0	2	0	0	0	2
OG0028195	0	2	0	0	0	2
OG0028196	0	2	0	0	0	2
OG0028197	0	2	0	0	0	2
OG0028198	0	2	0	0	0	2
OG0028199	0	2	0	0	0	2
OG0028200	0	2	0	0	0	2
OG0028201	0	2	0	0	0	2
OG0028202	0	2	0	0	0	2
OG0028203	0	2	0	0	0	2
OG0028204	0	2	0	0	0	2
OG0028205	0	2	0	0	0	2
OG0028206	0	2	0	0	0	2
OG0028207	0	2	0	0	0	2
OG0028208	0	2	0	0	0	2
OG0028209	0	2	0	0	0	2
OG0028210	0	2	0	0	0	2
OG0028211	0	2	0	0	0	2
OG0028212	0	2	0	0	0	2
OG0028213	0	2	0	0	0	2
OG0028214	0	2	0	0	0	2
OG0028215	0	2	0	0	0	2
OG0028216	0	2	0	0	0	2
OG0028217	0	2	0	0	0	2
OG0028218	0	2	0	0	0	2
OG0028219	0	2	0	0	0	2
OG0028220	0	2	0	0	0	2
OG0028221	0	2	0	0	0	2
OG0028222	0	2	0	0	0	2
OG0028223	0	2	0	0	0	2
OG0028224	0	2	0	0	0	2
OG0028225	0	2	0	0	0	2
OG0028226	0	2	0	0	0	2
OG0028227	0	2	0	0	0	2
OG0028228	0	2	0	0	0	2
OG0028229	0	2	0	0	0	2
OG0028230	0	2	0	0	0	2
OG0028231	0	2	0	0	0	2
OG0028232	0	2	0	0	0	2
OG0028233	0	2	0	0	0	2
OG0028234	0	2	0	0	0	2
OG0028235	0	2	0	0	0	2
OG0028236	0	2	0	0	0	2
OG0028237	0	2	0	0	0	2
OG0028238	0	2	0	0	0	2
OG0028239	0	2	0	0	0	2
OG0028240	0	2	0	0	0	2
OG0028241	0	2	0	0	0	2
OG0028242	0	2	0	0	0	2
OG0028243	0	2	0	0	0	2
OG0028244	0	2	0	0	0	2
OG0028245	0	2	0	0	0	2
OG0028246	0	2	0	0	0	2
OG0028247	0	2	0	0	0	2
OG0028248	0	2	0	0	0	2
OG0028249	0	2	0	0	0	2
OG0028250	0	2	0	0	0	2
OG0028251	0	1	0	1	0	2
OG0028252	0	2	0	0	0	2
OG0028253	0	2	0	0	0	2
OG0028254	0	2	0	0	0	2
OG0028255	0	2	0	0	0	2
OG0028256	0	2	0	0	0	2
OG0028257	0	2	0	0	0	2
OG0028258	0	2	0	0	0	2
OG0028259	0	2	0	0	0	2
OG0028260	0	2	0	0	0	2
OG0028261	0	2	0	0	0	2
OG0028262	0	2	0	0	0	2
OG0028263	0	2	0	0	0	2
OG0028264	0	2	0	0	0	2
OG0028265	0	2	0	0	0	2
OG0028266	0	2	0	0	0	2
OG0028267	0	2	0	0	0	2
OG0028268	0	2	0	0	0	2
OG0028269	0	2	0	0	0	2
OG0028270	0	2	0	0	0	2
OG0028271	0	2	0	0	0	2
OG0028272	0	2	0	0	0	2
OG0028273	0	2	0	0	0	2
OG0028274	0	2	0	0	0	2
OG0028275	0	2	0	0	0	2
OG0028276	0	2	0	0	0	2
OG0028277	0	2	0	0	0	2
OG0028278	0	2	0	0	0	2
OG0028279	0	2	0	0	0	2
OG0028280	0	2	0	0	0	2
OG0028281	0	2	0	0	0	2
OG0028282	0	2	0	0	0	2
OG0028283	0	2	0	0	0	2
OG0028284	0	2	0	0	0	2
OG0028285	0	2	0	0	0	2
OG0028286	0	2	0	0	0	2
OG0028287	0	2	0	0	0	2
OG0028288	0	2	0	0	0	2
OG0028289	0	2	0	0	0	2
OG0028290	0	2	0	0	0	2
OG0028291	0	2	0	0	0	2
OG0028292	0	2	0	0	0	2
OG0028293	0	2	0	0	0	2
OG0028294	0	2	0	0	0	2
OG0028295	0	2	0	0	0	2
OG0028296	0	2	0	0	0	2
OG0028297	0	2	0	0	0	2
OG0028298	0	2	0	0	0	2
OG0028299	0	2	0	0	0	2
OG0028300	0	2	0	0	0	2
OG0028301	0	2	0	0	0	2
OG0028302	0	2	0	0	0	2
OG0028303	0	2	0	0	0	2
OG0028304	0	2	0	0	0	2
OG0028305	0	2	0	0	0	2
OG0028306	0	2	0	0	0	2
OG0028307	0	1	1	0	0	2
OG0028308	0	2	0	0	0	2
OG0028309	0	2	0	0	0	2
OG0028310	0	2	0	0	0	2
OG0028311	0	2	0	0	0	2
OG0028312	0	2	0	0	0	2
OG0028313	0	2	0	0	0	2
OG0028314	0	2	0	0	0	2
OG0028315	0	2	0	0	0	2
OG0028316	0	2	0	0	0	2
OG0028317	0	2	0	0	0	2
OG0028318	0	2	0	0	0	2
OG0028319	0	2	0	0	0	2
OG0028320	0	2	0	0	0	2
OG0028321	0	2	0	0	0	2
OG0028322	0	2	0	0	0	2
OG0028323	0	2	0	0	0	2
OG0028324	0	2	0	0	0	2
OG0028325	0	2	0	0	0	2
OG0028326	0	2	0	0	0	2
OG0028327	0	2	0	0	0	2
OG0028328	0	2	0	0	0	2
OG0028329	0	2	0	0	0	2
OG0028330	0	2	0	0	0	2
OG0028331	0	2	0	0	0	2
OG0028332	0	2	0	0	0	2
OG0028333	0	2	0	0	0	2
OG0028334	0	2	0	0	0	2
OG0028335	0	2	0	0	0	2
OG0028336	0	2	0	0	0	2
OG0028337	0	2	0	0	0	2
OG0028338	0	2	0	0	0	2
OG0028339	0	2	0	0	0	2
OG0028340	0	1	0	0	1	2
OG0028341	0	2	0	0	0	2
OG0028342	0	2	0	0	0	2
OG0028343	0	2	0	0	0	2
OG0028344	0	2	0	0	0	2
OG0028345	0	2	0	0	0	2
OG0028346	0	2	0	0	0	2
OG0028347	0	2	0	0	0	2
OG0028348	0	2	0	0	0	2
OG0028349	0	2	0	0	0	2
OG0028350	0	2	0	0	0	2
OG0028351	0	2	0	0	0	2
OG0028352	0	2	0	0	0	2
OG0028353	0	2	0	0	0	2
OG0028354	0	2	0	0	0	2
OG0028355	0	2	0	0	0	2
OG0028356	0	2	0	0	0	2
OG0028357	0	2	0	0	0	2
OG0028358	0	2	0	0	0	2
OG0028359	0	2	0	0	0	2
OG0028360	0	2	0	0	0	2
OG0028361	0	2	0	0	0	2
OG0028362	0	2	0	0	0	2
OG0028363	0	2	0	0	0	2
OG0028364	0	2	0	0	0	2
OG0028365	0	2	0	0	0	2
OG0028366	0	2	0	0	0	2
OG0028367	0	2	0	0	0	2
OG0028368	0	2	0	0	0	2
OG0028369	0	2	0	0	0	2
OG0028370	0	2	0	0	0	2
OG0028371	0	2	0	0	0	2
OG0028372	0	2	0	0	0	2
OG0028373	0	2	0	0	0	2
OG0028374	0	2	0	0	0	2
OG0028375	0	2	0	0	0	2
OG0028376	0	2	0	0	0	2
OG0028377	0	2	0	0	0	2
OG0028378	0	2	0	0	0	2
OG0028379	0	2	0	0	0	2
OG0028380	0	2	0	0	0	2
OG0028381	0	2	0	0	0	2
OG0028382	0	2	0	0	0	2
OG0028383	0	2	0	0	0	2
OG0028384	0	2	0	0	0	2
OG0028385	0	2	0	0	0	2
OG0028386	0	2	0	0	0	2
OG0028387	0	2	0	0	0	2
OG0028388	0	2	0	0	0	2
OG0028389	0	2	0	0	0	2
OG0028390	0	2	0	0	0	2
OG0028391	0	2	0	0	0	2
OG0028392	0	2	0	0	0	2
OG0028393	0	2	0	0	0	2
OG0028394	0	2	0	0	0	2
OG0028395	0	2	0	0	0	2
OG0028396	0	1	1	0	0	2
OG0028397	0	2	0	0	0	2
OG0028398	0	2	0	0	0	2
OG0028399	0	2	0	0	0	2
OG0028400	0	2	0	0	0	2
OG0028401	0	2	0	0	0	2
OG0028402	0	2	0	0	0	2
OG0028403	0	2	0	0	0	2
OG0028404	0	2	0	0	0	2
OG0028405	0	2	0	0	0	2
OG0028406	0	2	0	0	0	2
OG0028407	0	2	0	0	0	2
OG0028408	0	2	0	0	0	2
OG0028409	0	2	0	0	0	2
OG0028410	0	2	0	0	0	2
OG0028411	0	2	0	0	0	2
OG0028412	0	2	0	0	0	2
OG0028413	0	2	0	0	0	2
OG0028414	0	2	0	0	0	2
OG0028415	0	2	0	0	0	2
OG0028416	0	2	0	0	0	2
OG0028417	0	2	0	0	0	2
OG0028418	0	2	0	0	0	2
OG0028419	0	2	0	0	0	2
OG0028420	0	2	0	0	0	2
OG0028421	0	2	0	0	0	2
OG0028422	0	2	0	0	0	2
OG0028423	0	2	0	0	0	2
OG0028424	0	1	1	0	0	2
OG0028425	0	2	0	0	0	2
OG0028426	0	2	0	0	0	2
OG0028427	0	2	0	0	0	2
OG0028428	0	2	0	0	0	2
OG0028429	0	2	0	0	0	2
OG0028430	0	2	0	0	0	2
OG0028431	0	2	0	0	0	2
OG0028432	0	2	0	0	0	2
OG0028433	0	2	0	0	0	2
OG0028434	0	2	0	0	0	2
OG0028435	0	2	0	0	0	2
OG0028436	0	2	0	0	0	2
OG0028437	0	2	0	0	0	2
OG0028438	0	2	0	0	0	2
OG0028439	0	2	0	0	0	2
OG0028440	0	2	0	0	0	2
OG0028441	0	2	0	0	0	2
OG0028442	0	2	0	0	0	2
OG0028443	0	2	0	0	0	2
OG0028444	0	2	0	0	0	2
OG0028445	0	2	0	0	0	2
OG0028446	0	2	0	0	0	2
OG0028447	0	2	0	0	0	2
OG0028448	0	2	0	0	0	2
OG0028449	0	2	0	0	0	2
OG0028450	0	2	0	0	0	2
OG0028451	0	2	0	0	0	2
OG0028452	0	2	0	0	0	2
OG0028453	0	2	0	0	0	2
OG0028454	0	2	0	0	0	2
OG0028455	0	2	0	0	0	2
OG0028456	0	2	0	0	0	2
OG0028457	0	2	0	0	0	2
OG0028458	0	2	0	0	0	2
OG0028459	0	2	0	0	0	2
OG0028460	0	2	0	0	0	2
OG0028461	0	2	0	0	0	2
OG0028462	0	2	0	0	0	2
OG0028463	0	2	0	0	0	2
OG0028464	0	2	0	0	0	2
OG0028465	0	2	0	0	0	2
OG0028466	0	2	0	0	0	2
OG0028467	0	2	0	0	0	2
OG0028468	0	2	0	0	0	2
OG0028469	0	2	0	0	0	2
OG0028470	0	2	0	0	0	2
OG0028471	0	2	0	0	0	2
OG0028472	0	2	0	0	0	2
OG0028473	0	2	0	0	0	2
OG0028474	0	2	0	0	0	2
OG0028475	0	2	0	0	0	2
OG0028476	0	2	0	0	0	2
OG0028477	0	2	0	0	0	2
OG0028478	0	2	0	0	0	2
OG0028479	0	2	0	0	0	2
OG0028480	0	2	0	0	0	2
OG0028481	0	2	0	0	0	2
OG0028482	0	2	0	0	0	2
OG0028483	0	2	0	0	0	2
OG0028484	0	2	0	0	0	2
OG0028485	0	2	0	0	0	2
OG0028486	0	2	0	0	0	2
OG0028487	0	2	0	0	0	2
OG0028488	0	2	0	0	0	2
OG0028489	0	2	0	0	0	2
OG0028490	0	2	0	0	0	2
OG0028491	0	2	0	0	0	2
OG0028492	0	2	0	0	0	2
OG0028493	0	2	0	0	0	2
OG0028494	0	2	0	0	0	2
OG0028495	0	2	0	0	0	2
OG0028496	0	2	0	0	0	2
OG0028497	0	2	0	0	0	2
OG0028498	0	1	1	0	0	2
OG0028499	0	2	0	0	0	2
OG0028500	0	2	0	0	0	2
OG0028501	0	2	0	0	0	2
OG0028502	0	2	0	0	0	2
OG0028503	0	2	0	0	0	2
OG0028504	0	2	0	0	0	2
OG0028505	0	2	0	0	0	2
OG0028506	0	2	0	0	0	2
OG0028507	0	2	0	0	0	2
OG0028508	0	2	0	0	0	2
OG0028509	0	2	0	0	0	2
OG0028510	0	2	0	0	0	2
OG0028511	0	2	0	0	0	2
OG0028512	0	2	0	0	0	2
OG0028513	0	2	0	0	0	2
OG0028514	0	2	0	0	0	2
OG0028515	0	2	0	0	0	2
OG0028516	0	2	0	0	0	2
OG0028517	0	2	0	0	0	2
OG0028518	0	2	0	0	0	2
OG0028519	0	2	0	0	0	2
OG0028520	0	2	0	0	0	2
OG0028521	0	2	0	0	0	2
OG0028522	0	2	0	0	0	2
OG0028523	0	2	0	0	0	2
OG0028524	0	2	0	0	0	2
OG0028525	0	2	0	0	0	2
OG0028526	0	1	0	1	0	2
OG0028527	0	2	0	0	0	2
OG0028528	0	2	0	0	0	2
OG0028529	0	2	0	0	0	2
OG0028530	0	2	0	0	0	2
OG0028531	0	2	0	0	0	2
OG0028532	0	2	0	0	0	2
OG0028533	0	2	0	0	0	2
OG0028534	0	2	0	0	0	2
OG0028535	0	1	1	0	0	2
OG0028536	0	2	0	0	0	2
OG0028537	0	2	0	0	0	2
OG0028538	0	2	0	0	0	2
OG0028539	0	2	0	0	0	2
OG0028540	0	2	0	0	0	2
OG0028541	0	2	0	0	0	2
OG0028542	0	2	0	0	0	2
OG0028543	0	2	0	0	0	2
OG0028544	0	2	0	0	0	2
OG0028545	0	2	0	0	0	2
OG0028546	0	2	0	0	0	2
OG0028547	0	2	0	0	0	2
OG0028548	0	2	0	0	0	2
OG0028549	0	2	0	0	0	2
OG0028550	0	2	0	0	0	2
OG0028551	0	2	0	0	0	2
OG0028552	0	2	0	0	0	2
OG0028553	0	2	0	0	0	2
OG0028554	0	2	0	0	0	2
OG0028555	0	2	0	0	0	2
OG0028556	0	2	0	0	0	2
OG0028557	0	2	0	0	0	2
OG0028558	0	2	0	0	0	2
OG0028559	0	2	0	0	0	2
OG0028560	0	2	0	0	0	2
OG0028561	0	2	0	0	0	2
OG0028562	0	2	0	0	0	2
OG0028563	0	2	0	0	0	2
OG0028564	0	2	0	0	0	2
OG0028565	0	2	0	0	0	2
OG0028566	0	2	0	0	0	2
OG0028567	0	2	0	0	0	2
OG0028568	0	1	1	0	0	2
OG0028569	0	2	0	0	0	2
OG0028570	0	2	0	0	0	2
OG0028571	0	2	0	0	0	2
OG0028572	0	2	0	0	0	2
OG0028573	0	2	0	0	0	2
OG0028574	0	2	0	0	0	2
OG0028575	0	2	0	0	0	2
OG0028576	0	2	0	0	0	2
OG0028577	0	2	0	0	0	2
OG0028578	0	2	0	0	0	2
OG0028579	0	2	0	0	0	2
OG0028580	0	2	0	0	0	2
OG0028581	0	2	0	0	0	2
OG0028582	0	2	0	0	0	2
OG0028583	0	2	0	0	0	2
OG0028584	0	2	0	0	0	2
OG0028585	0	2	0	0	0	2
OG0028586	0	2	0	0	0	2
OG0028587	0	2	0	0	0	2
OG0028588	0	2	0	0	0	2
OG0028589	0	2	0	0	0	2
OG0028590	0	2	0	0	0	2
OG0028591	0	2	0	0	0	2
OG0028592	0	2	0	0	0	2
OG0028593	0	2	0	0	0	2
OG0028594	0	2	0	0	0	2
OG0028595	0	2	0	0	0	2
OG0028596	0	2	0	0	0	2
OG0028597	0	2	0	0	0	2
OG0028598	0	2	0	0	0	2
OG0028599	0	2	0	0	0	2
OG0028600	0	2	0	0	0	2
OG0028601	0	2	0	0	0	2
OG0028602	0	2	0	0	0	2
OG0028603	0	2	0	0	0	2
OG0028604	0	2	0	0	0	2
OG0028605	0	2	0	0	0	2
OG0028606	0	2	0	0	0	2
OG0028607	0	2	0	0	0	2
OG0028608	0	2	0	0	0	2
OG0028609	0	2	0	0	0	2
OG0028610	0	2	0	0	0	2
OG0028611	0	2	0	0	0	2
OG0028612	0	2	0	0	0	2
OG0028613	0	2	0	0	0	2
OG0028614	0	2	0	0	0	2
OG0028615	0	2	0	0	0	2
OG0028616	0	2	0	0	0	2
OG0028617	0	2	0	0	0	2
OG0028618	0	2	0	0	0	2
OG0028619	0	2	0	0	0	2
OG0028620	0	2	0	0	0	2
OG0028621	0	2	0	0	0	2
OG0028622	0	2	0	0	0	2
OG0028623	0	2	0	0	0	2
OG0028624	0	2	0	0	0	2
OG0028625	0	2	0	0	0	2
OG0028626	0	2	0	0	0	2
OG0028627	0	2	0	0	0	2
OG0028628	0	2	0	0	0	2
OG0028629	0	2	0	0	0	2
OG0028630	0	2	0	0	0	2
OG0028631	0	2	0	0	0	2
OG0028632	0	2	0	0	0	2
OG0028633	0	2	0	0	0	2
OG0028634	0	2	0	0	0	2
OG0028635	0	2	0	0	0	2
OG0028636	0	2	0	0	0	2
OG0028637	0	2	0	0	0	2
OG0028638	0	2	0	0	0	2
OG0028639	0	2	0	0	0	2
OG0028640	0	2	0	0	0	2
OG0028641	0	2	0	0	0	2
OG0028642	0	2	0	0	0	2
OG0028643	0	2	0	0	0	2
OG0028644	0	2	0	0	0	2
OG0028645	0	2	0	0	0	2
OG0028646	0	2	0	0	0	2
OG0028647	0	2	0	0	0	2
OG0028648	0	2	0	0	0	2
OG0028649	0	2	0	0	0	2
OG0028650	0	2	0	0	0	2
OG0028651	0	2	0	0	0	2
OG0028652	0	2	0	0	0	2
OG0028653	0	2	0	0	0	2
OG0028654	0	2	0	0	0	2
OG0028655	0	2	0	0	0	2
OG0028656	0	2	0	0	0	2
OG0028657	0	2	0	0	0	2
OG0028658	0	2	0	0	0	2
OG0028659	0	2	0	0	0	2
OG0028660	0	1	1	0	0	2
OG0028661	0	1	1	0	0	2
OG0028662	0	2	0	0	0	2
OG0028663	0	2	0	0	0	2
OG0028664	0	2	0	0	0	2
OG0028665	0	2	0	0	0	2
OG0028666	0	2	0	0	0	2
OG0028667	0	2	0	0	0	2
OG0028668	0	2	0	0	0	2
OG0028669	0	2	0	0	0	2
OG0028670	0	2	0	0	0	2
OG0028671	0	2	0	0	0	2
OG0028672	0	2	0	0	0	2
OG0028673	0	2	0	0	0	2
OG0028674	0	2	0	0	0	2
OG0028675	0	2	0	0	0	2
OG0028676	0	2	0	0	0	2
OG0028677	0	2	0	0	0	2
OG0028678	0	2	0	0	0	2
OG0028679	0	2	0	0	0	2
OG0028680	0	2	0	0	0	2
OG0028681	0	2	0	0	0	2
OG0028682	0	2	0	0	0	2
OG0028683	0	2	0	0	0	2
OG0028684	0	2	0	0	0	2
OG0028685	0	2	0	0	0	2
OG0028686	0	2	0	0	0	2
OG0028687	0	2	0	0	0	2
OG0028688	0	2	0	0	0	2
OG0028689	0	2	0	0	0	2
OG0028690	0	2	0	0	0	2
OG0028691	0	2	0	0	0	2
OG0028692	0	2	0	0	0	2
OG0028693	0	2	0	0	0	2
OG0028694	0	2	0	0	0	2
OG0028695	0	2	0	0	0	2
OG0028696	0	2	0	0	0	2
OG0028697	0	2	0	0	0	2
OG0028698	0	2	0	0	0	2
OG0028699	0	2	0	0	0	2
OG0028700	0	2	0	0	0	2
OG0028701	0	2	0	0	0	2
OG0028702	0	2	0	0	0	2
OG0028703	0	2	0	0	0	2
OG0028704	0	2	0	0	0	2
OG0028705	0	2	0	0	0	2
OG0028706	0	2	0	0	0	2
OG0028707	0	2	0	0	0	2
OG0028708	0	2	0	0	0	2
OG0028709	0	2	0	0	0	2
OG0028710	0	2	0	0	0	2
OG0028711	0	2	0	0	0	2
OG0028712	0	2	0	0	0	2
OG0028713	0	2	0	0	0	2
OG0028714	0	2	0	0	0	2
OG0028715	0	2	0	0	0	2
OG0028716	0	2	0	0	0	2
OG0028717	0	2	0	0	0	2
OG0028718	0	2	0	0	0	2
OG0028719	0	2	0	0	0	2
OG0028720	0	2	0	0	0	2
OG0028721	0	2	0	0	0	2
OG0028722	0	2	0	0	0	2
OG0028723	0	1	1	0	0	2
OG0028724	0	2	0	0	0	2
OG0028725	0	1	1	0	0	2
OG0028726	0	2	0	0	0	2
OG0028727	0	2	0	0	0	2
OG0028728	0	1	1	0	0	2
OG0028729	0	2	0	0	0	2
OG0028730	0	2	0	0	0	2
OG0028731	0	2	0	0	0	2
OG0028732	0	2	0	0	0	2
OG0028733	0	2	0	0	0	2
OG0028734	0	2	0	0	0	2
OG0028735	0	2	0	0	0	2
OG0028736	0	2	0	0	0	2
OG0028737	0	2	0	0	0	2
OG0028738	0	2	0	0	0	2
OG0028739	0	2	0	0	0	2
OG0028740	0	2	0	0	0	2
OG0028741	0	2	0	0	0	2
OG0028742	0	2	0	0	0	2
OG0028743	0	2	0	0	0	2
OG0028744	0	2	0	0	0	2
OG0028745	0	2	0	0	0	2
OG0028746	0	2	0	0	0	2
OG0028747	0	2	0	0	0	2
OG0028748	0	2	0	0	0	2
OG0028749	0	2	0	0	0	2
OG0028750	0	2	0	0	0	2
OG0028751	0	2	0	0	0	2
OG0028752	0	2	0	0	0	2
OG0028753	0	2	0	0	0	2
OG0028754	0	2	0	0	0	2
OG0028755	0	2	0	0	0	2
OG0028756	0	2	0	0	0	2
OG0028757	0	2	0	0	0	2
OG0028758	0	2	0	0	0	2
OG0028759	0	2	0	0	0	2
OG0028760	0	2	0	0	0	2
OG0028761	0	2	0	0	0	2
OG0028762	0	2	0	0	0	2
OG0028763	0	2	0	0	0	2
OG0028764	0	2	0	0	0	2
OG0028765	0	2	0	0	0	2
OG0028766	0	2	0	0	0	2
OG0028767	0	2	0	0	0	2
OG0028768	0	2	0	0	0	2
OG0028769	0	2	0	0	0	2
OG0028770	0	2	0	0	0	2
OG0028771	0	2	0	0	0	2
OG0028772	0	2	0	0	0	2
OG0028773	0	2	0	0	0	2
OG0028774	0	2	0	0	0	2
OG0028775	0	2	0	0	0	2
OG0028776	0	2	0	0	0	2
OG0028777	0	2	0	0	0	2
OG0028778	0	2	0	0	0	2
OG0028779	0	2	0	0	0	2
OG0028780	0	2	0	0	0	2
OG0028781	0	2	0	0	0	2
OG0028782	0	2	0	0	0	2
OG0028783	0	2	0	0	0	2
OG0028784	0	2	0	0	0	2
OG0028785	0	2	0	0	0	2
OG0028786	0	2	0	0	0	2
OG0028787	0	2	0	0	0	2
OG0028788	0	2	0	0	0	2
OG0028789	0	2	0	0	0	2
OG0028790	0	2	0	0	0	2
OG0028791	0	2	0	0	0	2
OG0028792	0	2	0	0	0	2
OG0028793	0	2	0	0	0	2
OG0028794	0	2	0	0	0	2
OG0028795	0	2	0	0	0	2
OG0028796	0	2	0	0	0	2
OG0028797	0	2	0	0	0	2
OG0028798	0	2	0	0	0	2
OG0028799	0	2	0	0	0	2
OG0028800	0	2	0	0	0	2
OG0028801	0	2	0	0	0	2
OG0028802	0	2	0	0	0	2
OG0028803	0	2	0	0	0	2
OG0028804	0	2	0	0	0	2
OG0028805	0	2	0	0	0	2
OG0028806	0	2	0	0	0	2
OG0028807	0	2	0	0	0	2
OG0028808	0	2	0	0	0	2
OG0028809	0	2	0	0	0	2
OG0028810	0	2	0	0	0	2
OG0028811	0	2	0	0	0	2
OG0028812	0	1	1	0	0	2
OG0028813	0	2	0	0	0	2
OG0028814	0	2	0	0	0	2
OG0028815	0	1	1	0	0	2
OG0028816	0	2	0	0	0	2
OG0028817	0	2	0	0	0	2
OG0028818	0	2	0	0	0	2
OG0028819	0	2	0	0	0	2
OG0028820	0	2	0	0	0	2
OG0028821	0	2	0	0	0	2
OG0028822	0	2	0	0	0	2
OG0028823	0	2	0	0	0	2
OG0028824	0	2	0	0	0	2
OG0028825	0	2	0	0	0	2
OG0028826	0	2	0	0	0	2
OG0028827	0	2	0	0	0	2
OG0028828	0	2	0	0	0	2
OG0028829	0	2	0	0	0	2
OG0028830	0	2	0	0	0	2
OG0028831	0	2	0	0	0	2
OG0028832	0	2	0	0	0	2
OG0028833	0	2	0	0	0	2
OG0028834	0	2	0	0	0	2
OG0028835	0	2	0	0	0	2
OG0028836	0	2	0	0	0	2
OG0028837	0	2	0	0	0	2
OG0028838	0	2	0	0	0	2
OG0028839	0	2	0	0	0	2
OG0028840	0	2	0	0	0	2
OG0028841	0	2	0	0	0	2
OG0028842	0	2	0	0	0	2
OG0028843	0	2	0	0	0	2
OG0028844	0	2	0	0	0	2
OG0028845	0	2	0	0	0	2
OG0028846	0	2	0	0	0	2
OG0028847	0	2	0	0	0	2
OG0028848	0	2	0	0	0	2
OG0028849	0	2	0	0	0	2
OG0028850	0	2	0	0	0	2
OG0028851	0	2	0	0	0	2
OG0028852	0	2	0	0	0	2
OG0028853	0	2	0	0	0	2
OG0028854	0	2	0	0	0	2
OG0028855	0	2	0	0	0	2
OG0028856	0	2	0	0	0	2
OG0028857	0	2	0	0	0	2
OG0028858	0	2	0	0	0	2
OG0028859	0	2	0	0	0	2
OG0028860	0	2	0	0	0	2
OG0028861	0	2	0	0	0	2
OG0028862	0	2	0	0	0	2
OG0028863	0	2	0	0	0	2
OG0028864	0	2	0	0	0	2
OG0028865	0	2	0	0	0	2
OG0028866	0	2	0	0	0	2
OG0028867	0	2	0	0	0	2
OG0028868	0	2	0	0	0	2
OG0028869	0	2	0	0	0	2
OG0028870	0	2	0	0	0	2
OG0028871	0	2	0	0	0	2
OG0028872	0	2	0	0	0	2
OG0028873	0	2	0	0	0	2
OG0028874	0	2	0	0	0	2
OG0028875	0	2	0	0	0	2
OG0028876	0	2	0	0	0	2
OG0028877	0	2	0	0	0	2
OG0028878	0	2	0	0	0	2
OG0028879	0	2	0	0	0	2
OG0028880	0	2	0	0	0	2
OG0028881	0	2	0	0	0	2
OG0028882	0	2	0	0	0	2
OG0028883	0	2	0	0	0	2
OG0028884	0	2	0	0	0	2
OG0028885	0	2	0	0	0	2
OG0028886	0	2	0	0	0	2
OG0028887	0	1	1	0	0	2
OG0028888	0	2	0	0	0	2
OG0028889	0	2	0	0	0	2
OG0028890	0	2	0	0	0	2
OG0028891	0	2	0	0	0	2
OG0028892	0	2	0	0	0	2
OG0028893	0	2	0	0	0	2
OG0028894	0	2	0	0	0	2
OG0028895	0	2	0	0	0	2
OG0028896	0	2	0	0	0	2
OG0028897	0	2	0	0	0	2
OG0028898	0	2	0	0	0	2
OG0028899	0	2	0	0	0	2
OG0028900	0	2	0	0	0	2
OG0028901	0	2	0	0	0	2
OG0028902	0	2	0	0	0	2
OG0028903	0	2	0	0	0	2
OG0028904	0	2	0	0	0	2
OG0028905	0	2	0	0	0	2
OG0028906	0	2	0	0	0	2
OG0028907	0	2	0	0	0	2
OG0028908	0	2	0	0	0	2
OG0028909	0	2	0	0	0	2
OG0028910	0	2	0	0	0	2
OG0028911	0	2	0	0	0	2
OG0028912	0	2	0	0	0	2
OG0028913	0	2	0	0	0	2
OG0028914	0	2	0	0	0	2
OG0028915	0	2	0	0	0	2
OG0028916	0	2	0	0	0	2
OG0028917	0	2	0	0	0	2
OG0028918	0	2	0	0	0	2
OG0028919	0	2	0	0	0	2
OG0028920	0	2	0	0	0	2
OG0028921	0	1	0	0	1	2
OG0028922	0	2	0	0	0	2
OG0028923	0	2	0	0	0	2
OG0028924	0	2	0	0	0	2
OG0028925	0	2	0	0	0	2
OG0028926	0	2	0	0	0	2
OG0028927	0	2	0	0	0	2
OG0028928	0	2	0	0	0	2
OG0028929	0	2	0	0	0	2
OG0028930	0	2	0	0	0	2
OG0028931	0	2	0	0	0	2
OG0028932	0	2	0	0	0	2
OG0028933	0	2	0	0	0	2
OG0028934	0	2	0	0	0	2
OG0028935	0	2	0	0	0	2
OG0028936	0	2	0	0	0	2
OG0028937	0	2	0	0	0	2
OG0028938	0	2	0	0	0	2
OG0028939	0	2	0	0	0	2
OG0028940	0	2	0	0	0	2
OG0028941	0	2	0	0	0	2
OG0028942	0	2	0	0	0	2
OG0028943	0	2	0	0	0	2
OG0028944	0	2	0	0	0	2
OG0028945	0	2	0	0	0	2
OG0028946	0	2	0	0	0	2
OG0028947	0	2	0	0	0	2
OG0028948	0	2	0	0	0	2
OG0028949	0	2	0	0	0	2
OG0028950	0	2	0	0	0	2
OG0028951	0	2	0	0	0	2
OG0028952	0	2	0	0	0	2
OG0028953	0	2	0	0	0	2
OG0028954	0	2	0	0	0	2
OG0028955	0	2	0	0	0	2
OG0028956	0	2	0	0	0	2
OG0028957	0	2	0	0	0	2
OG0028958	0	2	0	0	0	2
OG0028959	0	2	0	0	0	2
OG0028960	0	2	0	0	0	2
OG0028961	0	2	0	0	0	2
OG0028962	0	2	0	0	0	2
OG0028963	0	2	0	0	0	2
OG0028964	0	2	0	0	0	2
OG0028965	0	2	0	0	0	2
OG0028966	0	2	0	0	0	2
OG0028967	0	2	0	0	0	2
OG0028968	0	2	0	0	0	2
OG0028969	0	2	0	0	0	2
OG0028970	0	2	0	0	0	2
OG0028971	0	2	0	0	0	2
OG0028972	0	2	0	0	0	2
OG0028973	0	2	0	0	0	2
OG0028974	0	2	0	0	0	2
OG0028975	0	2	0	0	0	2
OG0028976	0	2	0	0	0	2
OG0028977	0	2	0	0	0	2
OG0028978	0	2	0	0	0	2
OG0028979	0	2	0	0	0	2
OG0028980	0	2	0	0	0	2
OG0028981	0	2	0	0	0	2
OG0028982	0	2	0	0	0	2
OG0028983	0	2	0	0	0	2
OG0028984	0	2	0	0	0	2
OG0028985	0	2	0	0	0	2
OG0028986	0	2	0	0	0	2
OG0028987	0	2	0	0	0	2
OG0028988	0	1	0	1	0	2
OG0028989	0	2	0	0	0	2
OG0028990	0	2	0	0	0	2
OG0028991	0	2	0	0	0	2
OG0028992	0	2	0	0	0	2
OG0028993	0	2	0	0	0	2
OG0028994	0	2	0	0	0	2
OG0028995	0	2	0	0	0	2
OG0028996	0	2	0	0	0	2
OG0028997	0	2	0	0	0	2
OG0028998	0	2	0	0	0	2
OG0028999	0	2	0	0	0	2
OG0029000	0	2	0	0	0	2
OG0029001	0	2	0	0	0	2
OG0029002	0	2	0	0	0	2
OG0029003	0	2	0	0	0	2
OG0029004	0	2	0	0	0	2
OG0029005	0	2	0	0	0	2
OG0029006	0	2	0	0	0	2
OG0029007	0	2	0	0	0	2
OG0029008	0	2	0	0	0	2
OG0029009	0	2	0	0	0	2
OG0029010	0	2	0	0	0	2
OG0029011	0	2	0	0	0	2
OG0029012	0	2	0	0	0	2
OG0029013	0	2	0	0	0	2
OG0029014	0	2	0	0	0	2
OG0029015	0	2	0	0	0	2
OG0029016	0	2	0	0	0	2
OG0029017	0	2	0	0	0	2
OG0029018	0	2	0	0	0	2
OG0029019	0	2	0	0	0	2
OG0029020	0	2	0	0	0	2
OG0029021	0	2	0	0	0	2
OG0029022	0	2	0	0	0	2
OG0029023	0	2	0	0	0	2
OG0029024	0	2	0	0	0	2
OG0029025	0	2	0	0	0	2
OG0029026	0	2	0	0	0	2
OG0029027	0	2	0	0	0	2
OG0029028	0	2	0	0	0	2
OG0029029	0	2	0	0	0	2
OG0029030	0	2	0	0	0	2
OG0029031	0	2	0	0	0	2
OG0029032	0	2	0	0	0	2
OG0029033	0	2	0	0	0	2
OG0029034	0	2	0	0	0	2
OG0029035	0	2	0	0	0	2
OG0029036	0	2	0	0	0	2
OG0029037	0	2	0	0	0	2
OG0029038	0	2	0	0	0	2
OG0029039	0	2	0	0	0	2
OG0029040	0	2	0	0	0	2
OG0029041	0	2	0	0	0	2
OG0029042	0	2	0	0	0	2
OG0029043	0	2	0	0	0	2
OG0029044	0	2	0	0	0	2
OG0029045	0	2	0	0	0	2
OG0029046	0	2	0	0	0	2
OG0029047	0	2	0	0	0	2
OG0029048	0	2	0	0	0	2
OG0029049	0	2	0	0	0	2
OG0029050	0	2	0	0	0	2
OG0029051	0	2	0	0	0	2
OG0029052	0	2	0	0	0	2
OG0029053	0	2	0	0	0	2
OG0029054	0	2	0	0	0	2
OG0029055	0	2	0	0	0	2
OG0029056	0	2	0	0	0	2
OG0029057	0	2	0	0	0	2
OG0029058	0	2	0	0	0	2
OG0029059	0	2	0	0	0	2
OG0029060	0	1	1	0	0	2
OG0029061	0	2	0	0	0	2
OG0029062	0	2	0	0	0	2
OG0029063	0	2	0	0	0	2
OG0029064	0	2	0	0	0	2
OG0029065	0	2	0	0	0	2
OG0029066	0	1	1	0	0	2
OG0029067	0	2	0	0	0	2
OG0029068	0	2	0	0	0	2
OG0029069	0	2	0	0	0	2
OG0029070	0	2	0	0	0	2
OG0029071	0	2	0	0	0	2
OG0029072	0	2	0	0	0	2
OG0029073	0	2	0	0	0	2
OG0029074	0	2	0	0	0	2
OG0029075	0	2	0	0	0	2
OG0029076	0	2	0	0	0	2
OG0029077	0	2	0	0	0	2
OG0029078	0	2	0	0	0	2
OG0029079	0	2	0	0	0	2
OG0029080	0	2	0	0	0	2
OG0029081	0	2	0	0	0	2
OG0029082	0	2	0	0	0	2
OG0029083	0	2	0	0	0	2
OG0029084	0	2	0	0	0	2
OG0029085	0	2	0	0	0	2
OG0029086	0	2	0	0	0	2
OG0029087	0	2	0	0	0	2
OG0029088	0	2	0	0	0	2
OG0029089	0	2	0	0	0	2
OG0029090	0	2	0	0	0	2
OG0029091	0	2	0	0	0	2
OG0029092	0	2	0	0	0	2
OG0029093	0	2	0	0	0	2
OG0029094	0	2	0	0	0	2
OG0029095	0	2	0	0	0	2
OG0029096	0	2	0	0	0	2
OG0029097	0	2	0	0	0	2
OG0029098	0	2	0	0	0	2
OG0029099	0	1	1	0	0	2
OG0029100	0	2	0	0	0	2
OG0029101	0	2	0	0	0	2
OG0029102	0	2	0	0	0	2
OG0029103	0	2	0	0	0	2
OG0029104	0	2	0	0	0	2
OG0029105	0	2	0	0	0	2
OG0029106	0	2	0	0	0	2
OG0029107	0	2	0	0	0	2
OG0029108	0	2	0	0	0	2
OG0029109	0	2	0	0	0	2
OG0029110	0	2	0	0	0	2
OG0029111	0	2	0	0	0	2
OG0029112	0	2	0	0	0	2
OG0029113	0	2	0	0	0	2
OG0029114	0	2	0	0	0	2
OG0029115	0	2	0	0	0	2
OG0029116	0	2	0	0	0	2
OG0029117	0	2	0	0	0	2
OG0029118	0	2	0	0	0	2
OG0029119	0	2	0	0	0	2
OG0029120	0	2	0	0	0	2
OG0029121	0	2	0	0	0	2
OG0029122	0	2	0	0	0	2
OG0029123	0	2	0	0	0	2
OG0029124	0	2	0	0	0	2
OG0029125	0	2	0	0	0	2
OG0029126	0	2	0	0	0	2
OG0029127	0	2	0	0	0	2
OG0029128	0	2	0	0	0	2
OG0029129	0	2	0	0	0	2
OG0029130	0	1	0	1	0	2
OG0029131	0	2	0	0	0	2
OG0029132	0	2	0	0	0	2
OG0029133	0	2	0	0	0	2
OG0029134	0	2	0	0	0	2
OG0029135	0	2	0	0	0	2
OG0029136	0	2	0	0	0	2
OG0029137	0	2	0	0	0	2
OG0029138	0	2	0	0	0	2
OG0029139	0	2	0	0	0	2
OG0029140	0	2	0	0	0	2
OG0029141	0	2	0	0	0	2
OG0029142	0	2	0	0	0	2
OG0029143	0	2	0	0	0	2
OG0029144	0	2	0	0	0	2
OG0029145	0	2	0	0	0	2
OG0029146	0	2	0	0	0	2
OG0029147	0	2	0	0	0	2
OG0029148	0	2	0	0	0	2
OG0029149	0	2	0	0	0	2
OG0029150	0	2	0	0	0	2
OG0029151	0	2	0	0	0	2
OG0029152	0	1	0	1	0	2
OG0029153	0	2	0	0	0	2
OG0029154	0	2	0	0	0	2
OG0029155	0	2	0	0	0	2
OG0029156	0	2	0	0	0	2
OG0029157	0	2	0	0	0	2
OG0029158	0	2	0	0	0	2
OG0029159	0	2	0	0	0	2
OG0029160	0	2	0	0	0	2
OG0029161	0	2	0	0	0	2
OG0029162	0	2	0	0	0	2
OG0029163	0	2	0	0	0	2
OG0029164	0	2	0	0	0	2
OG0029165	0	2	0	0	0	2
OG0029166	0	2	0	0	0	2
OG0029167	0	2	0	0	0	2
OG0029168	0	2	0	0	0	2
OG0029169	0	2	0	0	0	2
OG0029170	0	2	0	0	0	2
OG0029171	0	2	0	0	0	2
OG0029172	0	2	0	0	0	2
OG0029173	0	2	0	0	0	2
OG0029174	0	2	0	0	0	2
OG0029175	0	2	0	0	0	2
OG0029176	0	2	0	0	0	2
OG0029177	0	2	0	0	0	2
OG0029178	0	2	0	0	0	2
OG0029179	0	2	0	0	0	2
OG0029180	0	2	0	0	0	2
OG0029181	0	2	0	0	0	2
OG0029182	0	2	0	0	0	2
OG0029183	0	2	0	0	0	2
OG0029184	0	2	0	0	0	2
OG0029185	0	2	0	0	0	2
OG0029186	0	2	0	0	0	2
OG0029187	0	2	0	0	0	2
OG0029188	0	2	0	0	0	2
OG0029189	0	2	0	0	0	2
OG0029190	0	1	0	0	1	2
OG0029191	0	2	0	0	0	2
OG0029192	0	2	0	0	0	2
OG0029193	0	2	0	0	0	2
OG0029194	0	2	0	0	0	2
OG0029195	0	2	0	0	0	2
OG0029196	0	2	0	0	0	2
OG0029197	0	2	0	0	0	2
OG0029198	0	2	0	0	0	2
OG0029199	0	2	0	0	0	2
OG0029200	0	2	0	0	0	2
OG0029201	0	2	0	0	0	2
OG0029202	0	2	0	0	0	2
OG0029203	0	2	0	0	0	2
OG0029204	0	2	0	0	0	2
OG0029205	0	2	0	0	0	2
OG0029206	0	2	0	0	0	2
OG0029207	0	2	0	0	0	2
OG0029208	0	2	0	0	0	2
OG0029209	0	2	0	0	0	2
OG0029210	0	2	0	0	0	2
OG0029211	0	2	0	0	0	2
OG0029212	0	2	0	0	0	2
OG0029213	0	2	0	0	0	2
OG0029214	0	2	0	0	0	2
OG0029215	0	2	0	0	0	2
OG0029216	0	2	0	0	0	2
OG0029217	0	2	0	0	0	2
OG0029218	0	2	0	0	0	2
OG0029219	0	2	0	0	0	2
OG0029220	0	2	0	0	0	2
OG0029221	0	2	0	0	0	2
OG0029222	0	2	0	0	0	2
OG0029223	0	2	0	0	0	2
OG0029224	0	2	0	0	0	2
OG0029225	0	2	0	0	0	2
OG0029226	0	2	0	0	0	2
OG0029227	0	2	0	0	0	2
OG0029228	0	2	0	0	0	2
OG0029229	0	2	0	0	0	2
OG0029230	0	2	0	0	0	2
OG0029231	0	2	0	0	0	2
OG0029232	0	2	0	0	0	2
OG0029233	0	2	0	0	0	2
OG0029234	0	1	1	0	0	2
OG0029235	0	2	0	0	0	2
OG0029236	0	2	0	0	0	2
OG0029237	0	2	0	0	0	2
OG0029238	0	2	0	0	0	2
OG0029239	0	2	0	0	0	2
OG0029240	0	2	0	0	0	2
OG0029241	0	2	0	0	0	2
OG0029242	0	2	0	0	0	2
OG0029243	0	2	0	0	0	2
OG0029244	0	2	0	0	0	2
OG0029245	0	2	0	0	0	2
OG0029246	0	2	0	0	0	2
OG0029247	0	2	0	0	0	2
OG0029248	0	2	0	0	0	2
OG0029249	0	2	0	0	0	2
OG0029250	0	2	0	0	0	2
OG0029251	0	2	0	0	0	2
OG0029252	0	2	0	0	0	2
OG0029253	0	2	0	0	0	2
OG0029254	0	2	0	0	0	2
OG0029255	0	2	0	0	0	2
OG0029256	0	2	0	0	0	2
OG0029257	0	2	0	0	0	2
OG0029258	0	2	0	0	0	2
OG0029259	0	2	0	0	0	2
OG0029260	0	2	0	0	0	2
OG0029261	0	2	0	0	0	2
OG0029262	0	2	0	0	0	2
OG0029263	0	2	0	0	0	2
OG0029264	0	2	0	0	0	2
OG0029265	0	2	0	0	0	2
OG0029266	0	2	0	0	0	2
OG0029267	0	2	0	0	0	2
OG0029268	0	2	0	0	0	2
OG0029269	0	2	0	0	0	2
OG0029270	0	2	0	0	0	2
OG0029271	0	2	0	0	0	2
OG0029272	0	2	0	0	0	2
OG0029273	0	2	0	0	0	2
OG0029274	0	2	0	0	0	2
OG0029275	0	2	0	0	0	2
OG0029276	0	2	0	0	0	2
OG0029277	0	2	0	0	0	2
OG0029278	0	2	0	0	0	2
OG0029279	0	2	0	0	0	2
OG0029280	0	2	0	0	0	2
OG0029281	0	2	0	0	0	2
OG0029282	0	2	0	0	0	2
OG0029283	0	2	0	0	0	2
OG0029284	0	2	0	0	0	2
OG0029285	0	2	0	0	0	2
OG0029286	0	2	0	0	0	2
OG0029287	0	2	0	0	0	2
OG0029288	0	2	0	0	0	2
OG0029289	0	2	0	0	0	2
OG0029290	0	2	0	0	0	2
OG0029291	0	2	0	0	0	2
OG0029292	0	2	0	0	0	2
OG0029293	0	2	0	0	0	2
OG0029294	0	2	0	0	0	2
OG0029295	0	2	0	0	0	2
OG0029296	0	2	0	0	0	2
OG0029297	0	2	0	0	0	2
OG0029298	0	2	0	0	0	2
OG0029299	0	2	0	0	0	2
OG0029300	0	1	1	0	0	2
OG0029301	0	2	0	0	0	2
OG0029302	0	2	0	0	0	2
OG0029303	0	2	0	0	0	2
OG0029304	0	2	0	0	0	2
OG0029305	0	2	0	0	0	2
OG0029306	0	2	0	0	0	2
OG0029307	0	2	0	0	0	2
OG0029308	0	2	0	0	0	2
OG0029309	0	2	0	0	0	2
OG0029310	0	2	0	0	0	2
OG0029311	0	2	0	0	0	2
OG0029312	0	2	0	0	0	2
OG0029313	0	2	0	0	0	2
OG0029314	0	2	0	0	0	2
OG0029315	0	2	0	0	0	2
OG0029316	0	2	0	0	0	2
OG0029317	0	2	0	0	0	2
OG0029318	0	2	0	0	0	2
OG0029319	0	2	0	0	0	2
OG0029320	0	2	0	0	0	2
OG0029321	0	2	0	0	0	2
OG0029322	0	2	0	0	0	2
OG0029323	0	2	0	0	0	2
OG0029324	0	2	0	0	0	2
OG0029325	0	2	0	0	0	2
OG0029326	0	2	0	0	0	2
OG0029327	0	2	0	0	0	2
OG0029328	0	2	0	0	0	2
OG0029329	0	2	0	0	0	2
OG0029330	0	2	0	0	0	2
OG0029331	0	2	0	0	0	2
OG0029332	0	2	0	0	0	2
OG0029333	0	2	0	0	0	2
OG0029334	0	2	0	0	0	2
OG0029335	0	2	0	0	0	2
OG0029336	0	2	0	0	0	2
OG0029337	0	2	0	0	0	2
OG0029338	0	2	0	0	0	2
OG0029339	0	2	0	0	0	2
OG0029340	0	2	0	0	0	2
OG0029341	0	2	0	0	0	2
OG0029342	0	2	0	0	0	2
OG0029343	0	2	0	0	0	2
OG0029344	0	2	0	0	0	2
OG0029345	0	2	0	0	0	2
OG0029346	0	2	0	0	0	2
OG0029347	0	2	0	0	0	2
OG0029348	0	2	0	0	0	2
OG0029349	0	2	0	0	0	2
OG0029350	0	2	0	0	0	2
OG0029351	0	2	0	0	0	2
OG0029352	0	2	0	0	0	2
OG0029353	0	2	0	0	0	2
OG0029354	0	2	0	0	0	2
OG0029355	0	2	0	0	0	2
OG0029356	0	2	0	0	0	2
OG0029357	0	2	0	0	0	2
OG0029358	0	2	0	0	0	2
OG0029359	0	2	0	0	0	2
OG0029360	0	2	0	0	0	2
OG0029361	0	2	0	0	0	2
OG0029362	0	2	0	0	0	2
OG0029363	0	2	0	0	0	2
OG0029364	0	2	0	0	0	2
OG0029365	0	2	0	0	0	2
OG0029366	0	2	0	0	0	2
OG0029367	0	2	0	0	0	2
OG0029368	0	2	0	0	0	2
OG0029369	0	2	0	0	0	2
OG0029370	0	2	0	0	0	2
OG0029371	0	2	0	0	0	2
OG0029372	0	2	0	0	0	2
OG0029373	0	2	0	0	0	2
OG0029374	0	2	0	0	0	2
OG0029375	0	2	0	0	0	2
OG0029376	0	2	0	0	0	2
OG0029377	0	2	0	0	0	2
OG0029378	0	2	0	0	0	2
OG0029379	0	2	0	0	0	2
OG0029380	0	2	0	0	0	2
OG0029381	0	2	0	0	0	2
OG0029382	0	2	0	0	0	2
OG0029383	0	2	0	0	0	2
OG0029384	0	2	0	0	0	2
OG0029385	0	2	0	0	0	2
OG0029386	0	2	0	0	0	2
OG0029387	0	2	0	0	0	2
OG0029388	0	2	0	0	0	2
OG0029389	0	2	0	0	0	2
OG0029390	0	2	0	0	0	2
OG0029391	0	2	0	0	0	2
OG0029392	0	1	1	0	0	2
OG0029393	0	2	0	0	0	2
OG0029394	0	2	0	0	0	2
OG0029395	0	2	0	0	0	2
OG0029396	0	2	0	0	0	2
OG0029397	0	2	0	0	0	2
OG0029398	0	2	0	0	0	2
OG0029399	0	2	0	0	0	2
OG0029400	0	2	0	0	0	2
OG0029401	0	2	0	0	0	2
OG0029402	0	2	0	0	0	2
OG0029403	0	2	0	0	0	2
OG0029404	0	2	0	0	0	2
OG0029405	0	2	0	0	0	2
OG0029406	0	2	0	0	0	2
OG0029407	0	2	0	0	0	2
OG0029408	0	2	0	0	0	2
OG0029409	0	2	0	0	0	2
OG0029410	0	2	0	0	0	2
OG0029411	0	2	0	0	0	2
OG0029412	0	2	0	0	0	2
OG0029413	0	2	0	0	0	2
OG0029414	0	2	0	0	0	2
OG0029415	0	2	0	0	0	2
OG0029416	0	2	0	0	0	2
OG0029417	0	2	0	0	0	2
OG0029418	0	2	0	0	0	2
OG0029419	0	2	0	0	0	2
OG0029420	0	2	0	0	0	2
OG0029421	0	1	0	0	1	2
OG0029422	0	2	0	0	0	2
OG0029423	0	2	0	0	0	2
OG0029424	0	2	0	0	0	2
OG0029425	0	2	0	0	0	2
OG0029426	0	2	0	0	0	2
OG0029427	0	2	0	0	0	2
OG0029428	0	2	0	0	0	2
OG0029429	0	2	0	0	0	2
OG0029430	0	2	0	0	0	2
OG0029431	0	2	0	0	0	2
OG0029432	0	2	0	0	0	2
OG0029433	0	2	0	0	0	2
OG0029434	0	2	0	0	0	2
OG0029435	0	2	0	0	0	2
OG0029436	0	2	0	0	0	2
OG0029437	0	2	0	0	0	2
OG0029438	0	2	0	0	0	2
OG0029439	0	2	0	0	0	2
OG0029440	0	2	0	0	0	2
OG0029441	0	2	0	0	0	2
OG0029442	0	2	0	0	0	2
OG0029443	0	2	0	0	0	2
OG0029444	0	2	0	0	0	2
OG0029445	0	2	0	0	0	2
OG0029446	0	2	0	0	0	2
OG0029447	0	2	0	0	0	2
OG0029448	0	2	0	0	0	2
OG0029449	0	2	0	0	0	2
OG0029450	0	2	0	0	0	2
OG0029451	0	2	0	0	0	2
OG0029452	0	2	0	0	0	2
OG0029453	0	2	0	0	0	2
OG0029454	0	2	0	0	0	2
OG0029455	0	2	0	0	0	2
OG0029456	0	2	0	0	0	2
OG0029457	0	2	0	0	0	2
OG0029458	0	2	0	0	0	2
OG0029459	0	2	0	0	0	2
OG0029460	0	2	0	0	0	2
OG0029461	0	2	0	0	0	2
OG0029462	0	2	0	0	0	2
OG0029463	0	2	0	0	0	2
OG0029464	0	2	0	0	0	2
OG0029465	0	2	0	0	0	2
OG0029466	0	2	0	0	0	2
OG0029467	0	2	0	0	0	2
OG0029468	0	2	0	0	0	2
OG0029469	0	2	0	0	0	2
OG0029470	0	2	0	0	0	2
OG0029471	0	2	0	0	0	2
OG0029472	0	2	0	0	0	2
OG0029473	0	2	0	0	0	2
OG0029474	0	2	0	0	0	2
OG0029475	0	2	0	0	0	2
OG0029476	0	2	0	0	0	2
OG0029477	0	2	0	0	0	2
OG0029478	0	2	0	0	0	2
OG0029479	0	2	0	0	0	2
OG0029480	0	2	0	0	0	2
OG0029481	0	2	0	0	0	2
OG0029482	0	2	0	0	0	2
OG0029483	0	2	0	0	0	2
OG0029484	0	2	0	0	0	2
OG0029485	0	2	0	0	0	2
OG0029486	0	2	0	0	0	2
OG0029487	0	2	0	0	0	2
OG0029488	0	2	0	0	0	2
OG0029489	0	2	0	0	0	2
OG0029490	0	2	0	0	0	2
OG0029491	0	2	0	0	0	2
OG0029492	0	2	0	0	0	2
OG0029493	0	2	0	0	0	2
OG0029494	0	1	1	0	0	2
OG0029495	0	2	0	0	0	2
OG0029496	0	1	1	0	0	2
OG0029497	0	2	0	0	0	2
OG0029498	0	2	0	0	0	2
OG0029499	0	2	0	0	0	2
OG0029500	0	2	0	0	0	2
OG0029501	0	2	0	0	0	2
OG0029502	0	2	0	0	0	2
OG0029503	0	2	0	0	0	2
OG0029504	0	2	0	0	0	2
OG0029505	0	2	0	0	0	2
OG0029506	0	1	1	0	0	2
OG0029507	0	2	0	0	0	2
OG0029508	0	2	0	0	0	2
OG0029509	0	2	0	0	0	2
OG0029510	0	2	0	0	0	2
OG0029511	0	2	0	0	0	2
OG0029512	0	2	0	0	0	2
OG0029513	0	2	0	0	0	2
OG0029514	0	2	0	0	0	2
OG0029515	0	2	0	0	0	2
OG0029516	0	2	0	0	0	2
OG0029517	0	2	0	0	0	2
OG0029518	0	2	0	0	0	2
OG0029519	0	2	0	0	0	2
OG0029520	0	2	0	0	0	2
OG0029521	0	2	0	0	0	2
OG0029522	0	2	0	0	0	2
OG0029523	0	2	0	0	0	2
OG0029524	0	2	0	0	0	2
OG0029525	0	2	0	0	0	2
OG0029526	0	2	0	0	0	2
OG0029527	0	2	0	0	0	2
OG0029528	0	2	0	0	0	2
OG0029529	0	2	0	0	0	2
OG0029530	0	2	0	0	0	2
OG0029531	0	2	0	0	0	2
OG0029532	0	2	0	0	0	2
OG0029533	0	2	0	0	0	2
OG0029534	0	2	0	0	0	2
OG0029535	0	2	0	0	0	2
OG0029536	0	2	0	0	0	2
OG0029537	0	2	0	0	0	2
OG0029538	0	2	0	0	0	2
OG0029539	0	2	0	0	0	2
OG0029540	0	2	0	0	0	2
OG0029541	0	2	0	0	0	2
OG0029542	0	2	0	0	0	2
OG0029543	0	2	0	0	0	2
OG0029544	0	2	0	0	0	2
OG0029545	0	2	0	0	0	2
OG0029546	0	2	0	0	0	2
OG0029547	0	2	0	0	0	2
OG0029548	0	2	0	0	0	2
OG0029549	0	2	0	0	0	2
OG0029550	0	2	0	0	0	2
OG0029551	0	2	0	0	0	2
OG0029552	0	2	0	0	0	2
OG0029553	0	2	0	0	0	2
OG0029554	0	2	0	0	0	2
OG0029555	0	2	0	0	0	2
OG0029556	0	2	0	0	0	2
OG0029557	0	2	0	0	0	2
OG0029558	0	2	0	0	0	2
OG0029559	0	2	0	0	0	2
OG0029560	0	2	0	0	0	2
OG0029561	0	2	0	0	0	2
OG0029562	0	2	0	0	0	2
OG0029563	0	2	0	0	0	2
OG0029564	0	2	0	0	0	2
OG0029565	0	2	0	0	0	2
OG0029566	0	2	0	0	0	2
OG0029567	0	2	0	0	0	2
OG0029568	0	2	0	0	0	2
OG0029569	0	2	0	0	0	2
OG0029570	0	2	0	0	0	2
OG0029571	0	2	0	0	0	2
OG0029572	0	2	0	0	0	2
OG0029573	0	2	0	0	0	2
OG0029574	0	2	0	0	0	2
OG0029575	0	2	0	0	0	2
OG0029576	0	2	0	0	0	2
OG0029577	0	2	0	0	0	2
OG0029578	0	2	0	0	0	2
OG0029579	0	2	0	0	0	2
OG0029580	0	2	0	0	0	2
OG0029581	0	2	0	0	0	2
OG0029582	0	2	0	0	0	2
OG0029583	0	2	0	0	0	2
OG0029584	0	2	0	0	0	2
OG0029585	0	2	0	0	0	2
OG0029586	0	2	0	0	0	2
OG0029587	0	2	0	0	0	2
OG0029588	0	2	0	0	0	2
OG0029589	0	2	0	0	0	2
OG0029590	0	2	0	0	0	2
OG0029591	0	2	0	0	0	2
OG0029592	0	2	0	0	0	2
OG0029593	0	2	0	0	0	2
OG0029594	0	2	0	0	0	2
OG0029595	0	2	0	0	0	2
OG0029596	0	2	0	0	0	2
OG0029597	0	2	0	0	0	2
OG0029598	0	2	0	0	0	2
OG0029599	0	2	0	0	0	2
OG0029600	0	2	0	0	0	2
OG0029601	0	2	0	0	0	2
OG0029602	0	2	0	0	0	2
OG0029603	0	2	0	0	0	2
OG0029604	0	2	0	0	0	2
OG0029605	0	2	0	0	0	2
OG0029606	0	2	0	0	0	2
OG0029607	0	2	0	0	0	2
OG0029608	0	2	0	0	0	2
OG0029609	0	1	1	0	0	2
OG0029610	0	2	0	0	0	2
OG0029611	0	2	0	0	0	2
OG0029612	0	2	0	0	0	2
OG0029613	0	2	0	0	0	2
OG0029614	0	2	0	0	0	2
OG0029615	0	2	0	0	0	2
OG0029616	0	2	0	0	0	2
OG0029617	0	2	0	0	0	2
OG0029618	0	2	0	0	0	2
OG0029619	0	2	0	0	0	2
OG0029620	0	2	0	0	0	2
OG0029621	0	2	0	0	0	2
OG0029622	0	2	0	0	0	2
OG0029623	0	2	0	0	0	2
OG0029624	0	2	0	0	0	2
OG0029625	0	2	0	0	0	2
OG0029626	0	2	0	0	0	2
OG0029627	0	2	0	0	0	2
OG0029628	0	2	0	0	0	2
OG0029629	0	2	0	0	0	2
OG0029630	0	2	0	0	0	2
OG0029631	0	2	0	0	0	2
OG0029632	0	2	0	0	0	2
OG0029633	0	2	0	0	0	2
OG0029634	0	2	0	0	0	2
OG0029635	0	2	0	0	0	2
OG0029636	0	2	0	0	0	2
OG0029637	0	2	0	0	0	2
OG0029638	0	2	0	0	0	2
OG0029639	0	2	0	0	0	2
OG0029640	0	2	0	0	0	2
OG0029641	0	2	0	0	0	2
OG0029642	0	2	0	0	0	2
OG0029643	0	2	0	0	0	2
OG0029644	0	2	0	0	0	2
OG0029645	0	2	0	0	0	2
OG0029646	0	2	0	0	0	2
OG0029647	0	2	0	0	0	2
OG0029648	0	2	0	0	0	2
OG0029649	0	2	0	0	0	2
OG0029650	0	2	0	0	0	2
OG0029651	0	2	0	0	0	2
OG0029652	0	2	0	0	0	2
OG0029653	0	2	0	0	0	2
OG0029654	0	2	0	0	0	2
OG0029655	0	2	0	0	0	2
OG0029656	0	2	0	0	0	2
OG0029657	0	2	0	0	0	2
OG0029658	0	2	0	0	0	2
OG0029659	0	2	0	0	0	2
OG0029660	0	2	0	0	0	2
OG0029661	0	2	0	0	0	2
OG0029662	0	2	0	0	0	2
OG0029663	0	2	0	0	0	2
OG0029664	0	2	0	0	0	2
OG0029665	0	2	0	0	0	2
OG0029666	0	2	0	0	0	2
OG0029667	0	2	0	0	0	2
OG0029668	0	2	0	0	0	2
OG0029669	0	2	0	0	0	2
OG0029670	0	2	0	0	0	2
OG0029671	0	2	0	0	0	2
OG0029672	0	2	0	0	0	2
OG0029673	0	2	0	0	0	2
OG0029674	0	2	0	0	0	2
OG0029675	0	2	0	0	0	2
OG0029676	0	2	0	0	0	2
OG0029677	0	2	0	0	0	2
OG0029678	0	2	0	0	0	2
OG0029679	0	2	0	0	0	2
OG0029680	0	2	0	0	0	2
OG0029681	0	2	0	0	0	2
OG0029682	0	2	0	0	0	2
OG0029683	0	2	0	0	0	2
OG0029684	0	2	0	0	0	2
OG0029685	0	2	0	0	0	2
OG0029686	0	2	0	0	0	2
OG0029687	0	2	0	0	0	2
OG0029688	0	2	0	0	0	2
OG0029689	0	2	0	0	0	2
OG0029690	0	2	0	0	0	2
OG0029691	0	2	0	0	0	2
OG0029692	0	2	0	0	0	2
OG0029693	0	2	0	0	0	2
OG0029694	0	2	0	0	0	2
OG0029695	0	2	0	0	0	2
OG0029696	0	2	0	0	0	2
OG0029697	0	2	0	0	0	2
OG0029698	0	2	0	0	0	2
OG0029699	0	2	0	0	0	2
OG0029700	0	2	0	0	0	2
OG0029701	0	2	0	0	0	2
OG0029702	0	2	0	0	0	2
OG0029703	0	2	0	0	0	2
OG0029704	0	2	0	0	0	2
OG0029705	0	2	0	0	0	2
OG0029706	0	2	0	0	0	2
OG0029707	0	2	0	0	0	2
OG0029708	0	2	0	0	0	2
OG0029709	0	2	0	0	0	2
OG0029710	0	2	0	0	0	2
OG0029711	0	2	0	0	0	2
OG0029712	0	2	0	0	0	2
OG0029713	0	2	0	0	0	2
OG0029714	0	2	0	0	0	2
OG0029715	0	2	0	0	0	2
OG0029716	0	2	0	0	0	2
OG0029717	0	2	0	0	0	2
OG0029718	0	2	0	0	0	2
OG0029719	0	2	0	0	0	2
OG0029720	0	2	0	0	0	2
OG0029721	0	2	0	0	0	2
OG0029722	0	2	0	0	0	2
OG0029723	0	2	0	0	0	2
OG0029724	0	2	0	0	0	2
OG0029725	0	2	0	0	0	2
OG0029726	0	2	0	0	0	2
OG0029727	0	2	0	0	0	2
OG0029728	0	2	0	0	0	2
OG0029729	0	2	0	0	0	2
OG0029730	0	2	0	0	0	2
OG0029731	0	2	0	0	0	2
OG0029732	0	2	0	0	0	2
OG0029733	0	2	0	0	0	2
OG0029734	0	2	0	0	0	2
OG0029735	0	2	0	0	0	2
OG0029736	0	2	0	0	0	2
OG0029737	0	2	0	0	0	2
OG0029738	0	2	0	0	0	2
OG0029739	0	2	0	0	0	2
OG0029740	0	2	0	0	0	2
OG0029741	0	2	0	0	0	2
OG0029742	0	1	0	0	1	2
OG0029743	0	2	0	0	0	2
OG0029744	0	2	0	0	0	2
OG0029745	0	2	0	0	0	2
OG0029746	0	2	0	0	0	2
OG0029747	0	2	0	0	0	2
OG0029748	0	2	0	0	0	2
OG0029749	0	2	0	0	0	2
OG0029750	0	2	0	0	0	2
OG0029751	0	2	0	0	0	2
OG0029752	0	2	0	0	0	2
OG0029753	0	2	0	0	0	2
OG0029754	0	2	0	0	0	2
OG0029755	0	2	0	0	0	2
OG0029756	0	2	0	0	0	2
OG0029757	0	2	0	0	0	2
OG0029758	0	2	0	0	0	2
OG0029759	0	2	0	0	0	2
OG0029760	0	2	0	0	0	2
OG0029761	0	2	0	0	0	2
OG0029762	0	2	0	0	0	2
OG0029763	0	2	0	0	0	2
OG0029764	0	2	0	0	0	2
OG0029765	0	2	0	0	0	2
OG0029766	0	2	0	0	0	2
OG0029767	0	2	0	0	0	2
OG0029768	0	2	0	0	0	2
OG0029769	0	2	0	0	0	2
OG0029770	0	2	0	0	0	2
OG0029771	0	2	0	0	0	2
OG0029772	0	2	0	0	0	2
OG0029773	0	2	0	0	0	2
OG0029774	0	2	0	0	0	2
OG0029775	0	2	0	0	0	2
OG0029776	0	2	0	0	0	2
OG0029777	0	2	0	0	0	2
OG0029778	0	2	0	0	0	2
OG0029779	0	2	0	0	0	2
OG0029780	0	2	0	0	0	2
OG0029781	0	2	0	0	0	2
OG0029782	0	2	0	0	0	2
OG0029783	0	2	0	0	0	2
OG0029784	0	2	0	0	0	2
OG0029785	0	2	0	0	0	2
OG0029786	0	2	0	0	0	2
OG0029787	0	2	0	0	0	2
OG0029788	0	2	0	0	0	2
OG0029789	0	2	0	0	0	2
OG0029790	0	2	0	0	0	2
OG0029791	0	2	0	0	0	2
OG0029792	0	2	0	0	0	2
OG0029793	0	2	0	0	0	2
OG0029794	0	1	1	0	0	2
OG0029795	0	2	0	0	0	2
OG0029796	0	2	0	0	0	2
OG0029797	0	2	0	0	0	2
OG0029798	0	2	0	0	0	2
OG0029799	0	2	0	0	0	2
OG0029800	0	2	0	0	0	2
OG0029801	0	2	0	0	0	2
OG0029802	0	2	0	0	0	2
OG0029803	0	2	0	0	0	2
OG0029804	0	2	0	0	0	2
OG0029805	0	2	0	0	0	2
OG0029806	0	2	0	0	0	2
OG0029807	0	2	0	0	0	2
OG0029808	0	2	0	0	0	2
OG0029809	0	2	0	0	0	2
OG0029810	0	2	0	0	0	2
OG0029811	0	2	0	0	0	2
OG0029812	0	2	0	0	0	2
OG0029813	0	2	0	0	0	2
OG0029814	0	2	0	0	0	2
OG0029815	0	2	0	0	0	2
OG0029816	0	2	0	0	0	2
OG0029817	0	2	0	0	0	2
OG0029818	0	2	0	0	0	2
OG0029819	0	2	0	0	0	2
OG0029820	0	2	0	0	0	2
OG0029821	0	2	0	0	0	2
OG0029822	0	2	0	0	0	2
OG0029823	0	2	0	0	0	2
OG0029824	0	2	0	0	0	2
OG0029825	0	2	0	0	0	2
OG0029826	0	2	0	0	0	2
OG0029827	0	2	0	0	0	2
OG0029828	0	2	0	0	0	2
OG0029829	0	2	0	0	0	2
OG0029830	0	2	0	0	0	2
OG0029831	0	2	0	0	0	2
OG0029832	0	2	0	0	0	2
OG0029833	0	2	0	0	0	2
OG0029834	0	2	0	0	0	2
OG0029835	0	2	0	0	0	2
OG0029836	0	2	0	0	0	2
OG0029837	0	2	0	0	0	2
OG0029838	0	2	0	0	0	2
OG0029839	0	2	0	0	0	2
OG0029840	0	2	0	0	0	2
OG0029841	0	2	0	0	0	2
OG0029842	0	2	0	0	0	2
OG0029843	0	2	0	0	0	2
OG0029844	0	2	0	0	0	2
OG0029845	0	2	0	0	0	2
OG0029846	0	2	0	0	0	2
OG0029847	0	2	0	0	0	2
OG0029848	0	2	0	0	0	2
OG0029849	0	2	0	0	0	2
OG0029850	0	2	0	0	0	2
OG0029851	0	2	0	0	0	2
OG0029852	0	2	0	0	0	2
OG0029853	0	2	0	0	0	2
OG0029854	0	2	0	0	0	2
OG0029855	0	2	0	0	0	2
OG0029856	0	2	0	0	0	2
OG0029857	0	2	0	0	0	2
OG0029858	0	2	0	0	0	2
OG0029859	0	2	0	0	0	2
OG0029860	0	2	0	0	0	2
OG0029861	0	2	0	0	0	2
OG0029862	0	2	0	0	0	2
OG0029863	0	2	0	0	0	2
OG0029864	0	2	0	0	0	2
OG0029865	0	2	0	0	0	2
OG0029866	0	2	0	0	0	2
OG0029867	0	2	0	0	0	2
OG0029868	0	2	0	0	0	2
OG0029869	0	2	0	0	0	2
OG0029870	0	2	0	0	0	2
OG0029871	0	2	0	0	0	2
OG0029872	0	2	0	0	0	2
OG0029873	0	2	0	0	0	2
OG0029874	0	2	0	0	0	2
OG0029875	0	2	0	0	0	2
OG0029876	0	2	0	0	0	2
OG0029877	0	2	0	0	0	2
OG0029878	0	2	0	0	0	2
OG0029879	0	2	0	0	0	2
OG0029880	0	2	0	0	0	2
OG0029881	0	2	0	0	0	2
OG0029882	0	2	0	0	0	2
OG0029883	0	2	0	0	0	2
OG0029884	0	2	0	0	0	2
OG0029885	0	2	0	0	0	2
OG0029886	0	2	0	0	0	2
OG0029887	0	2	0	0	0	2
OG0029888	0	2	0	0	0	2
OG0029889	0	2	0	0	0	2
OG0029890	0	2	0	0	0	2
OG0029891	0	2	0	0	0	2
OG0029892	0	2	0	0	0	2
OG0029893	0	2	0	0	0	2
OG0029894	0	2	0	0	0	2
OG0029895	0	2	0	0	0	2
OG0029896	0	2	0	0	0	2
OG0029897	0	2	0	0	0	2
OG0029898	0	2	0	0	0	2
OG0029899	0	1	1	0	0	2
OG0029900	0	2	0	0	0	2
OG0029901	0	2	0	0	0	2
OG0029902	0	2	0	0	0	2
OG0029903	0	2	0	0	0	2
OG0029904	0	2	0	0	0	2
OG0029905	0	2	0	0	0	2
OG0029906	0	2	0	0	0	2
OG0029907	0	2	0	0	0	2
OG0029908	0	2	0	0	0	2
OG0029909	0	2	0	0	0	2
OG0029910	0	2	0	0	0	2
OG0029911	0	2	0	0	0	2
OG0029912	0	2	0	0	0	2
OG0029913	0	2	0	0	0	2
OG0029914	0	2	0	0	0	2
OG0029915	0	2	0	0	0	2
OG0029916	0	2	0	0	0	2
OG0029917	0	2	0	0	0	2
OG0029918	0	2	0	0	0	2
OG0029919	0	2	0	0	0	2
OG0029920	0	1	0	0	1	2
OG0029921	0	2	0	0	0	2
OG0029922	0	2	0	0	0	2
OG0029923	0	2	0	0	0	2
OG0029924	0	2	0	0	0	2
OG0029925	0	2	0	0	0	2
OG0029926	0	1	1	0	0	2
OG0029927	0	2	0	0	0	2
OG0029928	0	2	0	0	0	2
OG0029929	0	2	0	0	0	2
OG0029930	0	2	0	0	0	2
OG0029931	0	1	1	0	0	2
OG0029932	0	2	0	0	0	2
OG0029933	0	2	0	0	0	2
OG0029934	0	2	0	0	0	2
OG0029935	0	2	0	0	0	2
OG0029936	0	2	0	0	0	2
OG0029937	0	2	0	0	0	2
OG0029938	0	2	0	0	0	2
OG0029939	0	2	0	0	0	2
OG0029940	0	2	0	0	0	2
OG0029941	0	2	0	0	0	2
OG0029942	0	2	0	0	0	2
OG0029943	0	1	1	0	0	2
OG0029944	0	2	0	0	0	2
OG0029945	0	2	0	0	0	2
OG0029946	0	2	0	0	0	2
OG0029947	0	2	0	0	0	2
OG0029948	0	2	0	0	0	2
OG0029949	0	2	0	0	0	2
OG0029950	0	2	0	0	0	2
OG0029951	0	2	0	0	0	2
OG0029952	0	2	0	0	0	2
OG0029953	0	2	0	0	0	2
OG0029954	0	2	0	0	0	2
OG0029955	0	2	0	0	0	2
OG0029956	0	2	0	0	0	2
OG0029957	0	2	0	0	0	2
OG0029958	0	2	0	0	0	2
OG0029959	0	2	0	0	0	2
OG0029960	0	2	0	0	0	2
OG0029961	0	2	0	0	0	2
OG0029962	0	2	0	0	0	2
OG0029963	0	2	0	0	0	2
OG0029964	0	2	0	0	0	2
OG0029965	0	2	0	0	0	2
OG0029966	0	2	0	0	0	2
OG0029967	0	2	0	0	0	2
OG0029968	0	2	0	0	0	2
OG0029969	0	2	0	0	0	2
OG0029970	0	2	0	0	0	2
OG0029971	0	2	0	0	0	2
OG0029972	0	2	0	0	0	2
OG0029973	0	2	0	0	0	2
OG0029974	0	2	0	0	0	2
OG0029975	0	2	0	0	0	2
OG0029976	0	2	0	0	0	2
OG0029977	0	2	0	0	0	2
OG0029978	0	2	0	0	0	2
OG0029979	0	2	0	0	0	2
OG0029980	0	2	0	0	0	2
OG0029981	0	2	0	0	0	2
OG0029982	0	2	0	0	0	2
OG0029983	0	2	0	0	0	2
OG0029984	0	2	0	0	0	2
OG0029985	0	2	0	0	0	2
OG0029986	0	2	0	0	0	2
OG0029987	0	2	0	0	0	2
OG0029988	0	2	0	0	0	2
OG0029989	0	2	0	0	0	2
OG0029990	0	2	0	0	0	2
OG0029991	0	2	0	0	0	2
OG0029992	0	2	0	0	0	2
OG0029993	0	2	0	0	0	2
OG0029994	0	2	0	0	0	2
OG0029995	0	2	0	0	0	2
OG0029996	0	2	0	0	0	2
OG0029997	0	2	0	0	0	2
OG0029998	0	2	0	0	0	2
OG0029999	0	2	0	0	0	2
OG0030000	0	2	0	0	0	2
OG0030001	0	2	0	0	0	2
OG0030002	0	2	0	0	0	2
OG0030003	0	2	0	0	0	2
OG0030004	0	2	0	0	0	2
OG0030005	0	2	0	0	0	2
OG0030006	0	2	0	0	0	2
OG0030007	0	2	0	0	0	2
OG0030008	0	2	0	0	0	2
OG0030009	0	2	0	0	0	2
OG0030010	0	2	0	0	0	2
OG0030011	0	2	0	0	0	2
OG0030012	0	2	0	0	0	2
OG0030013	0	2	0	0	0	2
OG0030014	0	2	0	0	0	2
OG0030015	0	2	0	0	0	2
OG0030016	0	2	0	0	0	2
OG0030017	0	2	0	0	0	2
OG0030018	0	2	0	0	0	2
OG0030019	0	2	0	0	0	2
OG0030020	0	2	0	0	0	2
OG0030021	0	2	0	0	0	2
OG0030022	0	2	0	0	0	2
OG0030023	0	2	0	0	0	2
OG0030024	0	1	0	1	0	2
OG0030025	0	2	0	0	0	2
OG0030026	0	2	0	0	0	2
OG0030027	0	2	0	0	0	2
OG0030028	0	2	0	0	0	2
OG0030029	0	2	0	0	0	2
OG0030030	0	2	0	0	0	2
OG0030031	0	2	0	0	0	2
OG0030032	0	2	0	0	0	2
OG0030033	0	2	0	0	0	2
OG0030034	0	2	0	0	0	2
OG0030035	0	2	0	0	0	2
OG0030036	0	2	0	0	0	2
OG0030037	0	2	0	0	0	2
OG0030038	0	2	0	0	0	2
OG0030039	0	2	0	0	0	2
OG0030040	0	2	0	0	0	2
OG0030041	0	2	0	0	0	2
OG0030042	0	2	0	0	0	2
OG0030043	0	2	0	0	0	2
OG0030044	0	2	0	0	0	2
OG0030045	0	2	0	0	0	2
OG0030046	0	2	0	0	0	2
OG0030047	0	2	0	0	0	2
OG0030048	0	2	0	0	0	2
OG0030049	0	2	0	0	0	2
OG0030050	0	2	0	0	0	2
OG0030051	0	2	0	0	0	2
OG0030052	0	2	0	0	0	2
OG0030053	0	2	0	0	0	2
OG0030054	0	2	0	0	0	2
OG0030055	0	2	0	0	0	2
OG0030056	0	2	0	0	0	2
OG0030057	0	2	0	0	0	2
OG0030058	0	2	0	0	0	2
OG0030059	0	2	0	0	0	2
OG0030060	0	2	0	0	0	2
OG0030061	0	2	0	0	0	2
OG0030062	0	2	0	0	0	2
OG0030063	0	2	0	0	0	2
OG0030064	0	2	0	0	0	2
OG0030065	0	2	0	0	0	2
OG0030066	0	2	0	0	0	2
OG0030067	0	2	0	0	0	2
OG0030068	0	2	0	0	0	2
OG0030069	0	2	0	0	0	2
OG0030070	0	2	0	0	0	2
OG0030071	0	2	0	0	0	2
OG0030072	0	2	0	0	0	2
OG0030073	0	2	0	0	0	2
OG0030074	0	2	0	0	0	2
OG0030075	0	2	0	0	0	2
OG0030076	0	1	0	0	1	2
OG0030077	0	2	0	0	0	2
OG0030078	0	2	0	0	0	2
OG0030079	0	2	0	0	0	2
OG0030080	0	2	0	0	0	2
OG0030081	0	2	0	0	0	2
OG0030082	0	2	0	0	0	2
OG0030083	0	2	0	0	0	2
OG0030084	0	2	0	0	0	2
OG0030085	0	2	0	0	0	2
OG0030086	0	2	0	0	0	2
OG0030087	0	2	0	0	0	2
OG0030088	0	2	0	0	0	2
OG0030089	0	2	0	0	0	2
OG0030090	0	2	0	0	0	2
OG0030091	0	2	0	0	0	2
OG0030092	0	2	0	0	0	2
OG0030093	0	2	0	0	0	2
OG0030094	0	2	0	0	0	2
OG0030095	0	2	0	0	0	2
OG0030096	0	2	0	0	0	2
OG0030097	0	2	0	0	0	2
OG0030098	0	2	0	0	0	2
OG0030099	0	2	0	0	0	2
OG0030100	0	2	0	0	0	2
OG0030101	0	2	0	0	0	2
OG0030102	0	2	0	0	0	2
OG0030103	0	2	0	0	0	2
OG0030104	0	2	0	0	0	2
OG0030105	0	2	0	0	0	2
OG0030106	0	2	0	0	0	2
OG0030107	0	2	0	0	0	2
OG0030108	0	2	0	0	0	2
OG0030109	0	2	0	0	0	2
OG0030110	0	2	0	0	0	2
OG0030111	0	2	0	0	0	2
OG0030112	0	2	0	0	0	2
OG0030113	0	2	0	0	0	2
OG0030114	0	2	0	0	0	2
OG0030115	0	2	0	0	0	2
OG0030116	0	2	0	0	0	2
OG0030117	0	2	0	0	0	2
OG0030118	0	2	0	0	0	2
OG0030119	0	2	0	0	0	2
OG0030120	0	2	0	0	0	2
OG0030121	0	2	0	0	0	2
OG0030122	0	2	0	0	0	2
OG0030123	0	2	0	0	0	2
OG0030124	0	2	0	0	0	2
OG0030125	0	2	0	0	0	2
OG0030126	0	2	0	0	0	2
OG0030127	0	2	0	0	0	2
OG0030128	0	2	0	0	0	2
OG0030129	0	2	0	0	0	2
OG0030130	0	2	0	0	0	2
OG0030131	0	2	0	0	0	2
OG0030132	0	2	0	0	0	2
OG0030133	0	2	0	0	0	2
OG0030134	0	2	0	0	0	2
OG0030135	0	1	0	0	1	2
OG0030136	0	2	0	0	0	2
OG0030137	0	2	0	0	0	2
OG0030138	0	2	0	0	0	2
OG0030139	0	2	0	0	0	2
OG0030140	0	2	0	0	0	2
OG0030141	0	2	0	0	0	2
OG0030142	0	2	0	0	0	2
OG0030143	0	2	0	0	0	2
OG0030144	0	2	0	0	0	2
OG0030145	0	2	0	0	0	2
OG0030146	0	2	0	0	0	2
OG0030147	0	2	0	0	0	2
OG0030148	0	2	0	0	0	2
OG0030149	0	2	0	0	0	2
OG0030150	0	2	0	0	0	2
OG0030151	0	2	0	0	0	2
OG0030152	0	2	0	0	0	2
OG0030153	0	2	0	0	0	2
OG0030154	0	2	0	0	0	2
OG0030155	0	2	0	0	0	2
OG0030156	0	2	0	0	0	2
OG0030157	0	2	0	0	0	2
OG0030158	0	2	0	0	0	2
OG0030159	0	2	0	0	0	2
OG0030160	0	2	0	0	0	2
OG0030161	0	2	0	0	0	2
OG0030162	0	2	0	0	0	2
OG0030163	0	2	0	0	0	2
OG0030164	0	2	0	0	0	2
OG0030165	0	2	0	0	0	2
OG0030166	0	2	0	0	0	2
OG0030167	0	2	0	0	0	2
OG0030168	0	2	0	0	0	2
OG0030169	0	2	0	0	0	2
OG0030170	0	2	0	0	0	2
OG0030171	0	2	0	0	0	2
OG0030172	0	2	0	0	0	2
OG0030173	0	2	0	0	0	2
OG0030174	0	2	0	0	0	2
OG0030175	0	2	0	0	0	2
OG0030176	0	2	0	0	0	2
OG0030177	0	2	0	0	0	2
OG0030178	0	2	0	0	0	2
OG0030179	0	2	0	0	0	2
OG0030180	0	2	0	0	0	2
OG0030181	0	1	1	0	0	2
OG0030182	0	2	0	0	0	2
OG0030183	0	2	0	0	0	2
OG0030184	0	2	0	0	0	2
OG0030185	0	2	0	0	0	2
OG0030186	0	2	0	0	0	2
OG0030187	0	2	0	0	0	2
OG0030188	0	2	0	0	0	2
OG0030189	0	2	0	0	0	2
OG0030190	0	2	0	0	0	2
OG0030191	0	2	0	0	0	2
OG0030192	0	2	0	0	0	2
OG0030193	0	2	0	0	0	2
OG0030194	0	2	0	0	0	2
OG0030195	0	2	0	0	0	2
OG0030196	0	2	0	0	0	2
OG0030197	0	2	0	0	0	2
OG0030198	0	2	0	0	0	2
OG0030199	0	2	0	0	0	2
OG0030200	0	2	0	0	0	2
OG0030201	0	2	0	0	0	2
OG0030202	0	2	0	0	0	2
OG0030203	0	2	0	0	0	2
OG0030204	0	2	0	0	0	2
OG0030205	0	2	0	0	0	2
OG0030206	0	2	0	0	0	2
OG0030207	0	2	0	0	0	2
OG0030208	0	2	0	0	0	2
OG0030209	0	2	0	0	0	2
OG0030210	0	2	0	0	0	2
OG0030211	0	2	0	0	0	2
OG0030212	0	2	0	0	0	2
OG0030213	0	2	0	0	0	2
OG0030214	0	2	0	0	0	2
OG0030215	0	2	0	0	0	2
OG0030216	0	2	0	0	0	2
OG0030217	0	2	0	0	0	2
OG0030218	0	2	0	0	0	2
OG0030219	0	2	0	0	0	2
OG0030220	0	2	0	0	0	2
OG0030221	0	2	0	0	0	2
OG0030222	0	2	0	0	0	2
OG0030223	0	2	0	0	0	2
OG0030224	0	2	0	0	0	2
OG0030225	0	2	0	0	0	2
OG0030226	0	2	0	0	0	2
OG0030227	0	2	0	0	0	2
OG0030228	0	2	0	0	0	2
OG0030229	0	2	0	0	0	2
OG0030230	0	2	0	0	0	2
OG0030231	0	2	0	0	0	2
OG0030232	0	2	0	0	0	2
OG0030233	0	2	0	0	0	2
OG0030234	0	2	0	0	0	2
OG0030235	0	2	0	0	0	2
OG0030236	0	2	0	0	0	2
OG0030237	0	2	0	0	0	2
OG0030238	0	2	0	0	0	2
OG0030239	0	2	0	0	0	2
OG0030240	0	2	0	0	0	2
OG0030241	0	2	0	0	0	2
OG0030242	0	2	0	0	0	2
OG0030243	0	2	0	0	0	2
OG0030244	0	2	0	0	0	2
OG0030245	0	2	0	0	0	2
OG0030246	0	2	0	0	0	2
OG0030247	0	2	0	0	0	2
OG0030248	0	2	0	0	0	2
OG0030249	0	2	0	0	0	2
OG0030250	0	2	0	0	0	2
OG0030251	0	2	0	0	0	2
OG0030252	0	2	0	0	0	2
OG0030253	0	2	0	0	0	2
OG0030254	0	2	0	0	0	2
OG0030255	0	2	0	0	0	2
OG0030256	0	2	0	0	0	2
OG0030257	0	2	0	0	0	2
OG0030258	0	2	0	0	0	2
OG0030259	0	2	0	0	0	2
OG0030260	0	2	0	0	0	2
OG0030261	0	2	0	0	0	2
OG0030262	0	2	0	0	0	2
OG0030263	0	2	0	0	0	2
OG0030264	0	2	0	0	0	2
OG0030265	0	2	0	0	0	2
OG0030266	0	2	0	0	0	2
OG0030267	0	2	0	0	0	2
OG0030268	0	2	0	0	0	2
OG0030269	0	2	0	0	0	2
OG0030270	0	2	0	0	0	2
OG0030271	0	2	0	0	0	2
OG0030272	0	2	0	0	0	2
OG0030273	0	2	0	0	0	2
OG0030274	0	2	0	0	0	2
OG0030275	0	2	0	0	0	2
OG0030276	0	2	0	0	0	2
OG0030277	0	2	0	0	0	2
OG0030278	0	2	0	0	0	2
OG0030279	0	2	0	0	0	2
OG0030280	0	2	0	0	0	2
OG0030281	0	2	0	0	0	2
OG0030282	0	2	0	0	0	2
OG0030283	0	2	0	0	0	2
OG0030284	0	2	0	0	0	2
OG0030285	0	2	0	0	0	2
OG0030286	0	2	0	0	0	2
OG0030287	0	2	0	0	0	2
OG0030288	0	2	0	0	0	2
OG0030289	0	2	0	0	0	2
OG0030290	0	2	0	0	0	2
OG0030291	0	2	0	0	0	2
OG0030292	0	2	0	0	0	2
OG0030293	0	2	0	0	0	2
OG0030294	0	2	0	0	0	2
OG0030295	0	2	0	0	0	2
OG0030296	0	2	0	0	0	2
OG0030297	0	2	0	0	0	2
OG0030298	0	2	0	0	0	2
OG0030299	0	2	0	0	0	2
OG0030300	0	2	0	0	0	2
OG0030301	0	2	0	0	0	2
OG0030302	0	2	0	0	0	2
OG0030303	0	2	0	0	0	2
OG0030304	0	2	0	0	0	2
OG0030305	0	2	0	0	0	2
OG0030306	0	2	0	0	0	2
OG0030307	0	2	0	0	0	2
OG0030308	0	2	0	0	0	2
OG0030309	0	2	0	0	0	2
OG0030310	0	2	0	0	0	2
OG0030311	0	2	0	0	0	2
OG0030312	0	2	0	0	0	2
OG0030313	0	2	0	0	0	2
OG0030314	0	2	0	0	0	2
OG0030315	0	2	0	0	0	2
OG0030316	0	2	0	0	0	2
OG0030317	0	2	0	0	0	2
OG0030318	0	2	0	0	0	2
OG0030319	0	2	0	0	0	2
OG0030320	0	2	0	0	0	2
OG0030321	0	2	0	0	0	2
OG0030322	0	2	0	0	0	2
OG0030323	0	2	0	0	0	2
OG0030324	0	2	0	0	0	2
OG0030325	0	2	0	0	0	2
OG0030326	0	2	0	0	0	2
OG0030327	0	2	0	0	0	2
OG0030328	0	2	0	0	0	2
OG0030329	0	2	0	0	0	2
OG0030330	0	2	0	0	0	2
OG0030331	0	2	0	0	0	2
OG0030332	0	2	0	0	0	2
OG0030333	0	2	0	0	0	2
OG0030334	0	2	0	0	0	2
OG0030335	0	2	0	0	0	2
OG0030336	0	2	0	0	0	2
OG0030337	0	2	0	0	0	2
OG0030338	0	2	0	0	0	2
OG0030339	0	2	0	0	0	2
OG0030340	0	2	0	0	0	2
OG0030341	0	2	0	0	0	2
OG0030342	0	2	0	0	0	2
OG0030343	0	2	0	0	0	2
OG0030344	0	2	0	0	0	2
OG0030345	0	2	0	0	0	2
OG0030346	0	2	0	0	0	2
OG0030347	0	2	0	0	0	2
OG0030348	0	2	0	0	0	2
OG0030349	0	2	0	0	0	2
OG0030350	0	2	0	0	0	2
OG0030351	0	2	0	0	0	2
OG0030352	0	2	0	0	0	2
OG0030353	0	2	0	0	0	2
OG0030354	0	2	0	0	0	2
OG0030355	0	2	0	0	0	2
OG0030356	0	2	0	0	0	2
OG0030357	0	2	0	0	0	2
OG0030358	0	2	0	0	0	2
OG0030359	0	2	0	0	0	2
OG0030360	0	2	0	0	0	2
OG0030361	0	2	0	0	0	2
OG0030362	0	2	0	0	0	2
OG0030363	0	1	0	1	0	2
OG0030364	0	2	0	0	0	2
OG0030365	0	2	0	0	0	2
OG0030366	0	2	0	0	0	2
OG0030367	0	2	0	0	0	2
OG0030368	0	2	0	0	0	2
OG0030369	0	2	0	0	0	2
OG0030370	0	2	0	0	0	2
OG0030371	0	2	0	0	0	2
OG0030372	0	2	0	0	0	2
OG0030373	0	2	0	0	0	2
OG0030374	0	1	0	1	0	2
OG0030375	0	2	0	0	0	2
OG0030376	0	2	0	0	0	2
OG0030377	0	2	0	0	0	2
OG0030378	0	2	0	0	0	2
OG0030379	0	2	0	0	0	2
OG0030380	0	2	0	0	0	2
OG0030381	0	2	0	0	0	2
OG0030382	0	2	0	0	0	2
OG0030383	0	2	0	0	0	2
OG0030384	0	2	0	0	0	2
OG0030385	0	2	0	0	0	2
OG0030386	0	2	0	0	0	2
OG0030387	0	2	0	0	0	2
OG0030388	0	2	0	0	0	2
OG0030389	0	2	0	0	0	2
OG0030390	0	2	0	0	0	2
OG0030391	0	2	0	0	0	2
OG0030392	0	2	0	0	0	2
OG0030393	0	2	0	0	0	2
OG0030394	0	2	0	0	0	2
OG0030395	0	2	0	0	0	2
OG0030396	0	2	0	0	0	2
OG0030397	0	2	0	0	0	2
OG0030398	0	2	0	0	0	2
OG0030399	0	2	0	0	0	2
OG0030400	0	2	0	0	0	2
OG0030401	0	2	0	0	0	2
OG0030402	0	2	0	0	0	2
OG0030403	0	2	0	0	0	2
OG0030404	0	2	0	0	0	2
OG0030405	0	2	0	0	0	2
OG0030406	0	2	0	0	0	2
OG0030407	0	1	1	0	0	2
OG0030408	0	2	0	0	0	2
OG0030409	0	2	0	0	0	2
OG0030410	0	2	0	0	0	2
OG0030411	0	2	0	0	0	2
OG0030412	0	2	0	0	0	2
OG0030413	0	2	0	0	0	2
OG0030414	0	1	0	0	1	2
OG0030415	0	2	0	0	0	2
OG0030416	0	2	0	0	0	2
OG0030417	0	2	0	0	0	2
OG0030418	0	2	0	0	0	2
OG0030419	0	2	0	0	0	2
OG0030420	0	2	0	0	0	2
OG0030421	0	2	0	0	0	2
OG0030422	0	2	0	0	0	2
OG0030423	0	2	0	0	0	2
OG0030424	0	2	0	0	0	2
OG0030425	0	2	0	0	0	2
OG0030426	0	2	0	0	0	2
OG0030427	0	2	0	0	0	2
OG0030428	0	2	0	0	0	2
OG0030429	0	2	0	0	0	2
OG0030430	0	2	0	0	0	2
OG0030431	0	2	0	0	0	2
OG0030432	0	2	0	0	0	2
OG0030433	0	2	0	0	0	2
OG0030434	0	2	0	0	0	2
OG0030435	0	2	0	0	0	2
OG0030436	0	2	0	0	0	2
OG0030437	0	2	0	0	0	2
OG0030438	0	2	0	0	0	2
OG0030439	0	2	0	0	0	2
OG0030440	0	2	0	0	0	2
OG0030441	0	2	0	0	0	2
OG0030442	0	2	0	0	0	2
OG0030443	0	2	0	0	0	2
OG0030444	0	2	0	0	0	2
OG0030445	0	2	0	0	0	2
OG0030446	0	2	0	0	0	2
OG0030447	0	2	0	0	0	2
OG0030448	0	2	0	0	0	2
OG0030449	0	2	0	0	0	2
OG0030450	0	1	1	0	0	2
OG0030451	0	2	0	0	0	2
OG0030452	0	2	0	0	0	2
OG0030453	0	2	0	0	0	2
OG0030454	0	1	1	0	0	2
OG0030455	0	2	0	0	0	2
OG0030456	0	2	0	0	0	2
OG0030457	0	2	0	0	0	2
OG0030458	0	2	0	0	0	2
OG0030459	0	2	0	0	0	2
OG0030460	0	2	0	0	0	2
OG0030461	0	1	1	0	0	2
OG0030462	0	2	0	0	0	2
OG0030463	0	2	0	0	0	2
OG0030464	0	2	0	0	0	2
OG0030465	0	2	0	0	0	2
OG0030466	0	2	0	0	0	2
OG0030467	0	2	0	0	0	2
OG0030468	0	2	0	0	0	2
OG0030469	0	2	0	0	0	2
OG0030470	0	2	0	0	0	2
OG0030471	0	2	0	0	0	2
OG0030472	0	2	0	0	0	2
OG0030473	0	2	0	0	0	2
OG0030474	0	2	0	0	0	2
OG0030475	0	2	0	0	0	2
OG0030476	0	2	0	0	0	2
OG0030477	0	2	0	0	0	2
OG0030478	0	2	0	0	0	2
OG0030479	0	2	0	0	0	2
OG0030480	0	2	0	0	0	2
OG0030481	0	1	1	0	0	2
OG0030482	0	2	0	0	0	2
OG0030483	0	2	0	0	0	2
OG0030484	0	2	0	0	0	2
OG0030485	0	2	0	0	0	2
OG0030486	0	2	0	0	0	2
OG0030487	0	2	0	0	0	2
OG0030488	0	2	0	0	0	2
OG0030489	0	2	0	0	0	2
OG0030490	0	2	0	0	0	2
OG0030491	0	2	0	0	0	2
OG0030492	0	2	0	0	0	2
OG0030493	0	2	0	0	0	2
OG0030494	0	2	0	0	0	2
OG0030495	0	2	0	0	0	2
OG0030496	0	2	0	0	0	2
OG0030497	0	2	0	0	0	2
OG0030498	0	2	0	0	0	2
OG0030499	0	2	0	0	0	2
OG0030500	0	2	0	0	0	2
OG0030501	0	2	0	0	0	2
OG0030502	0	2	0	0	0	2
OG0030503	0	2	0	0	0	2
OG0030504	0	2	0	0	0	2
OG0030505	0	2	0	0	0	2
OG0030506	0	2	0	0	0	2
OG0030507	0	2	0	0	0	2
OG0030508	0	2	0	0	0	2
OG0030509	0	2	0	0	0	2
OG0030510	0	2	0	0	0	2
OG0030511	0	2	0	0	0	2
OG0030512	0	2	0	0	0	2
OG0030513	0	2	0	0	0	2
OG0030514	0	2	0	0	0	2
OG0030515	0	2	0	0	0	2
OG0030516	0	2	0	0	0	2
OG0030517	0	2	0	0	0	2
OG0030518	0	2	0	0	0	2
OG0030519	0	2	0	0	0	2
OG0030520	0	2	0	0	0	2
OG0030521	0	2	0	0	0	2
OG0030522	0	2	0	0	0	2
OG0030523	0	2	0	0	0	2
OG0030524	0	2	0	0	0	2
OG0030525	0	2	0	0	0	2
OG0030526	0	2	0	0	0	2
OG0030527	0	2	0	0	0	2
OG0030528	0	2	0	0	0	2
OG0030529	0	1	1	0	0	2
OG0030530	0	1	0	1	0	2
OG0030531	0	2	0	0	0	2
OG0030532	0	2	0	0	0	2
OG0030533	0	2	0	0	0	2
OG0030534	0	2	0	0	0	2
OG0030535	0	2	0	0	0	2
OG0030536	0	2	0	0	0	2
OG0030537	0	2	0	0	0	2
OG0030538	0	2	0	0	0	2
OG0030539	0	2	0	0	0	2
OG0030540	0	2	0	0	0	2
OG0030541	0	2	0	0	0	2
OG0030542	0	2	0	0	0	2
OG0030543	0	2	0	0	0	2
OG0030544	0	2	0	0	0	2
OG0030545	0	2	0	0	0	2
OG0030546	0	2	0	0	0	2
OG0030547	0	2	0	0	0	2
OG0030548	0	2	0	0	0	2
OG0030549	0	2	0	0	0	2
OG0030550	0	2	0	0	0	2
OG0030551	0	2	0	0	0	2
OG0030552	0	2	0	0	0	2
OG0030553	0	2	0	0	0	2
OG0030554	0	2	0	0	0	2
OG0030555	0	2	0	0	0	2
OG0030556	0	2	0	0	0	2
OG0030557	0	2	0	0	0	2
OG0030558	0	2	0	0	0	2
OG0030559	0	2	0	0	0	2
OG0030560	0	2	0	0	0	2
OG0030561	0	2	0	0	0	2
OG0030562	0	2	0	0	0	2
OG0030563	0	2	0	0	0	2
OG0030564	0	2	0	0	0	2
OG0030565	0	2	0	0	0	2
OG0030566	0	2	0	0	0	2
OG0030567	0	2	0	0	0	2
OG0030568	0	2	0	0	0	2
OG0030569	0	1	1	0	0	2
OG0030570	0	2	0	0	0	2
OG0030571	0	2	0	0	0	2
OG0030572	0	2	0	0	0	2
OG0030573	0	2	0	0	0	2
OG0030574	0	2	0	0	0	2
OG0030575	0	2	0	0	0	2
OG0030576	0	2	0	0	0	2
OG0030577	0	2	0	0	0	2
OG0030578	0	2	0	0	0	2
OG0030579	0	2	0	0	0	2
OG0030580	0	2	0	0	0	2
OG0030581	0	2	0	0	0	2
OG0030582	0	2	0	0	0	2
OG0030583	0	2	0	0	0	2
OG0030584	0	2	0	0	0	2
OG0030585	0	2	0	0	0	2
OG0030586	0	2	0	0	0	2
OG0030587	0	2	0	0	0	2
OG0030588	0	2	0	0	0	2
OG0030589	0	2	0	0	0	2
OG0030590	0	2	0	0	0	2
OG0030591	0	2	0	0	0	2
OG0030592	0	2	0	0	0	2
OG0030593	0	2	0	0	0	2
OG0030594	0	2	0	0	0	2
OG0030595	0	2	0	0	0	2
OG0030596	0	2	0	0	0	2
OG0030597	0	2	0	0	0	2
OG0030598	0	2	0	0	0	2
OG0030599	0	2	0	0	0	2
OG0030600	0	2	0	0	0	2
OG0030601	0	2	0	0	0	2
OG0030602	0	2	0	0	0	2
OG0030603	0	2	0	0	0	2
OG0030604	0	2	0	0	0	2
OG0030605	0	2	0	0	0	2
OG0030606	0	2	0	0	0	2
OG0030607	0	2	0	0	0	2
OG0030608	0	2	0	0	0	2
OG0030609	0	2	0	0	0	2
OG0030610	0	2	0	0	0	2
OG0030611	0	2	0	0	0	2
OG0030612	0	2	0	0	0	2
OG0030613	0	2	0	0	0	2
OG0030614	0	2	0	0	0	2
OG0030615	0	2	0	0	0	2
OG0030616	0	2	0	0	0	2
OG0030617	0	2	0	0	0	2
OG0030618	0	2	0	0	0	2
OG0030619	0	2	0	0	0	2
OG0030620	0	2	0	0	0	2
OG0030621	0	2	0	0	0	2
OG0030622	0	2	0	0	0	2
OG0030623	0	2	0	0	0	2
OG0030624	0	2	0	0	0	2
OG0030625	0	2	0	0	0	2
OG0030626	0	2	0	0	0	2
OG0030627	0	2	0	0	0	2
OG0030628	0	2	0	0	0	2
OG0030629	0	2	0	0	0	2
OG0030630	0	2	0	0	0	2
OG0030631	0	2	0	0	0	2
OG0030632	0	2	0	0	0	2
OG0030633	0	2	0	0	0	2
OG0030634	0	2	0	0	0	2
OG0030635	0	2	0	0	0	2
OG0030636	0	2	0	0	0	2
OG0030637	0	2	0	0	0	2
OG0030638	0	2	0	0	0	2
OG0030639	0	2	0	0	0	2
OG0030640	0	2	0	0	0	2
OG0030641	0	2	0	0	0	2
OG0030642	0	2	0	0	0	2
OG0030643	0	2	0	0	0	2
OG0030644	0	2	0	0	0	2
OG0030645	0	2	0	0	0	2
OG0030646	0	2	0	0	0	2
OG0030647	0	2	0	0	0	2
OG0030648	0	2	0	0	0	2
OG0030649	0	2	0	0	0	2
OG0030650	0	2	0	0	0	2
OG0030651	0	2	0	0	0	2
OG0030652	0	2	0	0	0	2
OG0030653	0	2	0	0	0	2
OG0030654	0	2	0	0	0	2
OG0030655	0	2	0	0	0	2
OG0030656	0	2	0	0	0	2
OG0030657	0	2	0	0	0	2
OG0030658	0	2	0	0	0	2
OG0030659	0	2	0	0	0	2
OG0030660	0	2	0	0	0	2
OG0030661	0	2	0	0	0	2
OG0030662	0	2	0	0	0	2
OG0030663	0	2	0	0	0	2
OG0030664	0	2	0	0	0	2
OG0030665	0	2	0	0	0	2
OG0030666	0	2	0	0	0	2
OG0030667	0	2	0	0	0	2
OG0030668	0	2	0	0	0	2
OG0030669	0	2	0	0	0	2
OG0030670	0	2	0	0	0	2
OG0030671	0	2	0	0	0	2
OG0030672	0	2	0	0	0	2
OG0030673	0	2	0	0	0	2
OG0030674	0	2	0	0	0	2
OG0030675	0	2	0	0	0	2
OG0030676	0	2	0	0	0	2
OG0030677	0	2	0	0	0	2
OG0030678	0	2	0	0	0	2
OG0030679	0	2	0	0	0	2
OG0030680	0	2	0	0	0	2
OG0030681	0	2	0	0	0	2
OG0030682	0	2	0	0	0	2
OG0030683	0	2	0	0	0	2
OG0030684	0	2	0	0	0	2
OG0030685	0	2	0	0	0	2
OG0030686	0	2	0	0	0	2
OG0030687	0	2	0	0	0	2
OG0030688	0	2	0	0	0	2
OG0030689	0	2	0	0	0	2
OG0030690	0	2	0	0	0	2
OG0030691	0	2	0	0	0	2
OG0030692	0	2	0	0	0	2
OG0030693	0	2	0	0	0	2
OG0030694	0	2	0	0	0	2
OG0030695	0	2	0	0	0	2
OG0030696	0	2	0	0	0	2
OG0030697	0	2	0	0	0	2
OG0030698	0	2	0	0	0	2
OG0030699	0	2	0	0	0	2
OG0030700	0	2	0	0	0	2
OG0030701	0	2	0	0	0	2
OG0030702	0	2	0	0	0	2
OG0030703	0	2	0	0	0	2
OG0030704	0	1	1	0	0	2
OG0030705	0	2	0	0	0	2
OG0030706	0	2	0	0	0	2
OG0030707	0	2	0	0	0	2
OG0030708	0	2	0	0	0	2
OG0030709	0	2	0	0	0	2
OG0030710	0	2	0	0	0	2
OG0030711	0	2	0	0	0	2
OG0030712	0	2	0	0	0	2
OG0030713	0	2	0	0	0	2
OG0030714	0	2	0	0	0	2
OG0030715	0	2	0	0	0	2
OG0030716	0	2	0	0	0	2
OG0030717	0	2	0	0	0	2
OG0030718	0	2	0	0	0	2
OG0030719	0	2	0	0	0	2
OG0030720	0	2	0	0	0	2
OG0030721	0	2	0	0	0	2
OG0030722	0	2	0	0	0	2
OG0030723	0	2	0	0	0	2
OG0030724	0	2	0	0	0	2
OG0030725	0	2	0	0	0	2
OG0030726	0	2	0	0	0	2
OG0030727	0	2	0	0	0	2
OG0030728	0	2	0	0	0	2
OG0030729	0	2	0	0	0	2
OG0030730	0	2	0	0	0	2
OG0030731	0	2	0	0	0	2
OG0030732	0	2	0	0	0	2
OG0030733	0	2	0	0	0	2
OG0030734	0	2	0	0	0	2
OG0030735	0	2	0	0	0	2
OG0030736	0	2	0	0	0	2
OG0030737	0	2	0	0	0	2
OG0030738	0	2	0	0	0	2
OG0030739	0	2	0	0	0	2
OG0030740	0	2	0	0	0	2
OG0030741	0	2	0	0	0	2
OG0030742	0	2	0	0	0	2
OG0030743	0	2	0	0	0	2
OG0030744	0	2	0	0	0	2
OG0030745	0	1	1	0	0	2
OG0030746	0	2	0	0	0	2
OG0030747	0	2	0	0	0	2
OG0030748	0	2	0	0	0	2
OG0030749	0	2	0	0	0	2
OG0030750	0	2	0	0	0	2
OG0030751	0	2	0	0	0	2
OG0030752	0	2	0	0	0	2
OG0030753	0	2	0	0	0	2
OG0030754	0	2	0	0	0	2
OG0030755	0	2	0	0	0	2
OG0030756	0	2	0	0	0	2
OG0030757	0	2	0	0	0	2
OG0030758	0	2	0	0	0	2
OG0030759	0	2	0	0	0	2
OG0030760	0	2	0	0	0	2
OG0030761	0	2	0	0	0	2
OG0030762	0	2	0	0	0	2
OG0030763	0	2	0	0	0	2
OG0030764	0	2	0	0	0	2
OG0030765	0	2	0	0	0	2
OG0030766	0	2	0	0	0	2
OG0030767	0	2	0	0	0	2
OG0030768	0	2	0	0	0	2
OG0030769	0	2	0	0	0	2
OG0030770	0	2	0	0	0	2
OG0030771	0	2	0	0	0	2
OG0030772	0	2	0	0	0	2
OG0030773	0	2	0	0	0	2
OG0030774	0	2	0	0	0	2
OG0030775	0	2	0	0	0	2
OG0030776	0	2	0	0	0	2
OG0030777	0	2	0	0	0	2
OG0030778	0	2	0	0	0	2
OG0030779	0	2	0	0	0	2
OG0030780	0	2	0	0	0	2
OG0030781	0	2	0	0	0	2
OG0030782	0	2	0	0	0	2
OG0030783	0	2	0	0	0	2
OG0030784	0	2	0	0	0	2
OG0030785	0	2	0	0	0	2
OG0030786	0	2	0	0	0	2
OG0030787	0	2	0	0	0	2
OG0030788	0	2	0	0	0	2
OG0030789	0	2	0	0	0	2
OG0030790	0	2	0	0	0	2
OG0030791	0	2	0	0	0	2
OG0030792	0	2	0	0	0	2
OG0030793	0	2	0	0	0	2
OG0030794	0	2	0	0	0	2
OG0030795	0	2	0	0	0	2
OG0030796	0	2	0	0	0	2
OG0030797	0	2	0	0	0	2
OG0030798	0	2	0	0	0	2
OG0030799	0	2	0	0	0	2
OG0030800	0	2	0	0	0	2
OG0030801	0	2	0	0	0	2
OG0030802	0	2	0	0	0	2
OG0030803	0	2	0	0	0	2
OG0030804	0	2	0	0	0	2
OG0030805	0	2	0	0	0	2
OG0030806	0	2	0	0	0	2
OG0030807	0	2	0	0	0	2
OG0030808	0	2	0	0	0	2
OG0030809	0	2	0	0	0	2
OG0030810	0	2	0	0	0	2
OG0030811	0	2	0	0	0	2
OG0030812	0	2	0	0	0	2
OG0030813	0	2	0	0	0	2
OG0030814	0	2	0	0	0	2
OG0030815	0	2	0	0	0	2
OG0030816	0	2	0	0	0	2
OG0030817	0	2	0	0	0	2
OG0030818	0	2	0	0	0	2
OG0030819	0	2	0	0	0	2
OG0030820	0	1	0	0	1	2
OG0030821	0	2	0	0	0	2
OG0030822	0	2	0	0	0	2
OG0030823	0	2	0	0	0	2
OG0030824	0	2	0	0	0	2
OG0030825	0	2	0	0	0	2
OG0030826	0	2	0	0	0	2
OG0030827	0	2	0	0	0	2
OG0030828	0	2	0	0	0	2
OG0030829	0	2	0	0	0	2
OG0030830	0	1	1	0	0	2
OG0030831	0	2	0	0	0	2
OG0030832	0	2	0	0	0	2
OG0030833	0	2	0	0	0	2
OG0030834	0	2	0	0	0	2
OG0030835	0	2	0	0	0	2
OG0030836	0	2	0	0	0	2
OG0030837	0	2	0	0	0	2
OG0030838	0	2	0	0	0	2
OG0030839	0	2	0	0	0	2
OG0030840	0	2	0	0	0	2
OG0030841	0	2	0	0	0	2
OG0030842	0	2	0	0	0	2
OG0030843	0	2	0	0	0	2
OG0030844	0	2	0	0	0	2
OG0030845	0	2	0	0	0	2
OG0030846	0	2	0	0	0	2
OG0030847	0	2	0	0	0	2
OG0030848	0	2	0	0	0	2
OG0030849	0	2	0	0	0	2
OG0030850	0	2	0	0	0	2
OG0030851	0	2	0	0	0	2
OG0030852	0	2	0	0	0	2
OG0030853	0	2	0	0	0	2
OG0030854	0	2	0	0	0	2
OG0030855	0	2	0	0	0	2
OG0030856	0	2	0	0	0	2
OG0030857	0	2	0	0	0	2
OG0030858	0	2	0	0	0	2
OG0030859	0	2	0	0	0	2
OG0030860	0	2	0	0	0	2
OG0030861	0	2	0	0	0	2
OG0030862	0	2	0	0	0	2
OG0030863	0	2	0	0	0	2
OG0030864	0	2	0	0	0	2
OG0030865	0	2	0	0	0	2
OG0030866	0	2	0	0	0	2
OG0030867	0	2	0	0	0	2
OG0030868	0	2	0	0	0	2
OG0030869	0	2	0	0	0	2
OG0030870	0	2	0	0	0	2
OG0030871	0	2	0	0	0	2
OG0030872	0	2	0	0	0	2
OG0030873	0	2	0	0	0	2
OG0030874	0	2	0	0	0	2
OG0030875	0	2	0	0	0	2
OG0030876	0	2	0	0	0	2
OG0030877	0	2	0	0	0	2
OG0030878	0	2	0	0	0	2
OG0030879	0	2	0	0	0	2
OG0030880	0	2	0	0	0	2
OG0030881	0	2	0	0	0	2
OG0030882	0	2	0	0	0	2
OG0030883	0	2	0	0	0	2
OG0030884	0	2	0	0	0	2
OG0030885	0	2	0	0	0	2
OG0030886	0	2	0	0	0	2
OG0030887	0	2	0	0	0	2
OG0030888	0	2	0	0	0	2
OG0030889	0	2	0	0	0	2
OG0030890	0	2	0	0	0	2
OG0030891	0	2	0	0	0	2
OG0030892	0	2	0	0	0	2
OG0030893	0	2	0	0	0	2
OG0030894	0	2	0	0	0	2
OG0030895	0	2	0	0	0	2
OG0030896	0	2	0	0	0	2
OG0030897	0	2	0	0	0	2
OG0030898	0	2	0	0	0	2
OG0030899	0	2	0	0	0	2
OG0030900	0	2	0	0	0	2
OG0030901	0	2	0	0	0	2
OG0030902	0	2	0	0	0	2
OG0030903	0	2	0	0	0	2
OG0030904	0	2	0	0	0	2
OG0030905	0	1	1	0	0	2
OG0030906	0	2	0	0	0	2
OG0030907	0	2	0	0	0	2
OG0030908	0	2	0	0	0	2
OG0030909	0	2	0	0	0	2
OG0030910	0	2	0	0	0	2
OG0030911	0	2	0	0	0	2
OG0030912	0	2	0	0	0	2
OG0030913	0	2	0	0	0	2
OG0030914	0	2	0	0	0	2
OG0030915	0	2	0	0	0	2
OG0030916	0	2	0	0	0	2
OG0030917	0	2	0	0	0	2
OG0030918	0	2	0	0	0	2
OG0030919	0	2	0	0	0	2
OG0030920	0	2	0	0	0	2
OG0030921	0	2	0	0	0	2
OG0030922	0	2	0	0	0	2
OG0030923	0	2	0	0	0	2
OG0030924	0	2	0	0	0	2
OG0030925	0	2	0	0	0	2
OG0030926	0	2	0	0	0	2
OG0030927	0	2	0	0	0	2
OG0030928	0	2	0	0	0	2
OG0030929	0	1	1	0	0	2
OG0030930	0	2	0	0	0	2
OG0030931	0	2	0	0	0	2
OG0030932	0	2	0	0	0	2
OG0030933	0	2	0	0	0	2
OG0030934	0	2	0	0	0	2
OG0030935	0	2	0	0	0	2
OG0030936	0	2	0	0	0	2
OG0030937	0	2	0	0	0	2
OG0030938	0	2	0	0	0	2
OG0030939	0	2	0	0	0	2
OG0030940	0	1	1	0	0	2
OG0030941	0	2	0	0	0	2
OG0030942	0	2	0	0	0	2
OG0030943	0	2	0	0	0	2
OG0030944	0	2	0	0	0	2
OG0030945	0	2	0	0	0	2
OG0030946	0	2	0	0	0	2
OG0030947	0	2	0	0	0	2
OG0030948	0	2	0	0	0	2
OG0030949	0	2	0	0	0	2
OG0030950	0	2	0	0	0	2
OG0030951	0	2	0	0	0	2
OG0030952	0	2	0	0	0	2
OG0030953	0	2	0	0	0	2
OG0030954	0	2	0	0	0	2
OG0030955	0	2	0	0	0	2
OG0030956	0	2	0	0	0	2
OG0030957	0	2	0	0	0	2
OG0030958	0	2	0	0	0	2
OG0030959	0	2	0	0	0	2
OG0030960	0	2	0	0	0	2
OG0030961	0	2	0	0	0	2
OG0030962	0	2	0	0	0	2
OG0030963	0	2	0	0	0	2
OG0030964	0	2	0	0	0	2
OG0030965	0	2	0	0	0	2
OG0030966	0	2	0	0	0	2
OG0030967	0	2	0	0	0	2
OG0030968	0	2	0	0	0	2
OG0030969	0	2	0	0	0	2
OG0030970	0	2	0	0	0	2
OG0030971	0	2	0	0	0	2
OG0030972	0	2	0	0	0	2
OG0030973	0	2	0	0	0	2
OG0030974	0	2	0	0	0	2
OG0030975	0	2	0	0	0	2
OG0030976	0	2	0	0	0	2
OG0030977	0	2	0	0	0	2
OG0030978	0	2	0	0	0	2
OG0030979	0	2	0	0	0	2
OG0030980	0	2	0	0	0	2
OG0030981	0	2	0	0	0	2
OG0030982	0	2	0	0	0	2
OG0030983	0	2	0	0	0	2
OG0030984	0	2	0	0	0	2
OG0030985	0	2	0	0	0	2
OG0030986	0	2	0	0	0	2
OG0030987	0	2	0	0	0	2
OG0030988	0	2	0	0	0	2
OG0030989	0	2	0	0	0	2
OG0030990	0	2	0	0	0	2
OG0030991	0	2	0	0	0	2
OG0030992	0	2	0	0	0	2
OG0030993	0	1	1	0	0	2
OG0030994	0	2	0	0	0	2
OG0030995	0	2	0	0	0	2
OG0030996	0	2	0	0	0	2
OG0030997	0	2	0	0	0	2
OG0030998	0	2	0	0	0	2
OG0030999	0	2	0	0	0	2
OG0031000	0	2	0	0	0	2
OG0031001	0	2	0	0	0	2
OG0031002	0	1	0	0	1	2
OG0031003	0	1	1	0	0	2
OG0031004	0	2	0	0	0	2
OG0031005	0	2	0	0	0	2
OG0031006	0	2	0	0	0	2
OG0031007	0	2	0	0	0	2
OG0031008	0	2	0	0	0	2
OG0031009	0	2	0	0	0	2
OG0031010	0	2	0	0	0	2
OG0031011	0	2	0	0	0	2
OG0031012	0	2	0	0	0	2
OG0031013	0	2	0	0	0	2
OG0031014	0	2	0	0	0	2
OG0031015	0	2	0	0	0	2
OG0031016	0	2	0	0	0	2
OG0031017	0	2	0	0	0	2
OG0031018	0	2	0	0	0	2
OG0031019	0	2	0	0	0	2
OG0031020	0	2	0	0	0	2
OG0031021	0	2	0	0	0	2
OG0031022	0	2	0	0	0	2
OG0031023	0	2	0	0	0	2
OG0031024	0	2	0	0	0	2
OG0031025	0	2	0	0	0	2
OG0031026	0	2	0	0	0	2
OG0031027	0	2	0	0	0	2
OG0031028	0	2	0	0	0	2
OG0031029	0	2	0	0	0	2
OG0031030	0	2	0	0	0	2
OG0031031	0	2	0	0	0	2
OG0031032	0	2	0	0	0	2
OG0031033	0	2	0	0	0	2
OG0031034	0	2	0	0	0	2
OG0031035	0	2	0	0	0	2
OG0031036	0	2	0	0	0	2
OG0031037	0	2	0	0	0	2
OG0031038	0	2	0	0	0	2
OG0031039	0	2	0	0	0	2
OG0031040	0	2	0	0	0	2
OG0031041	0	2	0	0	0	2
OG0031042	0	2	0	0	0	2
OG0031043	0	2	0	0	0	2
OG0031044	0	1	1	0	0	2
OG0031045	0	2	0	0	0	2
OG0031046	0	2	0	0	0	2
OG0031047	0	2	0	0	0	2
OG0031048	0	2	0	0	0	2
OG0031049	0	2	0	0	0	2
OG0031050	0	2	0	0	0	2
OG0031051	0	2	0	0	0	2
OG0031052	0	2	0	0	0	2
OG0031053	0	2	0	0	0	2
OG0031054	0	2	0	0	0	2
OG0031055	0	2	0	0	0	2
OG0031056	0	2	0	0	0	2
OG0031057	0	2	0	0	0	2
OG0031058	0	2	0	0	0	2
OG0031059	0	2	0	0	0	2
OG0031060	0	1	0	1	0	2
OG0031061	0	2	0	0	0	2
OG0031062	0	2	0	0	0	2
OG0031063	0	2	0	0	0	2
OG0031064	0	2	0	0	0	2
OG0031065	0	2	0	0	0	2
OG0031066	0	2	0	0	0	2
OG0031067	0	2	0	0	0	2
OG0031068	0	2	0	0	0	2
OG0031069	0	2	0	0	0	2
OG0031070	0	2	0	0	0	2
OG0031071	0	1	1	0	0	2
OG0031072	0	2	0	0	0	2
OG0031073	0	2	0	0	0	2
OG0031074	0	2	0	0	0	2
OG0031075	0	1	0	1	0	2
OG0031076	0	2	0	0	0	2
OG0031077	0	2	0	0	0	2
OG0031078	0	2	0	0	0	2
OG0031079	0	2	0	0	0	2
OG0031080	0	1	1	0	0	2
OG0031081	0	2	0	0	0	2
OG0031082	0	2	0	0	0	2
OG0031083	0	2	0	0	0	2
OG0031084	0	2	0	0	0	2
OG0031085	0	2	0	0	0	2
OG0031086	0	2	0	0	0	2
OG0031087	0	2	0	0	0	2
OG0031088	0	2	0	0	0	2
OG0031089	0	2	0	0	0	2
OG0031090	0	1	0	0	1	2
OG0031091	0	2	0	0	0	2
OG0031092	0	2	0	0	0	2
OG0031093	0	2	0	0	0	2
OG0031094	0	2	0	0	0	2
OG0031095	0	2	0	0	0	2
OG0031096	0	2	0	0	0	2
OG0031097	0	2	0	0	0	2
OG0031098	0	2	0	0	0	2
OG0031099	0	2	0	0	0	2
OG0031100	0	2	0	0	0	2
OG0031101	0	2	0	0	0	2
OG0031102	0	2	0	0	0	2
OG0031103	0	2	0	0	0	2
OG0031104	0	2	0	0	0	2
OG0031105	0	2	0	0	0	2
OG0031106	0	1	1	0	0	2
OG0031107	0	2	0	0	0	2
OG0031108	0	2	0	0	0	2
OG0031109	0	2	0	0	0	2
OG0031110	0	2	0	0	0	2
OG0031111	0	2	0	0	0	2
OG0031112	0	2	0	0	0	2
OG0031113	0	2	0	0	0	2
OG0031114	0	2	0	0	0	2
OG0031115	0	2	0	0	0	2
OG0031116	0	2	0	0	0	2
OG0031117	0	2	0	0	0	2
OG0031118	0	2	0	0	0	2
OG0031119	0	2	0	0	0	2
OG0031120	0	2	0	0	0	2
OG0031121	0	2	0	0	0	2
OG0031122	0	2	0	0	0	2
OG0031123	0	2	0	0	0	2
OG0031124	0	2	0	0	0	2
OG0031125	0	2	0	0	0	2
OG0031126	0	2	0	0	0	2
OG0031127	0	2	0	0	0	2
OG0031128	0	1	1	0	0	2
OG0031129	0	2	0	0	0	2
OG0031130	0	2	0	0	0	2
OG0031131	0	2	0	0	0	2
OG0031132	0	2	0	0	0	2
OG0031133	0	2	0	0	0	2
OG0031134	0	2	0	0	0	2
OG0031135	0	2	0	0	0	2
OG0031136	0	2	0	0	0	2
OG0031137	0	2	0	0	0	2
OG0031138	0	2	0	0	0	2
OG0031139	0	2	0	0	0	2
OG0031140	0	2	0	0	0	2
OG0031141	0	2	0	0	0	2
OG0031142	0	2	0	0	0	2
OG0031143	0	2	0	0	0	2
OG0031144	0	2	0	0	0	2
OG0031145	0	2	0	0	0	2
OG0031146	0	2	0	0	0	2
OG0031147	0	2	0	0	0	2
OG0031148	0	2	0	0	0	2
OG0031149	0	2	0	0	0	2
OG0031150	0	2	0	0	0	2
OG0031151	0	1	1	0	0	2
OG0031152	0	2	0	0	0	2
OG0031153	0	2	0	0	0	2
OG0031154	0	2	0	0	0	2
OG0031155	0	2	0	0	0	2
OG0031156	0	2	0	0	0	2
OG0031157	0	2	0	0	0	2
OG0031158	0	2	0	0	0	2
OG0031159	0	2	0	0	0	2
OG0031160	0	2	0	0	0	2
OG0031161	0	2	0	0	0	2
OG0031162	0	2	0	0	0	2
OG0031163	0	2	0	0	0	2
OG0031164	0	2	0	0	0	2
OG0031165	0	2	0	0	0	2
OG0031166	0	2	0	0	0	2
OG0031167	0	2	0	0	0	2
OG0031168	0	2	0	0	0	2
OG0031169	0	2	0	0	0	2
OG0031170	0	2	0	0	0	2
OG0031171	0	2	0	0	0	2
OG0031172	0	2	0	0	0	2
OG0031173	0	2	0	0	0	2
OG0031174	0	2	0	0	0	2
OG0031175	0	2	0	0	0	2
OG0031176	0	2	0	0	0	2
OG0031177	0	2	0	0	0	2
OG0031178	0	2	0	0	0	2
OG0031179	0	2	0	0	0	2
OG0031180	0	2	0	0	0	2
OG0031181	0	2	0	0	0	2
OG0031182	0	2	0	0	0	2
OG0031183	0	2	0	0	0	2
OG0031184	0	2	0	0	0	2
OG0031185	0	2	0	0	0	2
OG0031186	0	2	0	0	0	2
OG0031187	0	2	0	0	0	2
OG0031188	0	2	0	0	0	2
OG0031189	0	2	0	0	0	2
OG0031190	0	2	0	0	0	2
OG0031191	0	2	0	0	0	2
OG0031192	0	2	0	0	0	2
OG0031193	0	2	0	0	0	2
OG0031194	0	2	0	0	0	2
OG0031195	0	2	0	0	0	2
OG0031196	0	2	0	0	0	2
OG0031197	0	2	0	0	0	2
OG0031198	0	2	0	0	0	2
OG0031199	0	2	0	0	0	2
OG0031200	0	2	0	0	0	2
OG0031201	0	2	0	0	0	2
OG0031202	0	2	0	0	0	2
OG0031203	0	2	0	0	0	2
OG0031204	0	2	0	0	0	2
OG0031205	0	2	0	0	0	2
OG0031206	0	1	1	0	0	2
OG0031207	0	2	0	0	0	2
OG0031208	0	1	0	1	0	2
OG0031209	0	2	0	0	0	2
OG0031210	0	2	0	0	0	2
OG0031211	0	2	0	0	0	2
OG0031212	0	2	0	0	0	2
OG0031213	0	2	0	0	0	2
OG0031214	0	2	0	0	0	2
OG0031215	0	2	0	0	0	2
OG0031216	0	2	0	0	0	2
OG0031217	0	2	0	0	0	2
OG0031218	0	2	0	0	0	2
OG0031219	0	2	0	0	0	2
OG0031220	0	2	0	0	0	2
OG0031221	0	2	0	0	0	2
OG0031222	0	2	0	0	0	2
OG0031223	0	2	0	0	0	2
OG0031224	0	2	0	0	0	2
OG0031225	0	2	0	0	0	2
OG0031226	0	2	0	0	0	2
OG0031227	0	2	0	0	0	2
OG0031228	0	2	0	0	0	2
OG0031229	0	2	0	0	0	2
OG0031230	0	2	0	0	0	2
OG0031231	0	2	0	0	0	2
OG0031232	0	2	0	0	0	2
OG0031233	0	2	0	0	0	2
OG0031234	0	2	0	0	0	2
OG0031235	0	2	0	0	0	2
OG0031236	0	2	0	0	0	2
OG0031237	0	2	0	0	0	2
OG0031238	0	2	0	0	0	2
OG0031239	0	2	0	0	0	2
OG0031240	0	2	0	0	0	2
OG0031241	0	2	0	0	0	2
OG0031242	0	2	0	0	0	2
OG0031243	0	2	0	0	0	2
OG0031244	0	2	0	0	0	2
OG0031245	0	2	0	0	0	2
OG0031246	0	2	0	0	0	2
OG0031247	0	2	0	0	0	2
OG0031248	0	2	0	0	0	2
OG0031249	0	2	0	0	0	2
OG0031250	0	2	0	0	0	2
OG0031251	0	2	0	0	0	2
OG0031252	0	1	0	1	0	2
OG0031253	0	2	0	0	0	2
OG0031254	0	2	0	0	0	2
OG0031255	0	2	0	0	0	2
OG0031256	0	2	0	0	0	2
OG0031257	0	2	0	0	0	2
OG0031258	0	2	0	0	0	2
OG0031259	0	2	0	0	0	2
OG0031260	0	2	0	0	0	2
OG0031261	0	2	0	0	0	2
OG0031262	0	2	0	0	0	2
OG0031263	0	2	0	0	0	2
OG0031264	0	2	0	0	0	2
OG0031265	0	2	0	0	0	2
OG0031266	0	2	0	0	0	2
OG0031267	0	2	0	0	0	2
OG0031268	0	2	0	0	0	2
OG0031269	0	2	0	0	0	2
OG0031270	0	2	0	0	0	2
OG0031271	0	2	0	0	0	2
OG0031272	0	1	1	0	0	2
OG0031273	0	2	0	0	0	2
OG0031274	0	2	0	0	0	2
OG0031275	0	2	0	0	0	2
OG0031276	0	2	0	0	0	2
OG0031277	0	2	0	0	0	2
OG0031278	0	2	0	0	0	2
OG0031279	0	2	0	0	0	2
OG0031280	0	2	0	0	0	2
OG0031281	0	2	0	0	0	2
OG0031282	0	2	0	0	0	2
OG0031283	0	2	0	0	0	2
OG0031284	0	2	0	0	0	2
OG0031285	0	2	0	0	0	2
OG0031286	0	2	0	0	0	2
OG0031287	0	2	0	0	0	2
OG0031288	0	2	0	0	0	2
OG0031289	0	2	0	0	0	2
OG0031290	0	2	0	0	0	2
OG0031291	0	2	0	0	0	2
OG0031292	0	2	0	0	0	2
OG0031293	0	2	0	0	0	2
OG0031294	0	2	0	0	0	2
OG0031295	0	2	0	0	0	2
OG0031296	0	2	0	0	0	2
OG0031297	0	2	0	0	0	2
OG0031298	0	1	1	0	0	2
OG0031299	0	2	0	0	0	2
OG0031300	0	2	0	0	0	2
OG0031301	0	2	0	0	0	2
OG0031302	0	2	0	0	0	2
OG0031303	0	2	0	0	0	2
OG0031304	0	2	0	0	0	2
OG0031305	0	2	0	0	0	2
OG0031306	0	2	0	0	0	2
OG0031307	0	2	0	0	0	2
OG0031308	0	2	0	0	0	2
OG0031309	0	2	0	0	0	2
OG0031310	0	2	0	0	0	2
OG0031311	0	2	0	0	0	2
OG0031312	0	2	0	0	0	2
OG0031313	0	2	0	0	0	2
OG0031314	0	2	0	0	0	2
OG0031315	0	2	0	0	0	2
OG0031316	0	2	0	0	0	2
OG0031317	0	2	0	0	0	2
OG0031318	0	2	0	0	0	2
OG0031319	0	2	0	0	0	2
OG0031320	0	2	0	0	0	2
OG0031321	0	2	0	0	0	2
OG0031322	0	2	0	0	0	2
OG0031323	0	2	0	0	0	2
OG0031324	0	2	0	0	0	2
OG0031325	0	2	0	0	0	2
OG0031326	0	2	0	0	0	2
OG0031327	0	2	0	0	0	2
OG0031328	0	2	0	0	0	2
OG0031329	0	2	0	0	0	2
OG0031330	0	2	0	0	0	2
OG0031331	0	2	0	0	0	2
OG0031332	0	2	0	0	0	2
OG0031333	0	2	0	0	0	2
OG0031334	0	2	0	0	0	2
OG0031335	0	2	0	0	0	2
OG0031336	0	2	0	0	0	2
OG0031337	0	2	0	0	0	2
OG0031338	0	2	0	0	0	2
OG0031339	0	2	0	0	0	2
OG0031340	0	2	0	0	0	2
OG0031341	0	2	0	0	0	2
OG0031342	0	2	0	0	0	2
OG0031343	0	2	0	0	0	2
OG0031344	0	2	0	0	0	2
OG0031345	0	2	0	0	0	2
OG0031346	0	2	0	0	0	2
OG0031347	0	2	0	0	0	2
OG0031348	0	2	0	0	0	2
OG0031349	0	2	0	0	0	2
OG0031350	0	2	0	0	0	2
OG0031351	0	2	0	0	0	2
OG0031352	0	2	0	0	0	2
OG0031353	0	2	0	0	0	2
OG0031354	0	2	0	0	0	2
OG0031355	0	2	0	0	0	2
OG0031356	0	2	0	0	0	2
OG0031357	0	2	0	0	0	2
OG0031358	0	2	0	0	0	2
OG0031359	0	2	0	0	0	2
OG0031360	0	2	0	0	0	2
OG0031361	0	1	1	0	0	2
OG0031362	0	2	0	0	0	2
OG0031363	0	2	0	0	0	2
OG0031364	0	2	0	0	0	2
OG0031365	0	2	0	0	0	2
OG0031366	0	2	0	0	0	2
OG0031367	0	2	0	0	0	2
OG0031368	0	2	0	0	0	2
OG0031369	0	2	0	0	0	2
OG0031370	0	2	0	0	0	2
OG0031371	0	2	0	0	0	2
OG0031372	0	2	0	0	0	2
OG0031373	0	2	0	0	0	2
OG0031374	0	2	0	0	0	2
OG0031375	0	2	0	0	0	2
OG0031376	0	2	0	0	0	2
OG0031377	0	1	1	0	0	2
OG0031378	0	2	0	0	0	2
OG0031379	0	2	0	0	0	2
OG0031380	0	2	0	0	0	2
OG0031381	0	2	0	0	0	2
OG0031382	0	2	0	0	0	2
OG0031383	0	2	0	0	0	2
OG0031384	0	1	0	0	1	2
OG0031385	0	2	0	0	0	2
OG0031386	0	2	0	0	0	2
OG0031387	0	2	0	0	0	2
OG0031388	0	2	0	0	0	2
OG0031389	0	1	0	0	1	2
OG0031390	0	2	0	0	0	2
OG0031391	0	2	0	0	0	2
OG0031392	0	2	0	0	0	2
OG0031393	0	2	0	0	0	2
OG0031394	0	2	0	0	0	2
OG0031395	0	1	1	0	0	2
OG0031396	0	2	0	0	0	2
OG0031397	0	2	0	0	0	2
OG0031398	0	2	0	0	0	2
OG0031399	0	2	0	0	0	2
OG0031400	0	1	0	1	0	2
OG0031401	0	2	0	0	0	2
OG0031402	0	2	0	0	0	2
OG0031403	0	2	0	0	0	2
OG0031404	0	2	0	0	0	2
OG0031405	0	2	0	0	0	2
OG0031406	0	2	0	0	0	2
OG0031407	0	2	0	0	0	2
OG0031408	0	2	0	0	0	2
OG0031409	0	2	0	0	0	2
OG0031410	0	2	0	0	0	2
OG0031411	0	2	0	0	0	2
OG0031412	0	2	0	0	0	2
OG0031413	0	2	0	0	0	2
OG0031414	0	2	0	0	0	2
OG0031415	0	2	0	0	0	2
OG0031416	0	2	0	0	0	2
OG0031417	0	2	0	0	0	2
OG0031418	0	2	0	0	0	2
OG0031419	0	2	0	0	0	2
OG0031420	0	2	0	0	0	2
OG0031421	0	2	0	0	0	2
OG0031422	0	2	0	0	0	2
OG0031423	0	2	0	0	0	2
OG0031424	0	2	0	0	0	2
OG0031425	0	2	0	0	0	2
OG0031426	0	2	0	0	0	2
OG0031427	0	2	0	0	0	2
OG0031428	0	2	0	0	0	2
OG0031429	0	2	0	0	0	2
OG0031430	0	2	0	0	0	2
OG0031431	0	2	0	0	0	2
OG0031432	0	2	0	0	0	2
OG0031433	0	2	0	0	0	2
OG0031434	0	2	0	0	0	2
OG0031435	0	2	0	0	0	2
OG0031436	0	2	0	0	0	2
OG0031437	0	2	0	0	0	2
OG0031438	0	2	0	0	0	2
OG0031439	0	2	0	0	0	2
OG0031440	0	2	0	0	0	2
OG0031441	0	2	0	0	0	2
OG0031442	0	1	1	0	0	2
OG0031443	0	2	0	0	0	2
OG0031444	0	1	1	0	0	2
OG0031445	0	2	0	0	0	2
OG0031446	0	2	0	0	0	2
OG0031447	0	2	0	0	0	2
OG0031448	0	2	0	0	0	2
OG0031449	0	2	0	0	0	2
OG0031450	0	2	0	0	0	2
OG0031451	0	1	1	0	0	2
OG0031452	0	2	0	0	0	2
OG0031453	0	2	0	0	0	2
OG0031454	0	2	0	0	0	2
OG0031455	0	2	0	0	0	2
OG0031456	0	2	0	0	0	2
OG0031457	0	2	0	0	0	2
OG0031458	0	2	0	0	0	2
OG0031459	0	2	0	0	0	2
OG0031460	0	2	0	0	0	2
OG0031461	0	2	0	0	0	2
OG0031462	0	2	0	0	0	2
OG0031463	0	2	0	0	0	2
OG0031464	0	2	0	0	0	2
OG0031465	0	2	0	0	0	2
OG0031466	0	2	0	0	0	2
OG0031467	0	2	0	0	0	2
OG0031468	0	2	0	0	0	2
OG0031469	0	2	0	0	0	2
OG0031470	0	2	0	0	0	2
OG0031471	0	2	0	0	0	2
OG0031472	0	2	0	0	0	2
OG0031473	0	2	0	0	0	2
OG0031474	0	2	0	0	0	2
OG0031475	0	2	0	0	0	2
OG0031476	0	2	0	0	0	2
OG0031477	0	2	0	0	0	2
OG0031478	0	2	0	0	0	2
OG0031479	0	2	0	0	0	2
OG0031480	0	2	0	0	0	2
OG0031481	0	2	0	0	0	2
OG0031482	0	2	0	0	0	2
OG0031483	0	2	0	0	0	2
OG0031484	0	2	0	0	0	2
OG0031485	0	2	0	0	0	2
OG0031486	0	1	1	0	0	2
OG0031487	0	2	0	0	0	2
OG0031488	0	2	0	0	0	2
OG0031489	0	2	0	0	0	2
OG0031490	0	2	0	0	0	2
OG0031491	0	2	0	0	0	2
OG0031492	0	2	0	0	0	2
OG0031493	0	2	0	0	0	2
OG0031494	0	2	0	0	0	2
OG0031495	0	2	0	0	0	2
OG0031496	0	2	0	0	0	2
OG0031497	0	2	0	0	0	2
OG0031498	0	2	0	0	0	2
OG0031499	0	2	0	0	0	2
OG0031500	0	2	0	0	0	2
OG0031501	0	2	0	0	0	2
OG0031502	0	2	0	0	0	2
OG0031503	0	2	0	0	0	2
OG0031504	0	2	0	0	0	2
OG0031505	0	2	0	0	0	2
OG0031506	0	2	0	0	0	2
OG0031507	0	2	0	0	0	2
OG0031508	0	2	0	0	0	2
OG0031509	0	2	0	0	0	2
OG0031510	0	2	0	0	0	2
OG0031511	0	2	0	0	0	2
OG0031512	0	2	0	0	0	2
OG0031513	0	2	0	0	0	2
OG0031514	0	2	0	0	0	2
OG0031515	0	2	0	0	0	2
OG0031516	0	2	0	0	0	2
OG0031517	0	2	0	0	0	2
OG0031518	0	2	0	0	0	2
OG0031519	0	2	0	0	0	2
OG0031520	0	2	0	0	0	2
OG0031521	0	2	0	0	0	2
OG0031522	0	2	0	0	0	2
OG0031523	0	2	0	0	0	2
OG0031524	0	2	0	0	0	2
OG0031525	0	2	0	0	0	2
OG0031526	0	2	0	0	0	2
OG0031527	0	2	0	0	0	2
OG0031528	0	2	0	0	0	2
OG0031529	0	2	0	0	0	2
OG0031530	0	1	0	0	1	2
OG0031531	0	2	0	0	0	2
OG0031532	0	2	0	0	0	2
OG0031533	0	2	0	0	0	2
OG0031534	0	2	0	0	0	2
OG0031535	0	2	0	0	0	2
OG0031536	0	2	0	0	0	2
OG0031537	0	2	0	0	0	2
OG0031538	0	2	0	0	0	2
OG0031539	0	2	0	0	0	2
OG0031540	0	2	0	0	0	2
OG0031541	0	2	0	0	0	2
OG0031542	0	2	0	0	0	2
OG0031543	0	2	0	0	0	2
OG0031544	0	2	0	0	0	2
OG0031545	0	1	1	0	0	2
OG0031546	0	2	0	0	0	2
OG0031547	0	2	0	0	0	2
OG0031548	0	2	0	0	0	2
OG0031549	0	2	0	0	0	2
OG0031550	0	2	0	0	0	2
OG0031551	0	2	0	0	0	2
OG0031552	0	2	0	0	0	2
OG0031553	0	2	0	0	0	2
OG0031554	0	2	0	0	0	2
OG0031555	0	2	0	0	0	2
OG0031556	0	2	0	0	0	2
OG0031557	0	2	0	0	0	2
OG0031558	0	2	0	0	0	2
OG0031559	0	2	0	0	0	2
OG0031560	0	2	0	0	0	2
OG0031561	0	2	0	0	0	2
OG0031562	0	2	0	0	0	2
OG0031563	0	2	0	0	0	2
OG0031564	0	2	0	0	0	2
OG0031565	0	2	0	0	0	2
OG0031566	0	2	0	0	0	2
OG0031567	0	2	0	0	0	2
OG0031568	0	2	0	0	0	2
OG0031569	0	2	0	0	0	2
OG0031570	0	2	0	0	0	2
OG0031571	0	2	0	0	0	2
OG0031572	0	2	0	0	0	2
OG0031573	0	2	0	0	0	2
OG0031574	0	2	0	0	0	2
OG0031575	0	2	0	0	0	2
OG0031576	0	2	0	0	0	2
OG0031577	0	2	0	0	0	2
OG0031578	0	2	0	0	0	2
OG0031579	0	2	0	0	0	2
OG0031580	0	2	0	0	0	2
OG0031581	0	2	0	0	0	2
OG0031582	0	1	0	0	1	2
OG0031583	0	2	0	0	0	2
OG0031584	0	2	0	0	0	2
OG0031585	0	2	0	0	0	2
OG0031586	0	2	0	0	0	2
OG0031587	0	2	0	0	0	2
OG0031588	0	2	0	0	0	2
OG0031589	0	2	0	0	0	2
OG0031590	0	2	0	0	0	2
OG0031591	0	2	0	0	0	2
OG0031592	0	1	1	0	0	2
OG0031593	0	2	0	0	0	2
OG0031594	0	2	0	0	0	2
OG0031595	0	2	0	0	0	2
OG0031596	0	2	0	0	0	2
OG0031597	0	2	0	0	0	2
OG0031598	0	2	0	0	0	2
OG0031599	0	2	0	0	0	2
OG0031600	0	2	0	0	0	2
OG0031601	0	2	0	0	0	2
OG0031602	0	2	0	0	0	2
OG0031603	0	2	0	0	0	2
OG0031604	0	2	0	0	0	2
OG0031605	0	2	0	0	0	2
OG0031606	0	2	0	0	0	2
OG0031607	0	2	0	0	0	2
OG0031608	0	2	0	0	0	2
OG0031609	0	2	0	0	0	2
OG0031610	0	2	0	0	0	2
OG0031611	0	2	0	0	0	2
OG0031612	0	2	0	0	0	2
OG0031613	0	2	0	0	0	2
OG0031614	0	1	1	0	0	2
OG0031615	0	2	0	0	0	2
OG0031616	0	2	0	0	0	2
OG0031617	0	2	0	0	0	2
OG0031618	0	2	0	0	0	2
OG0031619	0	2	0	0	0	2
OG0031620	0	2	0	0	0	2
OG0031621	0	1	1	0	0	2
OG0031622	0	2	0	0	0	2
OG0031623	0	2	0	0	0	2
OG0031624	0	2	0	0	0	2
OG0031625	0	2	0	0	0	2
OG0031626	0	2	0	0	0	2
OG0031627	0	2	0	0	0	2
OG0031628	0	2	0	0	0	2
OG0031629	0	2	0	0	0	2
OG0031630	0	2	0	0	0	2
OG0031631	0	1	1	0	0	2
OG0031632	0	2	0	0	0	2
OG0031633	0	2	0	0	0	2
OG0031634	0	2	0	0	0	2
OG0031635	0	2	0	0	0	2
OG0031636	0	2	0	0	0	2
OG0031637	0	2	0	0	0	2
OG0031638	0	2	0	0	0	2
OG0031639	0	2	0	0	0	2
OG0031640	0	2	0	0	0	2
OG0031641	0	2	0	0	0	2
OG0031642	0	2	0	0	0	2
OG0031643	0	2	0	0	0	2
OG0031644	0	2	0	0	0	2
OG0031645	0	2	0	0	0	2
OG0031646	0	2	0	0	0	2
OG0031647	0	2	0	0	0	2
OG0031648	0	2	0	0	0	2
OG0031649	0	2	0	0	0	2
OG0031650	0	2	0	0	0	2
OG0031651	0	2	0	0	0	2
OG0031652	0	2	0	0	0	2
OG0031653	0	2	0	0	0	2
OG0031654	0	2	0	0	0	2
OG0031655	0	2	0	0	0	2
OG0031656	0	2	0	0	0	2
OG0031657	0	2	0	0	0	2
OG0031658	0	2	0	0	0	2
OG0031659	0	2	0	0	0	2
OG0031660	0	2	0	0	0	2
OG0031661	0	2	0	0	0	2
OG0031662	0	2	0	0	0	2
OG0031663	0	2	0	0	0	2
OG0031664	0	2	0	0	0	2
OG0031665	0	2	0	0	0	2
OG0031666	0	1	1	0	0	2
OG0031667	0	1	1	0	0	2
OG0031668	0	2	0	0	0	2
OG0031669	0	2	0	0	0	2
OG0031670	0	2	0	0	0	2
OG0031671	0	2	0	0	0	2
OG0031672	0	2	0	0	0	2
OG0031673	0	2	0	0	0	2
OG0031674	0	2	0	0	0	2
OG0031675	0	2	0	0	0	2
OG0031676	0	2	0	0	0	2
OG0031677	0	2	0	0	0	2
OG0031678	0	2	0	0	0	2
OG0031679	0	2	0	0	0	2
OG0031680	0	2	0	0	0	2
OG0031681	0	2	0	0	0	2
OG0031682	0	2	0	0	0	2
OG0031683	0	2	0	0	0	2
OG0031684	0	2	0	0	0	2
OG0031685	0	2	0	0	0	2
OG0031686	0	1	0	1	0	2
OG0031687	0	2	0	0	0	2
OG0031688	0	2	0	0	0	2
OG0031689	0	2	0	0	0	2
OG0031690	0	2	0	0	0	2
OG0031691	0	2	0	0	0	2
OG0031692	0	2	0	0	0	2
OG0031693	0	2	0	0	0	2
OG0031694	0	2	0	0	0	2
OG0031695	0	2	0	0	0	2
OG0031696	0	2	0	0	0	2
OG0031697	0	2	0	0	0	2
OG0031698	0	1	1	0	0	2
OG0031699	0	2	0	0	0	2
OG0031700	0	2	0	0	0	2
OG0031701	0	2	0	0	0	2
OG0031702	0	2	0	0	0	2
OG0031703	0	2	0	0	0	2
OG0031704	0	2	0	0	0	2
OG0031705	0	2	0	0	0	2
OG0031706	0	2	0	0	0	2
OG0031707	0	2	0	0	0	2
OG0031708	0	2	0	0	0	2
OG0031709	0	2	0	0	0	2
OG0031710	0	2	0	0	0	2
OG0031711	0	2	0	0	0	2
OG0031712	0	2	0	0	0	2
OG0031713	0	2	0	0	0	2
OG0031714	0	2	0	0	0	2
OG0031715	0	2	0	0	0	2
OG0031716	0	2	0	0	0	2
OG0031717	0	2	0	0	0	2
OG0031718	0	2	0	0	0	2
OG0031719	0	1	1	0	0	2
OG0031720	0	2	0	0	0	2
OG0031721	0	2	0	0	0	2
OG0031722	0	2	0	0	0	2
OG0031723	0	2	0	0	0	2
OG0031724	0	2	0	0	0	2
OG0031725	0	2	0	0	0	2
OG0031726	0	2	0	0	0	2
OG0031727	0	2	0	0	0	2
OG0031728	0	1	1	0	0	2
OG0031729	0	2	0	0	0	2
OG0031730	0	2	0	0	0	2
OG0031731	0	2	0	0	0	2
OG0031732	0	2	0	0	0	2
OG0031733	0	2	0	0	0	2
OG0031734	0	2	0	0	0	2
OG0031735	0	2	0	0	0	2
OG0031736	0	2	0	0	0	2
OG0031737	0	2	0	0	0	2
OG0031738	0	2	0	0	0	2
OG0031739	0	2	0	0	0	2
OG0031740	0	2	0	0	0	2
OG0031741	0	2	0	0	0	2
OG0031742	0	2	0	0	0	2
OG0031743	0	2	0	0	0	2
OG0031744	0	2	0	0	0	2
OG0031745	0	2	0	0	0	2
OG0031746	0	2	0	0	0	2
OG0031747	0	2	0	0	0	2
OG0031748	0	2	0	0	0	2
OG0031749	0	2	0	0	0	2
OG0031750	0	2	0	0	0	2
OG0031751	0	2	0	0	0	2
OG0031752	0	2	0	0	0	2
OG0031753	0	2	0	0	0	2
OG0031754	0	2	0	0	0	2
OG0031755	0	2	0	0	0	2
OG0031756	0	2	0	0	0	2
OG0031757	0	2	0	0	0	2
OG0031758	0	1	0	1	0	2
OG0031759	0	2	0	0	0	2
OG0031760	0	2	0	0	0	2
OG0031761	0	2	0	0	0	2
OG0031762	0	2	0	0	0	2
OG0031763	0	2	0	0	0	2
OG0031764	0	2	0	0	0	2
OG0031765	0	2	0	0	0	2
OG0031766	0	2	0	0	0	2
OG0031767	0	2	0	0	0	2
OG0031768	0	2	0	0	0	2
OG0031769	0	2	0	0	0	2
OG0031770	0	2	0	0	0	2
OG0031771	0	2	0	0	0	2
OG0031772	0	2	0	0	0	2
OG0031773	0	2	0	0	0	2
OG0031774	0	2	0	0	0	2
OG0031775	0	2	0	0	0	2
OG0031776	0	1	1	0	0	2
OG0031777	0	1	1	0	0	2
OG0031778	0	1	0	0	1	2
OG0031779	0	1	1	0	0	2
OG0031780	0	2	0	0	0	2
OG0031781	0	2	0	0	0	2
OG0031782	0	2	0	0	0	2
OG0031783	0	2	0	0	0	2
OG0031784	0	2	0	0	0	2
OG0031785	0	2	0	0	0	2
OG0031786	0	2	0	0	0	2
OG0031787	0	2	0	0	0	2
OG0031788	0	2	0	0	0	2
OG0031789	0	1	1	0	0	2
OG0031790	0	2	0	0	0	2
OG0031791	0	2	0	0	0	2
OG0031792	0	2	0	0	0	2
OG0031793	0	2	0	0	0	2
OG0031794	0	2	0	0	0	2
OG0031795	0	2	0	0	0	2
OG0031796	0	2	0	0	0	2
OG0031797	0	2	0	0	0	2
OG0031798	0	2	0	0	0	2
OG0031799	0	2	0	0	0	2
OG0031800	0	1	0	0	1	2
OG0031801	0	2	0	0	0	2
OG0031802	0	1	0	0	1	2
OG0031803	0	2	0	0	0	2
OG0031804	0	2	0	0	0	2
OG0031805	0	1	0	1	0	2
OG0031806	0	2	0	0	0	2
OG0031807	0	2	0	0	0	2
OG0031808	0	2	0	0	0	2
OG0031809	0	2	0	0	0	2
OG0031810	0	2	0	0	0	2
OG0031811	0	2	0	0	0	2
OG0031812	0	2	0	0	0	2
OG0031813	0	2	0	0	0	2
OG0031814	0	2	0	0	0	2
OG0031815	0	2	0	0	0	2
OG0031816	0	2	0	0	0	2
OG0031817	0	2	0	0	0	2
OG0031818	0	2	0	0	0	2
OG0031819	0	2	0	0	0	2
OG0031820	0	2	0	0	0	2
OG0031821	0	2	0	0	0	2
OG0031822	0	2	0	0	0	2
OG0031823	0	2	0	0	0	2
OG0031824	0	2	0	0	0	2
OG0031825	0	2	0	0	0	2
OG0031826	0	2	0	0	0	2
OG0031827	0	1	1	0	0	2
OG0031828	0	1	1	0	0	2
OG0031829	0	2	0	0	0	2
OG0031830	0	1	0	0	1	2
OG0031831	0	2	0	0	0	2
OG0031832	0	2	0	0	0	2
OG0031833	0	2	0	0	0	2
OG0031834	0	2	0	0	0	2
OG0031835	0	2	0	0	0	2
OG0031836	0	2	0	0	0	2
OG0031837	0	1	1	0	0	2
OG0031838	0	2	0	0	0	2
OG0031839	0	2	0	0	0	2
OG0031840	0	2	0	0	0	2
OG0031841	0	2	0	0	0	2
OG0031842	0	2	0	0	0	2
OG0031843	0	1	1	0	0	2
OG0031844	0	2	0	0	0	2
OG0031845	0	2	0	0	0	2
OG0031846	0	2	0	0	0	2
OG0031847	0	2	0	0	0	2
OG0031848	0	2	0	0	0	2
OG0031849	0	2	0	0	0	2
OG0031850	0	2	0	0	0	2
OG0031851	0	2	0	0	0	2
OG0031852	0	2	0	0	0	2
OG0031853	0	2	0	0	0	2
OG0031854	0	2	0	0	0	2
OG0031855	0	2	0	0	0	2
OG0031856	0	2	0	0	0	2
OG0031857	0	2	0	0	0	2
OG0031858	0	2	0	0	0	2
OG0031859	0	1	1	0	0	2
OG0031860	0	2	0	0	0	2
OG0031861	0	2	0	0	0	2
OG0031862	0	2	0	0	0	2
OG0031863	0	2	0	0	0	2
OG0031864	0	2	0	0	0	2
OG0031865	0	1	0	0	1	2
OG0031866	0	2	0	0	0	2
OG0031867	0	2	0	0	0	2
OG0031868	0	1	1	0	0	2
OG0031869	0	2	0	0	0	2
OG0031870	0	2	0	0	0	2
OG0031871	0	2	0	0	0	2
OG0031872	0	2	0	0	0	2
OG0031873	0	2	0	0	0	2
OG0031874	0	2	0	0	0	2
OG0031875	0	2	0	0	0	2
OG0031876	0	2	0	0	0	2
OG0031877	0	2	0	0	0	2
OG0031878	0	2	0	0	0	2
OG0031879	0	2	0	0	0	2
OG0031880	0	2	0	0	0	2
OG0031881	0	2	0	0	0	2
OG0031882	0	2	0	0	0	2
OG0031883	0	2	0	0	0	2
OG0031884	0	2	0	0	0	2
OG0031885	0	2	0	0	0	2
OG0031886	0	2	0	0	0	2
OG0031887	0	2	0	0	0	2
OG0031888	0	2	0	0	0	2
OG0031889	0	2	0	0	0	2
OG0031890	0	2	0	0	0	2
OG0031891	0	2	0	0	0	2
OG0031892	0	1	1	0	0	2
OG0031893	0	2	0	0	0	2
OG0031894	0	2	0	0	0	2
OG0031895	0	2	0	0	0	2
OG0031896	0	2	0	0	0	2
OG0031897	0	2	0	0	0	2
OG0031898	0	2	0	0	0	2
OG0031899	0	2	0	0	0	2
OG0031900	0	2	0	0	0	2
OG0031901	0	2	0	0	0	2
OG0031902	0	2	0	0	0	2
OG0031903	0	2	0	0	0	2
OG0031904	0	2	0	0	0	2
OG0031905	0	1	1	0	0	2
OG0031906	0	2	0	0	0	2
OG0031907	0	2	0	0	0	2
OG0031908	0	2	0	0	0	2
OG0031909	0	2	0	0	0	2
OG0031910	0	2	0	0	0	2
OG0031911	0	2	0	0	0	2
OG0031912	0	2	0	0	0	2
OG0031913	0	2	0	0	0	2
OG0031914	0	2	0	0	0	2
OG0031915	0	2	0	0	0	2
OG0031916	0	1	1	0	0	2
OG0031917	0	1	0	1	0	2
OG0031918	0	2	0	0	0	2
OG0031919	0	1	0	0	1	2
OG0031920	0	2	0	0	0	2
OG0031921	0	2	0	0	0	2
OG0031922	0	2	0	0	0	2
OG0031923	0	1	1	0	0	2
OG0031924	0	1	0	1	0	2
OG0031925	0	2	0	0	0	2
OG0031926	0	2	0	0	0	2
OG0031927	0	2	0	0	0	2
OG0031928	0	2	0	0	0	2
OG0031929	0	2	0	0	0	2
OG0031930	0	2	0	0	0	2
OG0031931	0	2	0	0	0	2
OG0031932	0	2	0	0	0	2
OG0031933	0	2	0	0	0	2
OG0031934	0	2	0	0	0	2
OG0031935	0	2	0	0	0	2
OG0031936	0	2	0	0	0	2
OG0031937	0	2	0	0	0	2
OG0031938	0	2	0	0	0	2
OG0031939	0	2	0	0	0	2
OG0031940	0	2	0	0	0	2
OG0031941	0	1	0	0	1	2
OG0031942	0	2	0	0	0	2
OG0031943	0	2	0	0	0	2
OG0031944	0	2	0	0	0	2
OG0031945	0	2	0	0	0	2
OG0031946	0	2	0	0	0	2
OG0031947	0	1	0	0	1	2
OG0031948	0	2	0	0	0	2
OG0031949	0	2	0	0	0	2
OG0031950	0	2	0	0	0	2
OG0031951	0	2	0	0	0	2
OG0031952	0	2	0	0	0	2
OG0031953	0	2	0	0	0	2
OG0031954	0	2	0	0	0	2
OG0031955	0	2	0	0	0	2
OG0031956	0	1	0	1	0	2
OG0031957	0	2	0	0	0	2
OG0031958	0	1	1	0	0	2
OG0031959	0	2	0	0	0	2
OG0031960	0	2	0	0	0	2
OG0031961	0	2	0	0	0	2
OG0031962	0	2	0	0	0	2
OG0031963	0	2	0	0	0	2
OG0031964	0	2	0	0	0	2
OG0031965	0	2	0	0	0	2
OG0031966	0	1	1	0	0	2
OG0031967	0	2	0	0	0	2
OG0031968	0	1	1	0	0	2
OG0031969	0	1	0	0	1	2
OG0031970	0	2	0	0	0	2
OG0031971	0	2	0	0	0	2
OG0031972	0	2	0	0	0	2
OG0031973	0	2	0	0	0	2
OG0031974	0	2	0	0	0	2
OG0031975	0	2	0	0	0	2
OG0031976	0	1	1	0	0	2
OG0031977	0	2	0	0	0	2
OG0031978	0	1	0	0	1	2
OG0031979	0	1	0	1	0	2
OG0031980	0	2	0	0	0	2
OG0031981	0	2	0	0	0	2
OG0031982	0	2	0	0	0	2
OG0031983	0	2	0	0	0	2
OG0031984	0	1	0	0	1	2
OG0031985	0	2	0	0	0	2
OG0031986	0	1	0	1	0	2
OG0031987	0	2	0	0	0	2
OG0031988	0	2	0	0	0	2
OG0031989	0	2	0	0	0	2
OG0031990	0	2	0	0	0	2
OG0031991	0	2	0	0	0	2
OG0031992	0	2	0	0	0	2
OG0031993	0	2	0	0	0	2
OG0031994	0	2	0	0	0	2
OG0031995	0	2	0	0	0	2
OG0031996	0	1	1	0	0	2
OG0031997	0	2	0	0	0	2
OG0031998	0	2	0	0	0	2
OG0031999	0	2	0	0	0	2
OG0032000	0	2	0	0	0	2
OG0032001	0	2	0	0	0	2
OG0032002	0	2	0	0	0	2
OG0032003	0	2	0	0	0	2
OG0032004	0	1	0	1	0	2
OG0032005	0	2	0	0	0	2
OG0032006	0	2	0	0	0	2
OG0032007	0	2	0	0	0	2
OG0032008	0	2	0	0	0	2
OG0032009	0	2	0	0	0	2
OG0032010	0	2	0	0	0	2
OG0032011	0	2	0	0	0	2
OG0032012	0	2	0	0	0	2
OG0032013	0	2	0	0	0	2
OG0032014	0	2	0	0	0	2
OG0032015	0	1	0	0	1	2
OG0032016	0	2	0	0	0	2
OG0032017	0	2	0	0	0	2
OG0032018	0	2	0	0	0	2
OG0032019	0	1	1	0	0	2
OG0032020	0	1	0	0	1	2
OG0032021	0	2	0	0	0	2
OG0032022	0	2	0	0	0	2
OG0032023	0	2	0	0	0	2
OG0032024	0	2	0	0	0	2
OG0032025	0	2	0	0	0	2
OG0032026	0	2	0	0	0	2
OG0032027	0	2	0	0	0	2
OG0032028	0	2	0	0	0	2
OG0032029	0	2	0	0	0	2
OG0032030	0	2	0	0	0	2
OG0032031	0	2	0	0	0	2
OG0032032	0	2	0	0	0	2
OG0032033	0	1	1	0	0	2
OG0032034	0	2	0	0	0	2
OG0032035	0	2	0	0	0	2
OG0032036	0	1	0	0	1	2
OG0032037	0	1	1	0	0	2
OG0032038	0	2	0	0	0	2
OG0032039	0	2	0	0	0	2
OG0032040	0	2	0	0	0	2
OG0032041	0	2	0	0	0	2
OG0032042	0	2	0	0	0	2
OG0032043	0	1	1	0	0	2
OG0032044	0	2	0	0	0	2
OG0032045	0	2	0	0	0	2
OG0032046	0	2	0	0	0	2
OG0032047	0	2	0	0	0	2
OG0032048	0	2	0	0	0	2
OG0032049	0	1	1	0	0	2
OG0032050	0	2	0	0	0	2
OG0032051	0	2	0	0	0	2
OG0032052	0	2	0	0	0	2
OG0032053	0	2	0	0	0	2
OG0032054	0	2	0	0	0	2
OG0032055	0	2	0	0	0	2
OG0032056	0	2	0	0	0	2
OG0032057	0	2	0	0	0	2
OG0032058	0	2	0	0	0	2
OG0032059	0	2	0	0	0	2
OG0032060	0	1	1	0	0	2
OG0032061	0	2	0	0	0	2
OG0032062	0	2	0	0	0	2
OG0032063	0	1	1	0	0	2
OG0032064	0	2	0	0	0	2
OG0032065	0	1	0	1	0	2
OG0032066	0	2	0	0	0	2
OG0032067	0	1	0	0	1	2
OG0032068	0	2	0	0	0	2
OG0032069	0	2	0	0	0	2
OG0032070	0	2	0	0	0	2
OG0032071	0	2	0	0	0	2
OG0032072	0	1	1	0	0	2
OG0032073	0	1	1	0	0	2
OG0032074	0	2	0	0	0	2
OG0032075	0	2	0	0	0	2
OG0032076	0	2	0	0	0	2
OG0032077	0	1	1	0	0	2
OG0032078	0	1	1	0	0	2
OG0032079	0	0	1	1	0	2
OG0032080	0	0	1	0	1	2
OG0032081	0	0	1	1	0	2
OG0032082	0	0	1	0	1	2
OG0032083	0	0	1	0	1	2
OG0032084	0	0	1	0	1	2
OG0032085	0	0	1	0	1	2
OG0032086	0	0	1	0	1	2
OG0032087	0	0	1	0	1	2
OG0032088	0	0	1	0	1	2
OG0032089	0	0	1	0	1	2
OG0032090	0	0	1	0	1	2
OG0032091	0	0	2	0	0	2
OG0032092	0	0	1	0	1	2
OG0032093	0	0	1	0	1	2
OG0032094	0	0	1	0	1	2
OG0032095	0	0	2	0	0	2
OG0032096	0	0	2	0	0	2
OG0032097	0	0	2	0	0	2
OG0032098	0	0	1	0	1	2
OG0032099	0	0	1	0	1	2
OG0032100	0	0	2	0	0	2
OG0032101	0	0	1	0	1	2
OG0032102	0	0	1	1	0	2
OG0032103	0	0	1	0	1	2
OG0032104	0	0	1	0	1	2
OG0032105	0	0	2	0	0	2
OG0032106	0	0	1	0	1	2
OG0032107	0	0	1	0	1	2
OG0032108	0	0	1	0	1	2
OG0032109	0	0	1	0	1	2
OG0032110	0	0	2	0	0	2
OG0032111	0	0	1	0	1	2
OG0032112	0	0	1	0	1	2
OG0032113	0	0	2	0	0	2
OG0032114	0	0	1	0	1	2
OG0032115	0	0	1	0	1	2
OG0032116	0	0	2	0	0	2
OG0032117	0	0	2	0	0	2
OG0032118	0	0	2	0	0	2
OG0032119	0	0	2	0	0	2
OG0032120	0	0	1	0	1	2
OG0032121	0	0	1	0	1	2
OG0032122	0	0	1	0	1	2
OG0032123	0	0	1	0	1	2
OG0032124	0	0	1	0	1	2
OG0032125	0	0	1	0	1	2
OG0032126	0	0	1	0	1	2
OG0032127	0	0	2	0	0	2
OG0032128	0	0	2	0	0	2
OG0032129	0	0	2	0	0	2
OG0032130	0	0	1	0	1	2
OG0032131	0	0	2	0	0	2
OG0032132	0	0	2	0	0	2
OG0032133	0	0	1	0	1	2
OG0032134	0	0	2	0	0	2
OG0032135	0	0	1	0	1	2
OG0032136	0	0	1	0	1	2
OG0032137	0	0	1	0	1	2
OG0032138	0	0	2	0	0	2
OG0032139	0	0	2	0	0	2
OG0032140	0	0	2	0	0	2
OG0032141	0	0	2	0	0	2
OG0032142	0	0	1	0	1	2
OG0032143	0	0	1	0	1	2
OG0032144	0	0	1	0	1	2
OG0032145	0	0	2	0	0	2
OG0032146	0	0	1	0	1	2
OG0032147	0	0	1	0	1	2
OG0032148	0	0	2	0	0	2
OG0032149	0	0	2	0	0	2
OG0032150	0	0	1	0	1	2
OG0032151	0	0	2	0	0	2
OG0032152	0	0	1	0	1	2
OG0032153	0	0	1	0	1	2
OG0032154	0	0	2	0	0	2
OG0032155	0	0	2	0	0	2
OG0032156	0	0	2	0	0	2
OG0032157	0	0	1	0	1	2
OG0032158	0	0	1	0	1	2
OG0032159	0	0	1	0	1	2
OG0032160	0	0	1	0	1	2
OG0032161	0	0	1	0	1	2
OG0032162	0	0	1	0	1	2
OG0032163	0	0	1	0	1	2
OG0032164	0	0	1	0	1	2
OG0032165	0	0	1	0	1	2
OG0032166	0	0	1	0	1	2
OG0032167	0	0	2	0	0	2
OG0032168	0	0	2	0	0	2
OG0032169	0	0	2	0	0	2
OG0032170	0	0	1	0	1	2
OG0032171	0	0	2	0	0	2
OG0032172	0	0	1	0	1	2
OG0032173	0	0	1	0	1	2
OG0032174	0	0	1	0	1	2
OG0032175	0	0	1	0	1	2
OG0032176	0	0	1	0	1	2
OG0032177	0	0	1	0	1	2
OG0032178	0	0	2	0	0	2
OG0032179	0	0	1	0	1	2
OG0032180	0	0	1	0	1	2
OG0032181	0	0	1	0	1	2
OG0032182	0	0	2	0	0	2
OG0032183	0	0	1	0	1	2
OG0032184	0	0	1	0	1	2
OG0032185	0	0	1	0	1	2
OG0032186	0	0	2	0	0	2
OG0032187	0	0	2	0	0	2
OG0032188	0	0	1	0	1	2
OG0032189	0	0	1	0	1	2
OG0032190	0	0	2	0	0	2
OG0032191	0	0	2	0	0	2
OG0032192	0	0	1	0	1	2
OG0032193	0	0	2	0	0	2
OG0032194	0	0	2	0	0	2
OG0032195	0	0	2	0	0	2
OG0032196	0	0	1	0	1	2
OG0032197	0	0	1	0	1	2
OG0032198	0	0	1	0	1	2
OG0032199	0	0	1	0	1	2
OG0032200	0	0	1	0	1	2
OG0032201	0	0	2	0	0	2
OG0032202	0	0	1	1	0	2
OG0032203	0	0	1	0	1	2
OG0032204	0	0	1	0	1	2
OG0032205	0	0	1	0	1	2
OG0032206	0	0	1	0	1	2
OG0032207	0	0	1	0	1	2
OG0032208	0	0	2	0	0	2
OG0032209	0	0	1	1	0	2
OG0032210	0	0	1	0	1	2
OG0032211	0	0	2	0	0	2
OG0032212	0	0	1	0	1	2
OG0032213	0	0	2	0	0	2
OG0032214	0	0	2	0	0	2
OG0032215	0	0	2	0	0	2
OG0032216	0	0	1	0	1	2
OG0032217	0	0	1	0	1	2
OG0032218	0	0	1	0	1	2
OG0032219	0	0	2	0	0	2
OG0032220	0	0	1	0	1	2
OG0032221	0	0	2	0	0	2
OG0032222	0	0	1	0	1	2
OG0032223	0	0	1	0	1	2
OG0032224	0	0	1	0	1	2
OG0032225	0	0	2	0	0	2
OG0032226	0	0	2	0	0	2
OG0032227	0	0	1	0	1	2
OG0032228	0	0	1	0	1	2
OG0032229	0	0	2	0	0	2
OG0032230	0	0	1	0	1	2
OG0032231	0	0	1	0	1	2
OG0032232	0	0	1	0	1	2
OG0032233	0	0	1	0	1	2
OG0032234	0	0	1	0	1	2
OG0032235	0	0	2	0	0	2
OG0032236	0	0	2	0	0	2
OG0032237	0	0	2	0	0	2
OG0032238	0	0	2	0	0	2
OG0032239	0	0	1	1	0	2
OG0032240	0	0	2	0	0	2
OG0032241	0	0	1	0	1	2
OG0032242	0	0	1	0	1	2
OG0032243	0	0	2	0	0	2
OG0032244	0	0	1	0	1	2
OG0032245	0	0	1	0	1	2
OG0032246	0	0	1	0	1	2
OG0032247	0	0	1	0	1	2
OG0032248	0	0	2	0	0	2
OG0032249	0	0	1	0	1	2
OG0032250	0	0	2	0	0	2
OG0032251	0	0	2	0	0	2
OG0032252	0	0	1	0	1	2
OG0032253	0	0	1	0	1	2
OG0032254	0	0	1	0	1	2
OG0032255	0	0	2	0	0	2
OG0032256	0	0	1	0	1	2
OG0032257	0	0	1	0	1	2
OG0032258	0	0	1	0	1	2
OG0032259	0	0	2	0	0	2
OG0032260	0	0	2	0	0	2
OG0032261	0	0	1	0	1	2
OG0032262	0	0	1	0	1	2
OG0032263	0	0	1	0	1	2
OG0032264	0	0	2	0	0	2
OG0032265	0	0	1	0	1	2
OG0032266	0	0	1	0	1	2
OG0032267	0	0	1	0	1	2
OG0032268	0	0	1	0	1	2
OG0032269	0	0	1	0	1	2
OG0032270	0	0	1	0	1	2
OG0032271	0	0	1	0	1	2
OG0032272	0	0	1	0	1	2
OG0032273	0	0	2	0	0	2
OG0032274	0	0	1	0	1	2
OG0032275	0	0	1	0	1	2
OG0032276	0	0	1	0	1	2
OG0032277	0	0	1	0	1	2
OG0032278	0	0	1	0	1	2
OG0032279	0	0	1	0	1	2
OG0032280	0	0	1	0	1	2
OG0032281	0	0	2	0	0	2
OG0032282	0	0	2	0	0	2
OG0032283	0	0	2	0	0	2
OG0032284	0	0	1	0	1	2
OG0032285	0	0	1	1	0	2
OG0032286	0	0	1	0	1	2
OG0032287	0	0	1	0	1	2
OG0032288	0	0	1	0	1	2
OG0032289	0	0	1	1	0	2
OG0032290	0	0	1	0	1	2
OG0032291	0	0	1	0	1	2
OG0032292	0	0	1	0	1	2
OG0032293	0	0	1	0	1	2
OG0032294	0	0	1	0	1	2
OG0032295	0	0	1	1	0	2
OG0032296	0	0	1	0	1	2
OG0032297	0	0	2	0	0	2
OG0032298	0	0	2	0	0	2
OG0032299	0	0	1	0	1	2
OG0032300	0	0	2	0	0	2
OG0032301	0	0	1	0	1	2
OG0032302	0	0	1	1	0	2
OG0032303	0	0	1	0	1	2
OG0032304	0	0	1	0	1	2
OG0032305	0	0	1	0	1	2
OG0032306	0	0	1	0	1	2
OG0032307	0	0	2	0	0	2
OG0032308	0	0	1	0	1	2
OG0032309	0	0	1	0	1	2
OG0032310	0	0	1	0	1	2
OG0032311	0	0	1	0	1	2
OG0032312	0	0	1	0	1	2
OG0032313	0	0	1	0	1	2
OG0032314	0	0	1	0	1	2
OG0032315	0	0	1	0	1	2
OG0032316	0	0	1	0	1	2
OG0032317	0	0	1	0	1	2
OG0032318	0	0	1	0	1	2
OG0032319	0	0	2	0	0	2
OG0032320	0	0	2	0	0	2
OG0032321	0	0	2	0	0	2
OG0032322	0	0	2	0	0	2
OG0032323	0	0	2	0	0	2
OG0032324	0	0	1	0	1	2
OG0032325	0	0	1	0	1	2
OG0032326	0	0	1	0	1	2
OG0032327	0	0	1	0	1	2
OG0032328	0	0	1	0	1	2
OG0032329	0	0	2	0	0	2
OG0032330	0	0	1	0	1	2
OG0032331	0	0	1	0	1	2
OG0032332	0	0	1	0	1	2
OG0032333	0	0	1	0	1	2
OG0032334	0	0	1	0	1	2
OG0032335	0	0	2	0	0	2
OG0032336	0	0	2	0	0	2
OG0032337	0	0	2	0	0	2
OG0032338	0	0	2	0	0	2
OG0032339	0	0	1	0	1	2
OG0032340	0	0	2	0	0	2
OG0032341	0	0	1	0	1	2
OG0032342	0	0	1	0	1	2
OG0032343	0	0	1	0	1	2
OG0032344	0	0	1	0	1	2
OG0032345	0	0	1	0	1	2
OG0032346	0	0	1	0	1	2
OG0032347	0	0	1	0	1	2
OG0032348	0	0	1	0	1	2
OG0032349	0	0	1	0	1	2
OG0032350	0	0	1	0	1	2
OG0032351	0	0	1	0	1	2
OG0032352	0	0	1	1	0	2
OG0032353	0	0	2	0	0	2
OG0032354	0	0	1	0	1	2
OG0032355	0	0	1	0	1	2
OG0032356	0	0	1	0	1	2
OG0032357	0	0	1	0	1	2
OG0032358	0	0	1	0	1	2
OG0032359	0	0	1	0	1	2
OG0032360	0	0	2	0	0	2
OG0032361	0	0	1	0	1	2
OG0032362	0	0	1	0	1	2
OG0032363	0	0	1	0	1	2
OG0032364	0	0	1	0	1	2
OG0032365	0	0	2	0	0	2
OG0032366	0	0	2	0	0	2
OG0032367	0	0	1	0	1	2
OG0032368	0	0	2	0	0	2
OG0032369	0	0	2	0	0	2
OG0032370	0	0	1	0	1	2
OG0032371	0	0	1	0	1	2
OG0032372	0	0	1	0	1	2
OG0032373	0	0	2	0	0	2
OG0032374	0	0	1	0	1	2
OG0032375	0	0	1	0	1	2
OG0032376	0	0	2	0	0	2
OG0032377	0	0	1	0	1	2
OG0032378	0	0	1	0	1	2
OG0032379	0	0	2	0	0	2
OG0032380	0	0	2	0	0	2
OG0032381	0	0	2	0	0	2
OG0032382	0	0	1	0	1	2
OG0032383	0	0	1	0	1	2
OG0032384	0	0	2	0	0	2
OG0032385	0	0	2	0	0	2
OG0032386	0	0	2	0	0	2
OG0032387	0	0	1	0	1	2
OG0032388	0	0	2	0	0	2
OG0032389	0	0	1	0	1	2
OG0032390	0	0	2	0	0	2
OG0032391	0	0	1	0	1	2
OG0032392	0	0	2	0	0	2
OG0032393	0	0	1	0	1	2
OG0032394	0	0	1	0	1	2
OG0032395	0	0	1	0	1	2
OG0032396	0	0	1	0	1	2
OG0032397	0	0	1	0	1	2
OG0032398	0	0	1	0	1	2
OG0032399	0	0	1	0	1	2
OG0032400	0	0	1	0	1	2
OG0032401	0	0	2	0	0	2
OG0032402	0	0	2	0	0	2
OG0032403	0	0	2	0	0	2
OG0032404	0	0	2	0	0	2
OG0032405	0	0	2	0	0	2
OG0032406	0	0	1	0	1	2
OG0032407	0	0	2	0	0	2
OG0032408	0	0	2	0	0	2
OG0032409	0	0	2	0	0	2
OG0032410	0	0	1	1	0	2
OG0032411	0	0	1	0	1	2
OG0032412	0	0	1	0	1	2
OG0032413	0	0	1	0	1	2
OG0032414	0	0	1	0	1	2
OG0032415	0	0	1	0	1	2
OG0032416	0	0	1	0	1	2
OG0032417	0	0	1	0	1	2
OG0032418	0	0	2	0	0	2
OG0032419	0	0	1	0	1	2
OG0032420	0	0	2	0	0	2
OG0032421	0	0	1	0	1	2
OG0032422	0	0	1	1	0	2
OG0032423	0	0	1	0	1	2
OG0032424	0	0	1	0	1	2
OG0032425	0	0	1	0	1	2
OG0032426	0	0	1	0	1	2
OG0032427	0	0	1	0	1	2
OG0032428	0	0	1	0	1	2
OG0032429	0	0	1	0	1	2
OG0032430	0	0	1	0	1	2
OG0032431	0	0	1	0	1	2
OG0032432	0	0	1	0	1	2
OG0032433	0	0	1	0	1	2
OG0032434	0	0	1	0	1	2
OG0032435	0	0	1	0	1	2
OG0032436	0	0	1	0	1	2
OG0032437	0	0	1	0	1	2
OG0032438	0	0	1	0	1	2
OG0032439	0	0	1	0	1	2
OG0032440	0	0	1	0	1	2
OG0032441	0	0	1	0	1	2
OG0032442	0	0	1	1	0	2
OG0032443	0	0	1	1	0	2
OG0032444	0	0	1	0	1	2
OG0032445	0	0	1	0	1	2
OG0032446	0	0	2	0	0	2
OG0032447	0	0	1	0	1	2
OG0032448	0	0	1	0	1	2
OG0032449	0	0	1	0	1	2
OG0032450	0	0	2	0	0	2
OG0032451	0	0	1	0	1	2
OG0032452	0	0	2	0	0	2
OG0032453	0	0	2	0	0	2
OG0032454	0	0	1	0	1	2
OG0032455	0	0	2	0	0	2
OG0032456	0	0	2	0	0	2
OG0032457	0	0	1	0	1	2
OG0032458	0	0	1	0	1	2
OG0032459	0	0	1	0	1	2
OG0032460	0	0	1	0	1	2
OG0032461	0	0	1	0	1	2
OG0032462	0	0	2	0	0	2
OG0032463	0	0	1	0	1	2
OG0032464	0	0	1	0	1	2
OG0032465	0	0	2	0	0	2
OG0032466	0	0	1	0	1	2
OG0032467	0	0	1	0	1	2
OG0032468	0	0	2	0	0	2
OG0032469	0	0	2	0	0	2
OG0032470	0	0	1	0	1	2
OG0032471	0	0	1	0	1	2
OG0032472	0	0	2	0	0	2
OG0032473	0	0	2	0	0	2
OG0032474	0	0	2	0	0	2
OG0032475	0	0	1	0	1	2
OG0032476	0	0	1	0	1	2
OG0032477	0	0	1	0	1	2
OG0032478	0	0	1	0	1	2
OG0032479	0	0	1	0	1	2
OG0032480	0	0	1	0	1	2
OG0032481	0	0	1	0	1	2
OG0032482	0	0	1	0	1	2
OG0032483	0	0	1	0	1	2
OG0032484	0	0	2	0	0	2
OG0032485	0	0	2	0	0	2
OG0032486	0	0	1	0	1	2
OG0032487	0	0	1	0	1	2
OG0032488	0	0	1	0	1	2
OG0032489	0	0	2	0	0	2
OG0032490	0	0	2	0	0	2
OG0032491	0	0	2	0	0	2
OG0032492	0	0	2	0	0	2
OG0032493	0	0	1	0	1	2
OG0032494	0	0	2	0	0	2
OG0032495	0	0	1	0	1	2
OG0032496	0	0	1	0	1	2
OG0032497	0	0	1	0	1	2
OG0032498	0	0	1	0	1	2
OG0032499	0	0	1	0	1	2
OG0032500	0	0	2	0	0	2
OG0032501	0	0	1	0	1	2
OG0032502	0	0	1	0	1	2
OG0032503	0	0	2	0	0	2
OG0032504	0	0	2	0	0	2
OG0032505	0	0	2	0	0	2
OG0032506	0	0	1	0	1	2
OG0032507	0	0	1	0	1	2
OG0032508	0	0	1	0	1	2
OG0032509	0	0	1	0	1	2
OG0032510	0	0	2	0	0	2
OG0032511	0	0	1	0	1	2
OG0032512	0	0	1	0	1	2
OG0032513	0	0	1	0	1	2
OG0032514	0	0	1	0	1	2
OG0032515	0	0	2	0	0	2
OG0032516	0	0	1	0	1	2
OG0032517	0	0	2	0	0	2
OG0032518	0	0	1	0	1	2
OG0032519	0	0	1	0	1	2
OG0032520	0	0	2	0	0	2
OG0032521	0	0	1	0	1	2
OG0032522	0	0	1	0	1	2
OG0032523	0	0	1	0	1	2
OG0032524	0	0	1	0	1	2
OG0032525	0	0	1	0	1	2
OG0032526	0	0	2	0	0	2
OG0032527	0	0	1	0	1	2
OG0032528	0	0	2	0	0	2
OG0032529	0	0	2	0	0	2
OG0032530	0	0	1	0	1	2
OG0032531	0	0	2	0	0	2
OG0032532	0	0	1	0	1	2
OG0032533	0	0	2	0	0	2
OG0032534	0	0	2	0	0	2
OG0032535	0	0	2	0	0	2
OG0032536	0	0	2	0	0	2
OG0032537	0	0	2	0	0	2
OG0032538	0	0	1	1	0	2
OG0032539	0	0	2	0	0	2
OG0032540	0	0	2	0	0	2
OG0032541	0	0	2	0	0	2
OG0032542	0	0	2	0	0	2
OG0032543	0	0	1	0	1	2
OG0032544	0	0	1	0	1	2
OG0032545	0	0	1	0	1	2
OG0032546	0	0	1	0	1	2
OG0032547	0	0	2	0	0	2
OG0032548	0	0	1	0	1	2
OG0032549	0	0	2	0	0	2
OG0032550	0	0	2	0	0	2
OG0032551	0	0	2	0	0	2
OG0032552	0	0	1	0	1	2
OG0032553	0	0	2	0	0	2
OG0032554	0	0	2	0	0	2
OG0032555	0	0	2	0	0	2
OG0032556	0	0	1	0	1	2
OG0032557	0	0	2	0	0	2
OG0032558	0	0	2	0	0	2
OG0032559	0	0	1	0	1	2
OG0032560	0	0	1	0	1	2
OG0032561	0	0	2	0	0	2
OG0032562	0	0	2	0	0	2
OG0032563	0	0	1	0	1	2
OG0032564	0	0	1	0	1	2
OG0032565	0	0	2	0	0	2
OG0032566	0	0	1	0	1	2
OG0032567	0	0	1	0	1	2
OG0032568	0	0	1	0	1	2
OG0032569	0	0	1	0	1	2
OG0032570	0	0	1	0	1	2
OG0032571	0	0	1	0	1	2
OG0032572	0	0	1	1	0	2
OG0032573	0	0	1	0	1	2
OG0032574	0	0	2	0	0	2
OG0032575	0	0	1	0	1	2
OG0032576	0	0	2	0	0	2
OG0032577	0	0	1	0	1	2
OG0032578	0	0	1	0	1	2
OG0032579	0	0	1	0	1	2
OG0032580	0	0	1	0	1	2
OG0032581	0	0	2	0	0	2
OG0032582	0	0	1	0	1	2
OG0032583	0	0	1	0	1	2
OG0032584	0	0	1	0	1	2
OG0032585	0	0	2	0	0	2
OG0032586	0	0	2	0	0	2
OG0032587	0	0	1	0	1	2
OG0032588	0	0	1	0	1	2
OG0032589	0	0	1	0	1	2
OG0032590	0	0	1	0	1	2
OG0032591	0	0	2	0	0	2
OG0032592	0	0	1	0	1	2
OG0032593	0	0	1	0	1	2
OG0032594	0	0	2	0	0	2
OG0032595	0	0	1	0	1	2
OG0032596	0	0	2	0	0	2
OG0032597	0	0	1	0	1	2
OG0032598	0	0	1	0	1	2
OG0032599	0	0	1	0	1	2
OG0032600	0	0	1	0	1	2
OG0032601	0	0	1	0	1	2
OG0032602	0	0	1	1	0	2
OG0032603	0	0	1	0	1	2
OG0032604	0	0	2	0	0	2
OG0032605	0	0	1	0	1	2
OG0032606	0	0	2	0	0	2
OG0032607	0	0	2	0	0	2
OG0032608	0	0	1	0	1	2
OG0032609	0	0	1	0	1	2
OG0032610	0	0	1	0	1	2
OG0032611	0	0	1	0	1	2
OG0032612	0	0	1	0	1	2
OG0032613	0	0	1	0	1	2
OG0032614	0	0	1	0	1	2
OG0032615	0	0	1	0	1	2
OG0032616	0	0	2	0	0	2
OG0032617	0	0	1	1	0	2
OG0032618	0	0	2	0	0	2
OG0032619	0	0	1	0	1	2
OG0032620	0	0	1	0	1	2
OG0032621	0	0	1	0	1	2
OG0032622	0	0	1	1	0	2
OG0032623	0	0	1	0	1	2
OG0032624	0	0	1	0	1	2
OG0032625	0	0	1	0	1	2
OG0032626	0	0	1	0	1	2
OG0032627	0	0	2	0	0	2
OG0032628	0	0	1	0	1	2
OG0032629	0	0	1	0	1	2
OG0032630	0	0	2	0	0	2
OG0032631	0	0	1	0	1	2
OG0032632	0	0	2	0	0	2
OG0032633	0	0	2	0	0	2
OG0032634	0	0	1	0	1	2
OG0032635	0	0	1	0	1	2
OG0032636	0	0	1	0	1	2
OG0032637	0	0	1	1	0	2
OG0032638	0	0	1	0	1	2
OG0032639	0	0	1	0	1	2
OG0032640	0	0	1	0	1	2
OG0032641	0	0	1	0	1	2
OG0032642	0	0	2	0	0	2
OG0032643	0	0	1	0	1	2
OG0032644	0	0	1	0	1	2
OG0032645	0	0	1	0	1	2
OG0032646	0	0	1	0	1	2
OG0032647	0	0	1	0	1	2
OG0032648	0	0	1	0	1	2
OG0032649	0	0	1	0	1	2
OG0032650	0	0	1	0	1	2
OG0032651	0	0	1	0	1	2
OG0032652	0	0	1	0	1	2
OG0032653	0	0	1	0	1	2
OG0032654	0	0	1	0	1	2
OG0032655	0	0	1	0	1	2
OG0032656	0	0	1	0	1	2
OG0032657	0	0	2	0	0	2
OG0032658	0	0	2	0	0	2
OG0032659	0	0	2	0	0	2
OG0032660	0	0	1	0	1	2
OG0032661	0	0	2	0	0	2
OG0032662	0	0	1	1	0	2
OG0032663	0	0	1	0	1	2
OG0032664	0	0	2	0	0	2
OG0032665	0	0	2	0	0	2
OG0032666	0	0	1	0	1	2
OG0032667	0	0	2	0	0	2
OG0032668	0	0	1	0	1	2
OG0032669	0	0	1	0	1	2
OG0032670	0	0	1	1	0	2
OG0032671	0	0	2	0	0	2
OG0032672	0	0	2	0	0	2
OG0032673	0	0	2	0	0	2
OG0032674	0	0	2	0	0	2
OG0032675	0	0	2	0	0	2
OG0032676	0	0	1	0	1	2
OG0032677	0	0	1	0	1	2
OG0032678	0	0	1	0	1	2
OG0032679	0	0	2	0	0	2
OG0032680	0	0	1	0	1	2
OG0032681	0	0	1	1	0	2
OG0032682	0	0	1	0	1	2
OG0032683	0	0	2	0	0	2
OG0032684	0	0	1	0	1	2
OG0032685	0	0	1	0	1	2
OG0032686	0	0	1	0	1	2
OG0032687	0	0	1	0	1	2
OG0032688	0	0	1	0	1	2
OG0032689	0	0	1	0	1	2
OG0032690	0	0	1	0	1	2
OG0032691	0	0	2	0	0	2
OG0032692	0	0	1	0	1	2
OG0032693	0	0	1	0	1	2
OG0032694	0	0	2	0	0	2
OG0032695	0	0	1	0	1	2
OG0032696	0	0	1	0	1	2
OG0032697	0	0	2	0	0	2
OG0032698	0	0	2	0	0	2
OG0032699	0	0	1	0	1	2
OG0032700	0	0	1	0	1	2
OG0032701	0	0	2	0	0	2
OG0032702	0	0	1	0	1	2
OG0032703	0	0	1	0	1	2
OG0032704	0	0	1	0	1	2
OG0032705	0	0	1	0	1	2
OG0032706	0	0	1	0	1	2
OG0032707	0	0	1	0	1	2
OG0032708	0	0	1	0	1	2
OG0032709	0	0	2	0	0	2
OG0032710	0	0	1	0	1	2
OG0032711	0	0	1	0	1	2
OG0032712	0	0	2	0	0	2
OG0032713	0	0	1	0	1	2
OG0032714	0	0	1	0	1	2
OG0032715	0	0	1	0	1	2
OG0032716	0	0	1	0	1	2
OG0032717	0	0	2	0	0	2
OG0032718	0	0	1	0	1	2
OG0032719	0	0	1	0	1	2
OG0032720	0	0	1	0	1	2
OG0032721	0	0	1	0	1	2
OG0032722	0	0	1	0	1	2
OG0032723	0	0	1	1	0	2
OG0032724	0	0	1	0	1	2
OG0032725	0	0	1	0	1	2
OG0032726	0	0	2	0	0	2
OG0032727	0	0	1	0	1	2
OG0032728	0	0	1	0	1	2
OG0032729	0	0	1	0	1	2
OG0032730	0	0	1	0	1	2
OG0032731	0	0	1	0	1	2
OG0032732	0	0	1	0	1	2
OG0032733	0	0	1	0	1	2
OG0032734	0	0	2	0	0	2
OG0032735	0	0	1	0	1	2
OG0032736	0	0	1	0	1	2
OG0032737	0	0	1	0	1	2
OG0032738	0	0	1	0	1	2
OG0032739	0	0	1	1	0	2
OG0032740	0	0	1	0	1	2
OG0032741	0	0	1	0	1	2
OG0032742	0	0	1	0	1	2
OG0032743	0	0	1	1	0	2
OG0032744	0	0	1	0	1	2
OG0032745	0	0	1	0	1	2
OG0032746	0	0	1	0	1	2
OG0032747	0	0	2	0	0	2
OG0032748	0	0	2	0	0	2
OG0032749	0	0	2	0	0	2
OG0032750	0	0	2	0	0	2
OG0032751	0	0	2	0	0	2
OG0032752	0	0	2	0	0	2
OG0032753	0	0	1	0	1	2
OG0032754	0	0	1	1	0	2
OG0032755	0	0	1	0	1	2
OG0032756	0	0	1	0	1	2
OG0032757	0	0	1	0	1	2
OG0032758	0	0	1	0	1	2
OG0032759	0	0	1	0	1	2
OG0032760	0	0	1	0	1	2
OG0032761	0	0	1	0	1	2
OG0032762	0	0	1	0	1	2
OG0032763	0	0	1	0	1	2
OG0032764	0	0	2	0	0	2
OG0032765	0	0	1	0	1	2
OG0032766	0	0	1	0	1	2
OG0032767	0	0	1	0	1	2
OG0032768	0	0	1	0	1	2
OG0032769	0	0	1	0	1	2
OG0032770	0	0	1	0	1	2
OG0032771	0	0	1	1	0	2
OG0032772	0	0	1	0	1	2
OG0032773	0	0	2	0	0	2
OG0032774	0	0	2	0	0	2
OG0032775	0	0	1	0	1	2
OG0032776	0	0	1	0	1	2
OG0032777	0	0	1	0	1	2
OG0032778	0	0	2	0	0	2
OG0032779	0	0	1	0	1	2
OG0032780	0	0	1	0	1	2
OG0032781	0	0	1	0	1	2
OG0032782	0	0	1	0	1	2
OG0032783	0	0	1	0	1	2
OG0032784	0	0	2	0	0	2
OG0032785	0	0	1	0	1	2
OG0032786	0	0	1	0	1	2
OG0032787	0	0	1	0	1	2
OG0032788	0	0	1	0	1	2
OG0032789	0	0	2	0	0	2
OG0032790	0	0	1	0	1	2
OG0032791	0	0	1	0	1	2
OG0032792	0	0	1	0	1	2
OG0032793	0	0	1	0	1	2
OG0032794	0	0	1	0	1	2
OG0032795	0	0	1	0	1	2
OG0032796	0	0	2	0	0	2
OG0032797	0	0	1	0	1	2
OG0032798	0	0	1	0	1	2
OG0032799	0	0	1	0	1	2
OG0032800	0	0	1	0	1	2
OG0032801	0	0	2	0	0	2
OG0032802	0	0	2	0	0	2
OG0032803	0	0	1	0	1	2
OG0032804	0	0	1	0	1	2
OG0032805	0	0	1	0	1	2
OG0032806	0	0	2	0	0	2
OG0032807	0	0	1	0	1	2
OG0032808	0	0	1	0	1	2
OG0032809	0	0	1	0	1	2
OG0032810	0	0	2	0	0	2
OG0032811	0	0	1	0	1	2
OG0032812	0	0	1	0	1	2
OG0032813	0	0	1	0	1	2
OG0032814	0	0	2	0	0	2
OG0032815	0	0	1	0	1	2
OG0032816	0	0	1	0	1	2
OG0032817	0	0	1	0	1	2
OG0032818	0	0	1	0	1	2
OG0032819	0	0	2	0	0	2
OG0032820	0	0	2	0	0	2
OG0032821	0	0	1	0	1	2
OG0032822	0	0	1	0	1	2
OG0032823	0	0	1	0	1	2
OG0032824	0	0	2	0	0	2
OG0032825	0	0	2	0	0	2
OG0032826	0	0	1	0	1	2
OG0032827	0	0	1	0	1	2
OG0032828	0	0	1	0	1	2
OG0032829	0	0	2	0	0	2
OG0032830	0	0	2	0	0	2
OG0032831	0	0	1	0	1	2
OG0032832	0	0	1	0	1	2
OG0032833	0	0	2	0	0	2
OG0032834	0	0	1	0	1	2
OG0032835	0	0	1	0	1	2
OG0032836	0	0	1	0	1	2
OG0032837	0	0	1	0	1	2
OG0032838	0	0	1	0	1	2
OG0032839	0	0	1	0	1	2
OG0032840	0	0	1	0	1	2
OG0032841	0	0	1	0	1	2
OG0032842	0	0	1	0	1	2
OG0032843	0	0	1	0	1	2
OG0032844	0	0	2	0	0	2
OG0032845	0	0	1	0	1	2
OG0032846	0	0	1	0	1	2
OG0032847	0	0	1	0	1	2
OG0032848	0	0	1	0	1	2
OG0032849	0	0	2	0	0	2
OG0032850	0	0	2	0	0	2
OG0032851	0	0	2	0	0	2
OG0032852	0	0	1	0	1	2
OG0032853	0	0	2	0	0	2
OG0032854	0	0	1	0	1	2
OG0032855	0	0	1	0	1	2
OG0032856	0	0	1	0	1	2
OG0032857	0	0	1	0	1	2
OG0032858	0	0	1	0	1	2
OG0032859	0	0	1	0	1	2
OG0032860	0	0	1	0	1	2
OG0032861	0	0	1	0	1	2
OG0032862	0	0	1	0	1	2
OG0032863	0	0	2	0	0	2
OG0032864	0	0	2	0	0	2
OG0032865	0	0	1	0	1	2
OG0032866	0	0	1	0	1	2
OG0032867	0	0	1	0	1	2
OG0032868	0	0	1	0	1	2
OG0032869	0	0	1	0	1	2
OG0032870	0	0	1	0	1	2
OG0032871	0	0	1	0	1	2
OG0032872	0	0	1	0	1	2
OG0032873	0	0	1	0	1	2
OG0032874	0	0	1	0	1	2
OG0032875	0	0	1	0	1	2
OG0032876	0	0	1	0	1	2
OG0032877	0	0	1	0	1	2
OG0032878	0	0	2	0	0	2
OG0032879	0	0	1	0	1	2
OG0032880	0	0	1	1	0	2
OG0032881	0	0	1	0	1	2
OG0032882	0	0	1	0	1	2
OG0032883	0	0	1	0	1	2
OG0032884	0	0	1	0	1	2
OG0032885	0	0	1	0	1	2
OG0032886	0	0	1	0	1	2
OG0032887	0	0	2	0	0	2
OG0032888	0	0	1	0	1	2
OG0032889	0	0	1	0	1	2
OG0032890	0	0	1	0	1	2
OG0032891	0	0	1	0	1	2
OG0032892	0	0	1	0	1	2
OG0032893	0	0	2	0	0	2
OG0032894	0	0	1	0	1	2
OG0032895	0	0	1	0	1	2
OG0032896	0	0	1	0	1	2
OG0032897	0	0	1	0	1	2
OG0032898	0	0	1	1	0	2
OG0032899	0	0	1	0	1	2
OG0032900	0	0	1	0	1	2
OG0032901	0	0	1	0	1	2
OG0032902	0	0	1	0	1	2
OG0032903	0	0	1	0	1	2
OG0032904	0	0	1	0	1	2
OG0032905	0	0	1	0	1	2
OG0032906	0	0	2	0	0	2
OG0032907	0	0	1	0	1	2
OG0032908	0	0	1	0	1	2
OG0032909	0	0	1	0	1	2
OG0032910	0	0	1	0	1	2
OG0032911	0	0	2	0	0	2
OG0032912	0	0	1	0	1	2
OG0032913	0	0	1	1	0	2
OG0032914	0	0	1	0	1	2
OG0032915	0	0	1	0	1	2
OG0032916	0	0	1	0	1	2
OG0032917	0	0	1	0	1	2
OG0032918	0	0	1	0	1	2
OG0032919	0	0	1	0	1	2
OG0032920	0	0	1	0	1	2
OG0032921	0	0	1	0	1	2
OG0032922	0	0	1	0	1	2
OG0032923	0	0	1	0	1	2
OG0032924	0	0	1	0	1	2
OG0032925	0	0	1	0	1	2
OG0032926	0	0	1	0	1	2
OG0032927	0	0	1	0	1	2
OG0032928	0	0	1	0	1	2
OG0032929	0	0	1	0	1	2
OG0032930	0	0	1	0	1	2
OG0032931	0	0	1	0	1	2
OG0032932	0	0	1	0	1	2
OG0032933	0	0	1	0	1	2
OG0032934	0	0	1	0	1	2
OG0032935	0	0	1	0	1	2
OG0032936	0	0	1	0	1	2
OG0032937	0	0	1	0	1	2
OG0032938	0	0	1	0	1	2
OG0032939	0	0	2	0	0	2
OG0032940	0	0	1	0	1	2
OG0032941	0	0	1	0	1	2
OG0032942	0	0	1	0	1	2
OG0032943	0	0	1	0	1	2
OG0032944	0	0	1	0	1	2
OG0032945	0	0	1	0	1	2
OG0032946	0	0	1	0	1	2
OG0032947	0	0	1	0	1	2
OG0032948	0	0	1	0	1	2
OG0032949	0	0	1	0	1	2
OG0032950	0	0	1	0	1	2
OG0032951	0	0	1	0	1	2
OG0032952	0	0	1	0	1	2
OG0032953	0	0	2	0	0	2
OG0032954	0	0	2	0	0	2
OG0032955	0	0	1	0	1	2
OG0032956	0	0	1	0	1	2
OG0032957	0	0	1	0	1	2
OG0032958	0	0	1	0	1	2
OG0032959	0	0	1	0	1	2
OG0032960	0	0	1	0	1	2
OG0032961	0	0	1	0	1	2
OG0032962	0	0	1	0	1	2
OG0032963	0	0	1	0	1	2
OG0032964	0	0	1	0	1	2
OG0032965	0	0	2	0	0	2
OG0032966	0	0	1	0	1	2
OG0032967	0	0	2	0	0	2
OG0032968	0	0	2	0	0	2
OG0032969	0	0	1	0	1	2
OG0032970	0	0	1	0	1	2
OG0032971	0	0	1	0	1	2
OG0032972	0	0	2	0	0	2
OG0032973	0	0	1	0	1	2
OG0032974	0	0	2	0	0	2
OG0032975	0	0	1	0	1	2
OG0032976	0	0	2	0	0	2
OG0032977	0	0	1	0	1	2
OG0032978	0	0	1	0	1	2
OG0032979	0	0	2	0	0	2
OG0032980	0	0	1	0	1	2
OG0032981	0	0	1	0	1	2
OG0032982	0	0	1	0	1	2
OG0032983	0	0	1	0	1	2
OG0032984	0	0	1	0	1	2
OG0032985	0	0	1	0	1	2
OG0032986	0	0	1	0	1	2
OG0032987	0	0	1	0	1	2
OG0032988	0	0	1	0	1	2
OG0032989	0	0	1	0	1	2
OG0032990	0	0	1	0	1	2
OG0032991	0	0	1	0	1	2
OG0032992	0	0	1	0	1	2
OG0032993	0	0	2	0	0	2
OG0032994	0	0	1	0	1	2
OG0032995	0	0	1	0	1	2
OG0032996	0	0	2	0	0	2
OG0032997	0	0	1	0	1	2
OG0032998	0	0	1	0	1	2
OG0032999	0	0	1	0	1	2
OG0033000	0	0	1	0	1	2
OG0033001	0	0	1	0	1	2
OG0033002	0	0	1	0	1	2
OG0033003	0	0	1	0	1	2
OG0033004	0	0	2	0	0	2
OG0033005	0	0	1	0	1	2
OG0033006	0	0	1	0	1	2
OG0033007	0	0	2	0	0	2
OG0033008	0	0	1	0	1	2
OG0033009	0	0	1	0	1	2
OG0033010	0	0	1	0	1	2
OG0033011	0	0	1	0	1	2
OG0033012	0	0	1	0	1	2
OG0033013	0	0	1	0	1	2
OG0033014	0	0	1	0	1	2
OG0033015	0	0	1	0	1	2
OG0033016	0	0	1	0	1	2
OG0033017	0	0	2	0	0	2
OG0033018	0	0	1	0	1	2
OG0033019	0	0	1	0	1	2
OG0033020	0	0	2	0	0	2
OG0033021	0	0	1	0	1	2
OG0033022	0	0	1	0	1	2
OG0033023	0	0	1	0	1	2
OG0033024	0	0	1	0	1	2
OG0033025	0	0	1	0	1	2
OG0033026	0	0	1	1	0	2
OG0033027	0	0	1	0	1	2
OG0033028	0	0	1	0	1	2
OG0033029	0	0	1	0	1	2
OG0033030	0	0	1	0	1	2
OG0033031	0	0	1	0	1	2
OG0033032	0	0	2	0	0	2
OG0033033	0	0	1	0	1	2
OG0033034	0	0	1	0	1	2
OG0033035	0	0	1	0	1	2
OG0033036	0	0	1	0	1	2
OG0033037	0	0	1	0	1	2
OG0033038	0	0	1	0	1	2
OG0033039	0	0	1	0	1	2
OG0033040	0	0	1	0	1	2
OG0033041	0	0	1	0	1	2
OG0033042	0	0	1	0	1	2
OG0033043	0	0	2	0	0	2
OG0033044	0	0	1	0	1	2
OG0033045	0	0	1	0	1	2
OG0033046	0	0	2	0	0	2
OG0033047	0	0	1	0	1	2
OG0033048	0	0	1	0	1	2
OG0033049	0	0	1	0	1	2
OG0033050	0	0	1	0	1	2
OG0033051	0	0	1	0	1	2
OG0033052	0	0	1	0	1	2
OG0033053	0	0	1	0	1	2
OG0033054	0	0	1	0	1	2
OG0033055	0	0	1	0	1	2
OG0033056	0	0	1	0	1	2
OG0033057	0	0	1	0	1	2
OG0033058	0	0	1	0	1	2
OG0033059	0	0	1	1	0	2
OG0033060	0	0	1	0	1	2
OG0033061	0	0	1	0	1	2
OG0033062	0	0	1	0	1	2
OG0033063	0	0	1	1	0	2
OG0033064	0	0	1	0	1	2
OG0033065	0	0	1	0	1	2
OG0033066	0	0	1	0	1	2
OG0033067	0	0	2	0	0	2
OG0033068	0	0	1	0	1	2
OG0033069	0	0	1	0	1	2
OG0033070	0	0	1	0	1	2
OG0033071	0	0	1	0	1	2
OG0033072	0	0	1	0	1	2
OG0033073	0	0	1	0	1	2
OG0033074	0	0	1	0	1	2
OG0033075	0	0	1	0	1	2
OG0033076	0	0	1	0	1	2
OG0033077	0	0	1	0	1	2
OG0033078	0	0	2	0	0	2
OG0033079	0	0	1	0	1	2
OG0033080	0	0	1	0	1	2
OG0033081	0	0	1	0	1	2
OG0033082	0	0	1	0	1	2
OG0033083	0	0	1	0	1	2
OG0033084	0	0	1	0	1	2
OG0033085	0	0	1	0	1	2
OG0033086	0	0	1	0	1	2
OG0033087	0	0	1	1	0	2
OG0033088	0	0	1	0	1	2
OG0033089	0	0	1	0	1	2
OG0033090	0	0	2	0	0	2
OG0033091	0	0	1	0	1	2
OG0033092	0	0	1	0	1	2
OG0033093	0	0	1	0	1	2
OG0033094	0	0	1	0	1	2
OG0033095	0	0	1	0	1	2
OG0033096	0	0	1	0	1	2
OG0033097	0	0	2	0	0	2
OG0033098	0	0	1	0	1	2
OG0033099	0	0	1	0	1	2
OG0033100	0	0	2	0	0	2
OG0033101	0	0	1	0	1	2
OG0033102	0	0	2	0	0	2
OG0033103	0	0	1	0	1	2
OG0033104	0	0	1	0	1	2
OG0033105	0	0	1	0	1	2
OG0033106	0	0	2	0	0	2
OG0033107	0	0	1	0	1	2
OG0033108	0	0	2	0	0	2
OG0033109	0	0	1	0	1	2
OG0033110	0	0	1	0	1	2
OG0033111	0	0	1	0	1	2
OG0033112	0	0	1	0	1	2
OG0033113	0	0	2	0	0	2
OG0033114	0	0	1	0	1	2
OG0033115	0	0	1	0	1	2
OG0033116	0	0	1	0	1	2
OG0033117	0	0	1	1	0	2
OG0033118	0	0	1	0	1	2
OG0033119	0	0	1	0	1	2
OG0033120	0	0	1	0	1	2
OG0033121	0	0	1	0	1	2
OG0033122	0	0	2	0	0	2
OG0033123	0	0	1	0	1	2
OG0033124	0	0	1	0	1	2
OG0033125	0	0	1	0	1	2
OG0033126	0	0	1	0	1	2
OG0033127	0	0	1	1	0	2
OG0033128	0	0	1	0	1	2
OG0033129	0	0	1	0	1	2
OG0033130	0	0	1	0	1	2
OG0033131	0	0	2	0	0	2
OG0033132	0	0	1	0	1	2
OG0033133	0	0	1	0	1	2
OG0033134	0	0	1	0	1	2
OG0033135	0	0	1	0	1	2
OG0033136	0	0	1	0	1	2
OG0033137	0	0	1	0	1	2
OG0033138	0	0	1	0	1	2
OG0033139	0	0	1	0	1	2
OG0033140	0	0	1	0	1	2
OG0033141	0	0	1	0	1	2
OG0033142	0	0	1	0	1	2
OG0033143	0	0	1	0	1	2
OG0033144	0	0	1	0	1	2
OG0033145	0	0	1	0	1	2
OG0033146	0	0	1	0	1	2
OG0033147	0	0	1	0	1	2
OG0033148	0	0	1	0	1	2
OG0033149	0	0	1	0	1	2
OG0033150	0	0	1	0	1	2
OG0033151	0	0	1	0	1	2
OG0033152	0	0	1	0	1	2
OG0033153	0	0	1	0	1	2
OG0033154	0	0	1	0	1	2
OG0033155	0	0	1	0	1	2
OG0033156	0	0	1	0	1	2
OG0033157	0	0	1	0	1	2
OG0033158	0	0	1	0	1	2
OG0033159	0	0	1	0	1	2
OG0033160	0	0	1	0	1	2
OG0033161	0	0	1	0	1	2
OG0033162	0	0	1	0	1	2
OG0033163	0	0	1	0	1	2
OG0033164	0	0	1	0	1	2
OG0033165	0	0	1	0	1	2
OG0033166	0	0	2	0	0	2
OG0033167	0	0	2	0	0	2
OG0033168	0	0	1	0	1	2
OG0033169	0	0	1	1	0	2
OG0033170	0	0	2	0	0	2
OG0033171	0	0	1	1	0	2
OG0033172	0	0	1	0	1	2
OG0033173	0	0	1	0	1	2
OG0033174	0	0	1	0	1	2
OG0033175	0	0	2	0	0	2
OG0033176	0	0	1	0	1	2
OG0033177	0	0	1	0	1	2
OG0033178	0	0	1	0	1	2
OG0033179	0	0	1	0	1	2
OG0033180	0	0	1	0	1	2
OG0033181	0	0	1	0	1	2
OG0033182	0	0	1	0	1	2
OG0033183	0	0	1	0	1	2
OG0033184	0	0	1	0	1	2
OG0033185	0	0	1	0	1	2
OG0033186	0	0	1	0	1	2
OG0033187	0	0	1	0	1	2
OG0033188	0	0	1	0	1	2
OG0033189	0	0	1	0	1	2
OG0033190	0	0	2	0	0	2
OG0033191	0	0	1	0	1	2
OG0033192	0	0	1	0	1	2
OG0033193	0	0	2	0	0	2
OG0033194	0	0	1	0	1	2
OG0033195	0	0	1	0	1	2
OG0033196	0	0	1	0	1	2
OG0033197	0	0	1	0	1	2
OG0033198	0	0	1	1	0	2
OG0033199	0	0	1	0	1	2
OG0033200	0	0	2	0	0	2
OG0033201	0	0	1	0	1	2
OG0033202	0	0	1	0	1	2
OG0033203	0	0	1	0	1	2
OG0033204	0	0	1	0	1	2
OG0033205	0	0	1	0	1	2
OG0033206	0	0	2	0	0	2
OG0033207	0	0	1	0	1	2
OG0033208	0	0	1	0	1	2
OG0033209	0	0	1	0	1	2
OG0033210	0	0	2	0	0	2
OG0033211	0	0	1	0	1	2
OG0033212	0	0	1	0	1	2
OG0033213	0	0	1	0	1	2
OG0033214	0	0	1	1	0	2
OG0033215	0	0	1	0	1	2
OG0033216	0	0	1	0	1	2
OG0033217	0	0	2	0	0	2
OG0033218	0	0	1	0	1	2
OG0033219	0	0	1	0	1	2
OG0033220	0	0	1	0	1	2
OG0033221	0	0	2	0	0	2
OG0033222	0	0	2	0	0	2
OG0033223	0	0	1	0	1	2
OG0033224	0	0	1	1	0	2
OG0033225	0	0	1	0	1	2
OG0033226	0	0	1	0	1	2
OG0033227	0	0	1	0	1	2
OG0033228	0	0	1	0	1	2
OG0033229	0	0	1	0	1	2
OG0033230	0	0	1	0	1	2
OG0033231	0	0	2	0	0	2
OG0033232	0	0	1	0	1	2
OG0033233	0	0	1	0	1	2
OG0033234	0	0	1	0	1	2
OG0033235	0	0	1	0	1	2
OG0033236	0	0	1	0	1	2
OG0033237	0	0	1	0	1	2
OG0033238	0	0	1	0	1	2
OG0033239	0	0	1	0	1	2
OG0033240	0	0	1	0	1	2
OG0033241	0	0	1	0	1	2
OG0033242	0	0	1	0	1	2
OG0033243	0	0	2	0	0	2
OG0033244	0	0	1	0	1	2
OG0033245	0	0	1	0	1	2
OG0033246	0	0	1	0	1	2
OG0033247	0	0	1	0	1	2
OG0033248	0	0	1	0	1	2
OG0033249	0	0	1	0	1	2
OG0033250	0	0	1	0	1	2
OG0033251	0	0	1	0	1	2
OG0033252	0	0	1	0	1	2
OG0033253	0	0	1	1	0	2
OG0033254	0	0	2	0	0	2
OG0033255	0	0	1	0	1	2
OG0033256	0	0	2	0	0	2
OG0033257	0	0	1	0	1	2
OG0033258	0	0	1	0	1	2
OG0033259	0	0	1	0	1	2
OG0033260	0	0	1	0	1	2
OG0033261	0	0	1	0	1	2
OG0033262	0	0	2	0	0	2
OG0033263	0	0	2	0	0	2
OG0033264	0	0	2	0	0	2
OG0033265	0	0	1	0	1	2
OG0033266	0	0	1	0	1	2
OG0033267	0	0	1	0	1	2
OG0033268	0	0	1	0	1	2
OG0033269	0	0	1	0	1	2
OG0033270	0	0	1	0	1	2
OG0033271	0	0	1	0	1	2
OG0033272	0	0	2	0	0	2
OG0033273	0	0	1	0	1	2
OG0033274	0	0	1	0	1	2
OG0033275	0	0	1	0	1	2
OG0033276	0	0	1	0	1	2
OG0033277	0	0	1	0	1	2
OG0033278	0	0	2	0	0	2
OG0033279	0	0	1	0	1	2
OG0033280	0	0	1	0	1	2
OG0033281	0	0	2	0	0	2
OG0033282	0	0	1	0	1	2
OG0033283	0	0	1	0	1	2
OG0033284	0	0	1	0	1	2
OG0033285	0	0	1	0	1	2
OG0033286	0	0	1	0	1	2
OG0033287	0	0	1	0	1	2
OG0033288	0	0	1	0	1	2
OG0033289	0	0	1	0	1	2
OG0033290	0	0	1	0	1	2
OG0033291	0	0	1	0	1	2
OG0033292	0	0	2	0	0	2
OG0033293	0	0	1	0	1	2
OG0033294	0	0	1	0	1	2
OG0033295	0	0	1	0	1	2
OG0033296	0	0	1	0	1	2
OG0033297	0	0	1	1	0	2
OG0033298	0	0	1	0	1	2
OG0033299	0	0	2	0	0	2
OG0033300	0	0	1	0	1	2
OG0033301	0	0	1	0	1	2
OG0033302	0	0	2	0	0	2
OG0033303	0	0	1	0	1	2
OG0033304	0	0	2	0	0	2
OG0033305	0	0	1	0	1	2
OG0033306	0	0	1	0	1	2
OG0033307	0	0	2	0	0	2
OG0033308	0	0	1	0	1	2
OG0033309	0	0	1	0	1	2
OG0033310	0	0	2	0	0	2
OG0033311	0	0	0	2	0	2
OG0033312	0	0	0	2	0	2
OG0033313	0	0	0	2	0	2
OG0033314	0	0	0	2	0	2
OG0033315	0	0	0	2	0	2
OG0033316	0	0	0	2	0	2
OG0033317	0	0	0	2	0	2
OG0033318	0	0	0	2	0	2
OG0033319	0	0	0	1	1	2
OG0033320	0	0	0	2	0	2
OG0033321	0	0	0	2	0	2
OG0033322	0	0	0	2	0	2
OG0033323	0	0	0	2	0	2
OG0033324	0	0	0	2	0	2
OG0033325	0	0	0	2	0	2
OG0033326	0	0	0	2	0	2
OG0033327	0	0	0	2	0	2
OG0033328	0	0	0	2	0	2
OG0033329	0	0	0	2	0	2
OG0033330	0	0	0	2	0	2
OG0033331	0	0	0	2	0	2
OG0033332	0	0	0	2	0	2
OG0033333	0	0	0	2	0	2
OG0033334	0	0	0	2	0	2
OG0033335	0	0	0	2	0	2
OG0033336	0	0	0	1	1	2
OG0033337	0	0	0	2	0	2
OG0033338	0	0	0	2	0	2
OG0033339	0	0	0	2	0	2
OG0033340	0	0	0	1	1	2
OG0033341	0	0	0	2	0	2
OG0033342	0	0	0	2	0	2
OG0033343	0	0	0	2	0	2
OG0033344	0	0	0	2	0	2
OG0033345	0	0	0	2	0	2
OG0033346	0	0	0	2	0	2
OG0033347	0	0	0	1	1	2
OG0033348	0	0	0	2	0	2
OG0033349	0	0	0	2	0	2
OG0033350	0	0	0	2	0	2
OG0033351	0	0	0	2	0	2
OG0033352	0	0	0	2	0	2
OG0033353	0	0	0	2	0	2
OG0033354	0	0	0	1	1	2
OG0033355	0	0	0	2	0	2
OG0033356	0	0	0	2	0	2
OG0033357	0	0	0	2	0	2
OG0033358	0	0	0	2	0	2
OG0033359	0	0	0	1	1	2
OG0033360	0	0	0	2	0	2
OG0033361	0	0	0	2	0	2
OG0033362	0	0	0	2	0	2
OG0033363	0	0	0	2	0	2
OG0033364	0	0	0	1	1	2
OG0033365	0	0	0	2	0	2
OG0033366	0	0	0	2	0	2
OG0033367	0	0	0	2	0	2
OG0033368	0	0	0	1	1	2
OG0033369	0	0	0	2	0	2
OG0033370	0	0	0	2	0	2
OG0033371	0	0	0	2	0	2
OG0033372	0	0	0	2	0	2
OG0033373	0	0	0	2	0	2
OG0033374	0	0	0	2	0	2
OG0033375	0	0	0	2	0	2
OG0033376	0	0	0	2	0	2
OG0033377	0	0	0	2	0	2
OG0033378	0	0	0	2	0	2
OG0033379	0	0	0	2	0	2
OG0033380	0	0	0	2	0	2
OG0033381	0	0	0	2	0	2
OG0033382	0	0	0	2	0	2
OG0033383	0	0	0	2	0	2
OG0033384	0	0	0	2	0	2
OG0033385	0	0	0	2	0	2
OG0033386	0	0	0	2	0	2
OG0033387	0	0	0	2	0	2
OG0033388	0	0	0	2	0	2
OG0033389	0	0	0	1	1	2
OG0033390	0	0	0	2	0	2
OG0033391	0	0	0	2	0	2
OG0033392	0	0	0	2	0	2
OG0033393	0	0	0	1	1	2
OG0033394	0	0	0	2	0	2
OG0033395	0	0	0	2	0	2
OG0033396	0	0	0	2	0	2
OG0033397	0	0	0	2	0	2
OG0033398	0	0	0	1	1	2
OG0033399	0	0	0	2	0	2
OG0033400	0	0	0	2	0	2
OG0033401	0	0	0	2	0	2
OG0033402	0	0	0	2	0	2
OG0033403	0	0	0	2	0	2
OG0033404	0	0	0	2	0	2
OG0033405	0	0	0	2	0	2
OG0033406	0	0	0	2	0	2
OG0033407	0	0	0	2	0	2
OG0033408	0	0	0	1	1	2
OG0033409	0	0	0	2	0	2
OG0033410	0	0	0	2	0	2
OG0033411	0	0	0	2	0	2
OG0033412	0	0	0	2	0	2
OG0033413	0	0	0	2	0	2
OG0033414	0	0	0	2	0	2
OG0033415	0	0	0	2	0	2
OG0033416	0	0	0	2	0	2
OG0033417	0	0	0	2	0	2
OG0033418	0	0	0	2	0	2
OG0033419	0	0	0	2	0	2
OG0033420	0	0	0	2	0	2
OG0033421	0	0	0	2	0	2
OG0033422	0	0	0	2	0	2
OG0033423	0	0	0	2	0	2
OG0033424	0	0	0	2	0	2
OG0033425	0	0	0	2	0	2
OG0033426	0	0	0	2	0	2
OG0033427	0	0	0	2	0	2
OG0033428	0	0	0	2	0	2
OG0033429	0	0	0	2	0	2
OG0033430	0	0	0	2	0	2
OG0033431	0	0	0	1	1	2
OG0033432	0	0	0	2	0	2
OG0033433	0	0	0	2	0	2
OG0033434	0	0	0	2	0	2
OG0033435	0	0	0	2	0	2
OG0033436	0	0	0	2	0	2
OG0033437	0	0	0	1	1	2
OG0033438	0	0	0	2	0	2
OG0033439	0	0	0	2	0	2
OG0033440	0	0	0	1	1	2
OG0033441	0	0	0	2	0	2
OG0033442	0	0	0	2	0	2
OG0033443	0	0	0	2	0	2
OG0033444	0	0	0	2	0	2
OG0033445	0	0	0	2	0	2
OG0033446	0	0	0	2	0	2
OG0033447	0	0	0	2	0	2
OG0033448	0	0	0	1	1	2
OG0033449	0	0	0	2	0	2
OG0033450	0	0	0	2	0	2
OG0033451	0	0	0	2	0	2
OG0033452	0	0	0	2	0	2
OG0033453	0	0	0	2	0	2
OG0033454	0	0	0	2	0	2
OG0033455	0	0	0	1	1	2
OG0033456	0	0	0	2	0	2
OG0033457	0	0	0	2	0	2
OG0033458	0	0	0	2	0	2
OG0033459	0	0	0	2	0	2
OG0033460	0	0	0	2	0	2
OG0033461	0	0	0	2	0	2
OG0033462	0	0	0	2	0	2
OG0033463	0	0	0	2	0	2
OG0033464	0	0	0	1	1	2
OG0033465	0	0	0	1	1	2
OG0033466	0	0	0	2	0	2
OG0033467	0	0	0	1	1	2
OG0033468	0	0	0	2	0	2
OG0033469	0	0	0	2	0	2
OG0033470	0	0	0	2	0	2
OG0033471	0	0	0	2	0	2
OG0033472	0	0	0	1	1	2
OG0033473	0	0	0	2	0	2
OG0033474	0	0	0	2	0	2
OG0033475	0	0	0	2	0	2
OG0033476	0	0	0	2	0	2
OG0033477	0	0	0	2	0	2
OG0033478	0	0	0	2	0	2
OG0033479	0	0	0	2	0	2
OG0033480	0	0	0	2	0	2
OG0033481	0	0	0	2	0	2
OG0033482	0	0	0	2	0	2
OG0033483	0	0	0	2	0	2
OG0033484	0	0	0	1	1	2
OG0033485	0	0	0	2	0	2
OG0033486	0	0	0	2	0	2
OG0033487	0	0	0	2	0	2
OG0033488	0	0	0	2	0	2
OG0033489	0	0	0	2	0	2
OG0033490	0	0	0	2	0	2
OG0033491	0	0	0	1	1	2
OG0033492	0	0	0	2	0	2
OG0033493	0	0	0	2	0	2
OG0033494	0	0	0	2	0	2
OG0033495	0	0	0	2	0	2
OG0033496	0	0	0	2	0	2
OG0033497	0	0	0	2	0	2
OG0033498	0	0	0	2	0	2
OG0033499	0	0	0	2	0	2
OG0033500	0	0	0	2	0	2
OG0033501	0	0	0	1	1	2
OG0033502	0	0	0	2	0	2
OG0033503	0	0	0	2	0	2
OG0033504	0	0	0	1	1	2
OG0033505	0	0	0	2	0	2
OG0033506	0	0	0	2	0	2
OG0033507	0	0	0	2	0	2
OG0033508	0	0	0	2	0	2
OG0033509	0	0	0	2	0	2
OG0033510	0	0	0	2	0	2
OG0033511	0	0	0	2	0	2
OG0033512	0	0	0	2	0	2
OG0033513	0	0	0	2	0	2
OG0033514	0	0	0	2	0	2
OG0033515	0	0	0	2	0	2
OG0033516	0	0	0	2	0	2
OG0033517	0	0	0	2	0	2
OG0033518	0	0	0	2	0	2
OG0033519	0	0	0	2	0	2
OG0033520	0	0	0	2	0	2
OG0033521	0	0	0	2	0	2
OG0033522	0	0	0	2	0	2
OG0033523	0	0	0	2	0	2
OG0033524	0	0	0	2	0	2
OG0033525	0	0	0	2	0	2
OG0033526	0	0	0	2	0	2
OG0033527	0	0	0	1	1	2
OG0033528	0	0	0	2	0	2
OG0033529	0	0	0	1	1	2
OG0033530	0	0	0	2	0	2
OG0033531	0	0	0	2	0	2
OG0033532	0	0	0	1	1	2
OG0033533	0	0	0	2	0	2
OG0033534	0	0	0	2	0	2
OG0033535	0	0	0	2	0	2
OG0033536	0	0	0	2	0	2
OG0033537	0	0	0	2	0	2
OG0033538	0	0	0	2	0	2
OG0033539	0	0	0	2	0	2
OG0033540	0	0	0	2	0	2
OG0033541	0	0	0	2	0	2
OG0033542	0	0	0	2	0	2
OG0033543	0	0	0	2	0	2
OG0033544	0	0	0	2	0	2
OG0033545	0	0	0	2	0	2
OG0033546	0	0	0	2	0	2
OG0033547	0	0	0	2	0	2
OG0033548	0	0	0	2	0	2
OG0033549	0	0	0	2	0	2
OG0033550	0	0	0	2	0	2
OG0033551	0	0	0	2	0	2
OG0033552	0	0	0	2	0	2
OG0033553	0	0	0	2	0	2
OG0033554	0	0	0	1	1	2
OG0033555	0	0	0	2	0	2
OG0033556	0	0	0	2	0	2
OG0033557	0	0	0	2	0	2
OG0033558	0	0	0	1	1	2
OG0033559	0	0	0	2	0	2
OG0033560	0	0	0	2	0	2
OG0033561	0	0	0	2	0	2
OG0033562	0	0	0	2	0	2
OG0033563	0	0	0	2	0	2
OG0033564	0	0	0	2	0	2
OG0033565	0	0	0	2	0	2
OG0033566	0	0	0	2	0	2
OG0033567	0	0	0	2	0	2
OG0033568	0	0	0	2	0	2
OG0033569	0	0	0	2	0	2
OG0033570	0	0	0	2	0	2
OG0033571	0	0	0	2	0	2
OG0033572	0	0	0	1	1	2
OG0033573	0	0	0	2	0	2
OG0033574	0	0	0	1	1	2
OG0033575	0	0	0	2	0	2
OG0033576	0	0	0	2	0	2
OG0033577	0	0	0	2	0	2
OG0033578	0	0	0	2	0	2
OG0033579	0	0	0	1	1	2
OG0033580	0	0	0	2	0	2
OG0033581	0	0	0	2	0	2
OG0033582	0	0	0	1	1	2
OG0033583	0	0	0	2	0	2
OG0033584	0	0	0	2	0	2
OG0033585	0	0	0	2	0	2
OG0033586	0	0	0	2	0	2
OG0033587	0	0	0	2	0	2
OG0033588	0	0	0	2	0	2
OG0033589	0	0	0	2	0	2
OG0033590	0	0	0	1	1	2
OG0033591	0	0	0	2	0	2
OG0033592	0	0	0	2	0	2
OG0033593	0	0	0	2	0	2
OG0033594	0	0	0	2	0	2
OG0033595	0	0	0	2	0	2
OG0033596	0	0	0	2	0	2
OG0033597	0	0	0	1	1	2
OG0033598	0	0	0	1	1	2
OG0033599	0	0	0	2	0	2
OG0033600	0	0	0	2	0	2
OG0033601	0	0	0	2	0	2
OG0033602	0	0	0	2	0	2
OG0033603	0	0	0	1	1	2
OG0033604	0	0	0	2	0	2
OG0033605	0	0	0	1	1	2
OG0033606	0	0	0	2	0	2
OG0033607	0	0	0	2	0	2
OG0033608	0	0	0	2	0	2
OG0033609	0	0	0	2	0	2
OG0033610	0	0	0	2	0	2
OG0033611	0	0	0	2	0	2
OG0033612	0	0	0	2	0	2
OG0033613	0	0	0	2	0	2
OG0033614	0	0	0	2	0	2
OG0033615	0	0	0	2	0	2
OG0033616	0	0	0	1	1	2
OG0033617	0	0	0	2	0	2
OG0033618	0	0	0	2	0	2
OG0033619	0	0	0	2	0	2
OG0033620	0	0	0	2	0	2
OG0033621	0	0	0	2	0	2
OG0033622	0	0	0	2	0	2
OG0033623	0	0	0	2	0	2
OG0033624	0	0	0	2	0	2
OG0033625	0	0	0	2	0	2
OG0033626	0	0	0	2	0	2
OG0033627	0	0	0	2	0	2
OG0033628	0	0	0	1	1	2
OG0033629	0	0	0	2	0	2
OG0033630	0	0	0	2	0	2
OG0033631	0	0	0	2	0	2
OG0033632	0	0	0	2	0	2
OG0033633	0	0	0	1	1	2
OG0033634	0	0	0	2	0	2
OG0033635	0	0	0	2	0	2
OG0033636	0	0	0	2	0	2
OG0033637	0	0	0	1	1	2
OG0033638	0	0	0	2	0	2
OG0033639	0	0	0	1	1	2
OG0033640	0	0	0	2	0	2
OG0033641	0	0	0	2	0	2
OG0033642	0	0	0	2	0	2
OG0033643	0	0	0	2	0	2
OG0033644	0	0	0	1	1	2
OG0033645	0	0	0	2	0	2
OG0033646	0	0	0	0	2	2
OG0033647	0	0	0	0	2	2
OG0033648	0	0	0	0	2	2
OG0033649	0	0	0	0	2	2
OG0033650	0	0	0	0	2	2
OG0033651	0	0	0	0	2	2
OG0033652	0	0	0	0	2	2
OG0033653	0	0	0	0	2	2
OG0033654	0	0	0	0	2	2
OG0033655	0	0	0	0	2	2
OG0033656	0	0	0	0	2	2
OG0033657	0	0	0	0	2	2
OG0033658	0	0	0	0	2	2
OG0033659	0	0	0	0	2	2
OG0033660	0	0	0	0	2	2
OG0033661	0	0	0	0	2	2
OG0033662	0	0	0	0	2	2
OG0033663	0	0	0	0	2	2
OG0033664	0	0	0	0	2	2
OG0033665	0	0	0	0	2	2
OG0033666	0	0	0	0	2	2
OG0033667	0	0	0	0	2	2
OG0033668	0	0	0	0	2	2
OG0033669	0	0	0	0	2	2
OG0033670	0	0	0	0	2	2
OG0033671	0	0	0	0	2	2
OG0033672	0	0	0	0	2	2
OG0033673	0	0	0	0	2	2
OG0033674	0	0	0	0	2	2
OG0033675	0	0	0	0	2	2
OG0033676	0	0	0	0	2	2
OG0033677	0	0	0	0	2	2
OG0033678	0	0	0	0	2	2
OG0033679	0	0	0	0	2	2
OG0033680	0	0	0	0	2	2
OG0033681	0	0	0	0	2	2
OG0033682	0	0	0	0	2	2
OG0033683	0	0	0	0	2	2
OG0033684	0	0	0	0	2	2
OG0033685	0	0	0	0	2	2
OG0033686	0	0	0	0	2	2
OG0033687	0	0	0	0	2	2
OG0033688	0	0	0	0	2	2
OG0033689	0	0	0	0	2	2
OG0033690	0	0	0	0	2	2
OG0033691	0	0	0	0	2	2
OG0033692	0	0	0	0	2	2
OG0033693	0	0	0	0	2	2
OG0033694	0	0	0	0	2	2
OG0033695	0	0	0	0	2	2
OG0033696	0	0	0	0	2	2
OG0033697	0	0	0	0	2	2
OG0033698	0	0	0	0	2	2
OG0033699	0	0	0	0	2	2
OG0033700	0	0	0	0	2	2
OG0033701	0	0	0	0	2	2
OG0033702	0	0	0	0	2	2
OG0033703	0	0	0	0	2	2
OG0033704	0	0	0	0	2	2
OG0033705	0	0	0	0	2	2
OG0033706	0	0	0	0	2	2
OG0033707	0	0	0	0	2	2
OG0033708	0	0	0	0	2	2
OG0033709	0	0	0	0	2	2
OG0033710	0	0	0	0	2	2
OG0033711	0	0	0	0	2	2
OG0033712	0	0	0	0	2	2
OG0033713	0	0	0	0	2	2
OG0033714	0	0	0	0	2	2
OG0033715	0	0	0	0	2	2
OG0033716	0	0	0	0	2	2
OG0033717	0	0	0	0	2	2
OG0033718	0	0	0	0	2	2
OG0033719	0	0	0	0	2	2
OG0033720	0	0	0	0	2	2
OG0033721	0	0	0	0	2	2
OG0033722	0	0	0	0	2	2
OG0033723	0	0	0	0	2	2
OG0033724	0	0	0	0	2	2
OG0033725	0	0	0	0	2	2
OG0033726	0	0	0	0	2	2
OG0033727	0	0	0	0	2	2
OG0033728	0	0	0	0	2	2
OG0033729	0	0	0	0	2	2
OG0033730	0	0	0	0	2	2
OG0033731	0	0	0	0	2	2
OG0033732	0	0	0	0	2	2
OG0033733	0	0	0	0	2	2
OG0033734	0	0	0	0	2	2
OG0033735	0	0	0	0	2	2
OG0033736	0	0	0	0	2	2
OG0033737	0	0	0	0	2	2
OG0033738	0	0	0	0	2	2
OG0033739	0	0	0	0	2	2
OG0033740	0	0	0	0	2	2
OG0033741	0	0	0	0	2	2
OG0033742	0	0	0	0	2	2
OG0033743	0	0	0	0	2	2
OG0033744	0	0	0	0	2	2
OG0033745	0	0	0	0	2	2
OG0033746	0	0	0	0	2	2
OG0033747	0	0	0	0	2	2
OG0033748	0	0	0	0	2	2
OG0033749	0	0	0	0	2	2
OG0033750	0	0	0	0	2	2
OG0033751	0	0	0	0	2	2
OG0033752	0	0	0	0	2	2
OG0033753	0	0	0	0	2	2
OG0033754	0	0	0	0	2	2
OG0033755	0	0	0	0	2	2
OG0033756	0	0	0	0	2	2
OG0033757	0	0	0	0	2	2
OG0033758	0	0	0	0	2	2
OG0033759	0	0	0	0	2	2
OG0033760	0	0	0	0	2	2
OG0033761	0	0	0	0	2	2
OG0033762	0	0	0	0	2	2
OG0033763	0	0	0	0	2	2
OG0033764	0	0	0	0	2	2
OG0033765	0	0	0	0	2	2
OG0033766	0	0	0	0	2	2
OG0033767	0	0	0	0	2	2
OG0033768	0	0	0	0	2	2
OG0033769	0	0	0	0	2	2
OG0033770	0	0	0	0	2	2
OG0033771	0	0	0	0	2	2
OG0033772	0	0	0	0	2	2
OG0033773	0	0	0	0	2	2
OG0033774	0	0	0	0	2	2
OG0033775	0	0	0	0	2	2
OG0033776	0	0	0	0	2	2
OG0033777	0	0	0	0	2	2
OG0033778	0	0	0	0	2	2
OG0033779	0	0	0	0	2	2
OG0033780	0	0	0	0	2	2
OG0033781	0	0	0	0	2	2
OG0033782	0	0	0	0	2	2
OG0033783	0	0	0	0	2	2
OG0033784	0	0	0	0	2	2
OG0033785	0	0	0	0	2	2
OG0033786	0	0	0	0	2	2
OG0033787	0	0	0	0	2	2
OG0033788	0	0	0	0	2	2
OG0033789	0	0	0	0	2	2
OG0033790	0	0	0	0	2	2
OG0033791	0	0	0	0	2	2
OG0033792	0	0	0	0	2	2
OG0033793	0	0	0	0	2	2
OG0033794	0	0	0	0	2	2
OG0033795	0	0	0	0	2	2
OG0033796	0	0	0	0	2	2
OG0033797	0	0	0	0	2	2
OG0033798	0	0	0	0	2	2
OG0033799	0	0	0	0	2	2
OG0033800	0	0	0	0	2	2
OG0033801	0	0	0	0	2	2
OG0033802	0	0	0	0	2	2
OG0033803	0	0	0	0	2	2
OG0033804	0	0	0	0	2	2
OG0033805	0	0	0	0	2	2
OG0033806	0	0	0	0	2	2
OG0033807	0	0	0	0	2	2
OG0033808	0	0	0	0	2	2
OG0033809	0	0	0	0	2	2
OG0033810	0	0	0	0	2	2
OG0033811	0	0	0	0	2	2
OG0033812	0	0	0	0	2	2
OG0033813	0	0	0	0	2	2
OG0033814	0	0	0	0	2	2
OG0033815	0	0	0	0	2	2
OG0033816	0	0	0	0	2	2
OG0033817	0	0	0	0	2	2
OG0033818	0	0	0	0	2	2
OG0033819	0	0	0	0	2	2
OG0033820	0	0	0	0	2	2
OG0033821	0	0	0	0	2	2
OG0033822	0	0	0	0	2	2
OG0033823	0	0	0	0	2	2
OG0033824	0	0	0	0	2	2
OG0033825	0	0	0	0	2	2
OG0033826	0	0	0	0	2	2
OG0033827	0	0	0	0	2	2
OG0033828	0	0	0	0	2	2
OG0033829	0	0	0	0	2	2
OG0033830	0	0	0	0	2	2
OG0033831	0	0	0	0	2	2
OG0033832	0	0	0	0	2	2
OG0033833	0	0	0	0	2	2
OG0033834	0	0	0	0	2	2
OG0033835	0	0	0	0	2	2
OG0033836	0	0	0	0	2	2
OG0033837	0	0	0	0	2	2
OG0033838	0	0	0	0	2	2
OG0033839	0	0	0	0	2	2
OG0033840	0	0	0	0	2	2
OG0033841	0	0	0	0	2	2
OG0033842	0	0	0	0	2	2
OG0033843	0	0	0	0	2	2
OG0033844	0	0	0	0	2	2
OG0033845	0	0	0	0	2	2
OG0033846	0	0	0	0	2	2
OG0033847	0	0	0	0	2	2
OG0033848	0	0	0	0	2	2
OG0033849	0	0	0	0	2	2
OG0033850	0	0	0	0	2	2
OG0033851	0	0	0	0	2	2
OG0033852	0	0	0	0	2	2
OG0033853	0	0	0	0	2	2
OG0033854	0	0	0	0	2	2
OG0033855	0	0	0	0	2	2
OG0033856	0	0	0	0	2	2
OG0033857	0	0	0	0	2	2
OG0033858	0	0	0	0	2	2
OG0033859	0	0	0	0	2	2
OG0033860	0	0	0	0	2	2
OG0033861	0	0	0	0	2	2
OG0033862	0	0	0	0	2	2
OG0033863	0	0	0	0	2	2
OG0033864	0	0	0	0	2	2
OG0033865	0	0	0	0	2	2
OG0033866	0	0	0	0	2	2
OG0033867	0	0	0	0	2	2
OG0033868	0	0	0	0	2	2
OG0033869	0	0	0	0	2	2
OG0033870	0	0	0	0	2	2
OG0033871	0	0	0	0	2	2
OG0033872	0	0	0	0	2	2
OG0033873	0	0	0	0	2	2
OG0033874	0	0	0	0	2	2
OG0033875	0	0	0	0	2	2
OG0033876	0	0	0	0	2	2
OG0033877	0	0	0	0	2	2
OG0033878	0	0	0	0	2	2
OG0033879	0	0	0	0	2	2
OG0033880	0	0	0	0	2	2
OG0033881	0	0	0	0	2	2
OG0033882	0	0	0	0	2	2
OG0033883	0	0	0	0	2	2
OG0033884	0	0	0	0	2	2
OG0033885	0	0	0	0	2	2
OG0033886	0	0	0	0	2	2
OG0033887	0	0	0	0	2	2
OG0033888	0	0	0	0	2	2
OG0033889	0	0	0	0	2	2
OG0033890	0	0	0	0	2	2
OG0033891	0	0	0	0	2	2
OG0033892	0	0	0	0	2	2
OG0033893	0	0	0	0	2	2
OG0033894	0	0	0	0	2	2
OG0033895	0	0	0	0	2	2
OG0033896	0	0	0	0	2	2
OG0033897	0	0	0	0	2	2
OG0033898	0	0	0	0	2	2
OG0033899	0	0	0	0	2	2
OG0033900	0	0	0	0	2	2
OG0033901	0	0	0	0	2	2
OG0033902	0	0	0	0	2	2
OG0033903	0	0	0	0	2	2
OG0033904	0	0	0	0	2	2
OG0033905	0	0	0	0	2	2
OG0033906	0	0	0	0	2	2
OG0033907	0	0	0	0	2	2
OG0033908	0	0	0	0	2	2
OG0033909	0	0	0	0	2	2
OG0033910	0	0	0	0	2	2
OG0033911	0	0	0	0	2	2
OG0033912	0	0	0	0	2	2
OG0033913	0	0	0	0	2	2
OG0033914	0	0	0	0	2	2
OG0033915	0	0	0	0	2	2
OG0033916	0	0	0	0	2	2
OG0033917	0	0	0	0	2	2
OG0033918	0	0	0	0	2	2
OG0033919	0	0	0	0	2	2
OG0033920	0	0	0	0	2	2
OG0033921	0	0	0	0	2	2
OG0033922	0	0	0	0	2	2
OG0033923	0	0	0	0	2	2
OG0033924	0	0	0	0	2	2
OG0033925	0	0	0	0	2	2
OG0033926	0	0	0	0	2	2
OG0033927	0	0	0	0	2	2
OG0033928	0	0	0	0	2	2
OG0033929	0	0	0	0	2	2
OG0033930	0	0	0	0	2	2
OG0033931	0	0	0	0	2	2
OG0033932	0	0	0	0	2	2
OG0033933	0	0	0	0	2	2
OG0033934	0	0	0	0	2	2
OG0033935	0	0	0	0	2	2
OG0033936	0	0	0	0	2	2
OG0033937	0	0	0	0	2	2
OG0033938	0	0	0	0	2	2
OG0033939	0	0	0	0	2	2
OG0033940	0	0	0	0	2	2
OG0033941	0	0	0	0	2	2
OG0033942	0	0	0	0	2	2
OG0033943	0	0	0	0	2	2
OG0033944	0	0	0	0	2	2
OG0033945	0	0	0	0	2	2
OG0033946	0	0	0	0	2	2
OG0033947	0	0	0	0	2	2
OG0033948	0	0	0	0	2	2
OG0033949	0	0	0	0	2	2
OG0033950	0	0	0	0	2	2
OG0033951	0	0	0	0	2	2
OG0033952	0	0	0	0	2	2
OG0033953	0	0	0	0	2	2
OG0033954	0	0	0	0	2	2
OG0033955	0	0	0	0	2	2
OG0033956	0	0	0	0	2	2
OG0033957	0	0	0	0	2	2
OG0033958	0	0	0	0	2	2
OG0033959	0	0	0	0	2	2
OG0033960	0	0	0	0	2	2
OG0033961	0	0	0	0	2	2
OG0033962	0	0	0	0	2	2
OG0033963	0	0	0	0	2	2
OG0033964	0	0	0	0	2	2
OG0033965	0	0	0	0	2	2
OG0033966	0	0	0	0	2	2
OG0033967	0	0	0	0	2	2
OG0033968	0	0	0	0	2	2
OG0033969	0	0	0	0	2	2
OG0033970	0	0	0	0	2	2
OG0033971	0	0	0	0	2	2
OG0033972	0	0	0	0	2	2
OG0033973	0	0	0	0	2	2
OG0033974	0	0	0	0	2	2
OG0033975	0	0	0	0	2	2
OG0033976	0	0	0	0	2	2
OG0033977	0	0	0	0	2	2
OG0033978	0	0	0	0	2	2
OG0033979	0	0	0	0	2	2
OG0033980	0	0	0	0	2	2
OG0033981	0	0	0	0	2	2
OG0033982	0	0	0	0	2	2
OG0033983	0	0	0	0	2	2
OG0033984	0	0	0	0	2	2
OG0033985	0	0	0	0	2	2
OG0033986	0	0	0	0	2	2
OG0033987	0	0	0	0	2	2
OG0033988	0	0	0	0	2	2
OG0033989	0	0	0	0	2	2
OG0033990	0	0	0	0	2	2
OG0033991	0	0	0	0	2	2
OG0033992	0	0	0	0	2	2
OG0033993	0	0	0	0	2	2
OG0033994	0	0	0	0	2	2
OG0033995	0	0	0	0	2	2
OG0033996	0	0	0	0	2	2
OG0033997	0	0	0	0	2	2
OG0033998	0	0	0	0	2	2
OG0033999	0	0	0	0	2	2
OG0034000	0	0	0	0	2	2
OG0034001	0	0	0	0	2	2
OG0034002	0	0	0	0	2	2
OG0034003	0	0	0	0	2	2
OG0034004	0	0	0	0	2	2
OG0034005	0	0	0	0	2	2
OG0034006	0	0	0	0	2	2
OG0034007	0	0	0	0	2	2
OG0034008	0	0	0	0	2	2
OG0034009	0	0	0	0	2	2
OG0034010	0	0	0	0	2	2
OG0034011	0	0	0	0	2	2
OG0034012	0	0	0	0	2	2
OG0034013	0	0	0	0	2	2
OG0034014	0	0	0	0	2	2
OG0034015	0	0	0	0	2	2
OG0034016	0	0	0	0	2	2
OG0034017	0	0	0	0	2	2
OG0034018	0	0	0	0	2	2
OG0034019	0	0	0	0	2	2
OG0034020	0	0	0	0	2	2
OG0034021	0	0	0	0	2	2
OG0034022	0	0	0	0	2	2
OG0034023	0	0	0	0	2	2
OG0034024	0	0	0	0	2	2
OG0034025	0	0	0	0	2	2
OG0034026	0	0	0	0	2	2
OG0034027	0	0	0	0	2	2
OG0034028	0	0	0	0	2	2
OG0034029	0	0	0	0	2	2
OG0034030	0	0	0	0	2	2
OG0034031	0	0	0	0	2	2
OG0034032	0	0	0	0	2	2
OG0034033	0	0	0	0	2	2
OG0034034	0	0	0	0	2	2
OG0034035	0	0	0	0	2	2
OG0034036	0	0	0	0	2	2
OG0034037	0	0	0	0	2	2
OG0034038	0	0	0	0	2	2
OG0034039	0	0	0	0	2	2
OG0034040	0	0	0	0	2	2
OG0034041	0	0	0	0	2	2
OG0034042	0	0	0	0	2	2
OG0034043	0	0	0	0	2	2
OG0034044	0	0	0	0	2	2
OG0034045	0	0	0	0	2	2
OG0034046	0	0	0	0	2	2
OG0034047	0	0	0	0	2	2
OG0034048	0	0	0	0	2	2
OG0034049	0	0	0	0	2	2
OG0034050	0	0	0	0	2	2
OG0034051	0	0	0	0	2	2
OG0034052	0	0	0	0	2	2
OG0034053	0	0	0	0	2	2
OG0034054	0	0	0	0	2	2
OG0034055	0	0	0	0	2	2
OG0034056	0	0	0	0	2	2
OG0034057	0	0	0	0	2	2
OG0034058	0	0	0	0	2	2
OG0034059	0	0	0	0	2	2
OG0034060	0	0	0	0	2	2
OG0034061	0	0	0	0	2	2
OG0034062	0	0	0	0	2	2
OG0034063	0	0	0	0	2	2
OG0034064	0	0	0	0	2	2
OG0034065	0	0	0	0	2	2
OG0034066	0	0	0	0	2	2
OG0034067	0	0	0	0	2	2
OG0034068	0	0	0	0	2	2
OG0034069	0	0	0	0	2	2
OG0034070	0	0	0	0	2	2
OG0034071	0	0	0	0	2	2
OG0034072	0	0	0	0	2	2
OG0034073	0	0	0	0	2	2
OG0034074	0	0	0	0	2	2
OG0034075	0	0	0	0	2	2
OG0034076	0	0	0	0	2	2
OG0034077	0	0	0	0	2	2
OG0034078	0	0	0	0	2	2
OG0034079	0	0	0	0	2	2
OG0034080	0	0	0	0	2	2
OG0034081	0	0	0	0	2	2
OG0034082	0	0	0	0	2	2
OG0034083	0	0	0	0	2	2
OG0034084	0	0	0	0	2	2
OG0034085	0	0	0	0	2	2
OG0034086	0	0	0	0	2	2
OG0034087	0	0	0	0	2	2
OG0034088	0	0	0	0	2	2
OG0034089	0	0	0	0	2	2
OG0034090	0	0	0	0	2	2
OG0034091	0	0	0	0	2	2
OG0034092	0	0	0	0	2	2
OG0034093	0	0	0	0	2	2
OG0034094	0	0	0	0	2	2
OG0034095	0	0	0	0	2	2
OG0034096	0	0	0	0	2	2
OG0034097	0	0	0	0	2	2
OG0034098	0	0	0	0	2	2
OG0034099	0	0	0	0	2	2
OG0034100	0	0	0	0	2	2
OG0034101	0	0	0	0	2	2
OG0034102	0	0	0	0	2	2
OG0034103	0	0	0	0	2	2
OG0034104	0	0	0	0	2	2
OG0034105	0	0	0	0	2	2
OG0034106	0	0	0	0	2	2
OG0034107	0	0	0	0	2	2
OG0034108	0	0	0	0	2	2
OG0034109	0	0	0	0	2	2
OG0034110	0	0	0	0	2	2
OG0034111	0	0	0	0	2	2
OG0034112	0	0	0	0	2	2
OG0034113	0	0	0	0	2	2
OG0034114	0	0	0	0	2	2
OG0034115	0	0	0	0	2	2
OG0034116	0	0	0	0	2	2
OG0034117	0	0	0	0	2	2
OG0034118	0	0	0	0	2	2
OG0034119	0	0	0	0	2	2
OG0034120	0	0	0	0	2	2
OG0034121	0	0	0	0	2	2
OG0034122	0	0	0	0	2	2
OG0034123	0	0	0	0	2	2
OG0034124	0	0	0	0	2	2
OG0034125	0	0	0	0	2	2
OG0034126	0	0	0	0	2	2
OG0034127	0	0	0	0	2	2
OG0034128	0	0	0	0	2	2
OG0034129	0	0	0	0	2	2
OG0034130	0	0	0	0	2	2
OG0034131	0	0	0	0	2	2
OG0034132	0	0	0	0	2	2
OG0034133	0	0	0	0	2	2
OG0034134	0	0	0	0	2	2
OG0034135	0	0	0	0	2	2
OG0034136	0	0	0	0	2	2
OG0034137	0	0	0	0	2	2
OG0034138	0	0	0	0	2	2
OG0034139	0	0	0	0	2	2
OG0034140	0	0	0	0	2	2
OG0034141	0	0	0	0	2	2
OG0034142	0	0	0	0	2	2
OG0034143	0	0	0	0	2	2
OG0034144	0	0	0	0	2	2
OG0034145	0	0	0	0	2	2
OG0034146	0	0	0	0	2	2
OG0034147	0	0	0	0	2	2
OG0034148	0	0	0	0	2	2
OG0034149	0	0	0	0	2	2
OG0034150	0	0	0	0	2	2
OG0034151	0	0	0	0	2	2
OG0034152	0	0	0	0	2	2
OG0034153	0	0	0	0	2	2
OG0034154	0	0	0	0	2	2
OG0034155	0	0	0	0	2	2
OG0034156	0	0	0	0	2	2
OG0034157	0	0	0	0	2	2
OG0034158	0	0	0	0	2	2
OG0034159	0	0	0	0	2	2
OG0034160	0	0	0	0	2	2
OG0034161	0	0	0	0	2	2
OG0034162	0	0	0	0	2	2
OG0034163	0	0	0	0	2	2
OG0034164	0	0	0	0	2	2
OG0034165	0	0	0	0	2	2
OG0034166	0	0	0	0	2	2
OG0034167	0	0	0	0	2	2
OG0034168	0	0	0	0	2	2
OG0034169	0	0	0	0	2	2
OG0034170	0	0	0	0	2	2
OG0034171	0	0	0	0	2	2
OG0034172	0	0	0	0	2	2
OG0034173	0	0	0	0	2	2
OG0034174	0	0	0	0	2	2
OG0034175	0	0	0	0	2	2
OG0034176	0	0	0	0	2	2
OG0034177	0	0	0	0	2	2
OG0034178	0	0	0	0	2	2
OG0034179	0	0	0	0	2	2
OG0034180	0	0	0	0	2	2
OG0034181	0	0	0	0	2	2
OG0034182	0	0	0	0	2	2
